,filename,name,pose,truncated,difficult,xmin,ymin,xmax,ymax,width,height
0,levle0_158.jpg,fore,Unspecified,0.0,0,1114,2435,1306,2589,192,154
1,levle0_158.jpg,fore,Unspecified,0.0,0,692,2274,861,2397,169,123
2,levle1_439.jpg,fore,Unspecified,0.0,0,922,2175,999,2290,77,115
3,levle1_439.jpg,fore,Unspecified,0.0,0,1198,2221,1344,2313,146,92
4,levle1_439.jpg,fore,Unspecified,0.0,0,662,1983,800,2106,138,123
5,levle1_439.jpg,fore,Unspecified,0.0,0,1489,2412,1643,2535,154,123
6,levle1_439.jpg,fore,Unspecified,0.0,0,2057,2006,2171,2121,114,115
7,levle1_439.jpg,fore,Unspecified,0.0,0,1589,2734,1742,2888,153,154
8,levle3_36.jpg,fore,,,0,1249,320,1346,439,97,119
9,levle3_36.jpg,fore,,,0,1188,342,1258,430,70,88
10,levle3_36.jpg,fore,,,0,1091,324,1148,417,57,93
11,levle3_36.jpg,fore,,,0,890,329,1004,417,114,88
12,levle3_36.jpg,fore,,,0,977,382,1061,465,84,83
13,levle3_36.jpg,fore,,,0,1078,474,1131,522,53,48
14,levle3_36.jpg,fore,,,0,1105,535,1179,627,74,92
15,levle3_36.jpg,fore,,,0,1205,496,1311,579,106,83
16,levle3_36.jpg,fore,,,0,784,439,846,526,62,87
17,levle3_36.jpg,fore,,,0,754,566,855,653,101,87
18,levle3_36.jpg,fore,,,0,697,592,802,710,105,118
19,levle3_36.jpg,fore,,,0,1030,649,1122,706,92,57
20,levle3_36.jpg,fore,,,0,1135,649,1170,728,35,79
21,levle3_36.jpg,fore,,,0,1184,693,1254,754,70,61
22,levle3_36.jpg,fore,,,0,1157,925,1227,978,70,53
23,levle3_36.jpg,fore,,,0,1429,754,1548,851,119,97
24,levle3_36.jpg,fore,,,0,469,811,583,912,114,101
25,levle3_36.jpg,fore,,,0,385,881,534,978,149,97
26,levle3_36.jpg,fore,,,0,635,1101,723,1189,88,88
27,levle3_36.jpg,fore,,,0,776,1057,894,1175,118,118
28,levle3_36.jpg,fore,,,0,951,1044,1131,1140,180,96
29,levle3_36.jpg,fore,,,0,425,1197,521,1281,96,84
30,levle3_36.jpg,fore,,,0,745,1171,837,1237,92,66
31,levle3_36.jpg,fore,,,0,675,1206,741,1294,66,88
32,levle3_36.jpg,fore,,,0,741,1224,841,1320,100,96
33,levle3_36.jpg,fore,,,0,517,1259,670,1373,153,114
34,levle3_36.jpg,fore,,,0,425,1377,548,1456,123,79
35,levle3_36.jpg,fore,,,0,574,1434,666,1517,92,83
36,levle3_36.jpg,fore,,,0,539,1544,653,1614,114,70
37,levle3_36.jpg,fore,,,0,534,1675,635,1763,101,88
38,levle3_36.jpg,fore,,,0,688,1456,784,1548,96,92
39,levle3_36.jpg,fore,,,0,640,1539,745,1662,105,123
40,levle3_36.jpg,fore,,,0,763,1408,885,1513,122,105
41,levle3_36.jpg,fore,,,0,798,1311,960,1412,162,101
42,levle3_36.jpg,fore,,,0,916,1272,1043,1342,127,70
43,levle3_36.jpg,fore,,,0,982,1346,1083,1447,101,101
44,levle3_36.jpg,fore,,,0,1144,1298,1192,1346,48,48
45,levle3_36.jpg,fore,,,0,1201,1360,1306,1465,105,105
46,levle3_36.jpg,fore,,,0,1026,1614,1122,1688,96,74
47,levle3_36.jpg,fore,,,0,802,1605,925,1688,123,83
48,levle3_36.jpg,fore,,,0,1298,1079,1434,1210,136,131
49,levle3_36.jpg,fore,,,0,968,867,1043,946,75,79
50,levle3_36.jpg,fore,,,0,934,967,1024,1058,90,91
51,levle3_36.jpg,fore,,,0,491,1031,559,1086,68,55
52,levle3_36.jpg,fore,,,0,391,1077,463,1144,72,67
53,levle3_36.jpg,fore,,,0,759,1698,845,1775,86,77
54,levle3_36.jpg,fore,,,0,849,1738,941,1819,92,81
55,levle3_36.jpg,fore,,,0,322,1398,403,1469,81,71
56,levle3_36.jpg,fore,,,0,1216,1179,1303,1263,87,84
57,levle3_36.jpg,fore,,,0,941,1525,1057,1631,116,106
58,levle3_36.jpg,fore,,,0,561,1148,651,1221,90,73
59,levle3_36.jpg,fore,,,0,393,958,478,1044,85,86
60,levle0_164.jpg,fore,Unspecified,0.0,0,800,2121,930,2282,130,161
61,levle0_164.jpg,fore,Unspecified,0.0,0,1091,2366,1267,2543,176,177
62,levle0_164.jpg,fore,Unspecified,0.0,0,1367,2857,1543,3041,176,184
63,levle1_377.jpg,fore,Unspecified,0.0,0,1313,2137,1497,2305,184,168
64,levle1_377.jpg,fore,Unspecified,0.0,0,1298,2320,1451,2443,153,123
65,levle1_377.jpg,fore,Unspecified,0.0,0,723,2251,892,2366,169,115
66,levle1_377.jpg,fore,Unspecified,0.0,0,761,2045,884,2221,123,176
67,levle1_377.jpg,fore,Unspecified,0.0,0,907,2435,991,2581,84,146
68,levle1_377.jpg,fore,Unspecified,0.0,0,1014,2428,1198,2619,184,191
69,levle1_377.jpg,fore,Unspecified,0.0,0,853,2627,1068,2780,215,153
70,levle1_377.jpg,fore,Unspecified,0.0,0,823,2757,984,2865,161,108
71,levle1_411.jpg,fore,Unspecified,0.0,0,2424,1761,2616,1953,192,192
72,levle1_411.jpg,fore,Unspecified,0.0,0,2616,1753,2769,1907,153,154
73,levle1_411.jpg,fore,Unspecified,0.0,0,2317,2022,2516,2144,199,122
74,levle1_411.jpg,fore,Unspecified,0.0,0,2325,2282,2516,2443,191,161
75,levle1_411.jpg,fore,Unspecified,0.0,0,2210,2849,2355,2979,145,130
76,levle1_411.jpg,fore,Unspecified,0.0,0,1436,3271,1620,3424,184,153
77,levle1_411.jpg,fore,Unspecified,0.0,0,1704,3232,1911,3416,207,184
78,levle1_411.jpg,fore,Unspecified,0.0,0,2716,2091,2823,2221,107,130
79,levle1_405.jpg,fore,Unspecified,0.0,0,869,842,1014,964,145,122
80,levle1_405.jpg,fore,Unspecified,0.0,0,984,581,1145,681,161,100
81,levle1_405.jpg,fore,Unspecified,0.0,0,1482,665,1719,811,237,146
82,levle1_405.jpg,fore,Unspecified,0.0,0,2102,558,2302,665,200,107
83,levle1_405.jpg,fore,Unspecified,0.0,0,2202,780,2424,918,222,138
84,levle1_405.jpg,fore,Unspecified,0.0,0,1942,2290,2110,2451,168,161
85,levle1_405.jpg,fore,Unspecified,0.0,0,2417,2213,2547,2351,130,138
86,levle1_405.jpg,fore,Unspecified,0.0,0,2547,2206,2693,2313,146,107
87,levle1_405.jpg,fore,Unspecified,0.0,0,2647,2313,2777,2443,130,130
88,levle1_405.jpg,fore,Unspecified,0.0,0,2378,2374,2562,2535,184,161
89,levle0_170.jpg,fore,Unspecified,0.0,0,1283,1983,1459,2198,176,215
90,levle0_170.jpg,fore,Unspecified,0.0,0,1283,2251,1489,2382,206,131
91,levle1_363.jpg,fore,Unspecified,0.0,0,1604,2987,1781,3133,177,146
92,levle1_363.jpg,fore,Unspecified,0.0,0,1489,2750,1620,2903,131,153
93,levle1_363.jpg,fore,Unspecified,0.0,0,1949,2750,2110,2872,161,122
94,levle1_363.jpg,fore,Unspecified,0.0,0,2187,2796,2363,2934,176,138
95,levle1_363.jpg,fore,Unspecified,0.0,0,2034,2911,2118,2995,84,84
96,levle1_363.jpg,fore,Unspecified,0.0,0,991,2397,1076,2543,85,146
97,levle3_22.jpg,fore,,,0,39,136,62,156,23,20
98,levle3_22.jpg,fore,,,0,81,135,100,154,19,19
99,levle3_22.jpg,fore,,,0,2,149,13,166,11,17
100,levle3_22.jpg,fore,,,0,24,173,48,188,24,15
101,levle3_22.jpg,fore,,,0,48,170,64,188,16,18
102,levle3_22.jpg,fore,,,0,48,209,56,224,8,15
103,levle3_22.jpg,fore,,,0,79,202,98,214,19,12
104,levle3_22.jpg,fore,,,0,26,229,42,245,16,16
105,levle3_22.jpg,fore,,,0,61,230,83,246,22,16
106,levle3_22.jpg,fore,,,0,35,250,51,268,16,18
107,levle3_22.jpg,fore,,,0,92,295,117,315,25,20
108,levle3_22.jpg,fore,,,0,29,51,51,66,22,15
109,levle3_22.jpg,fore,,,0,26,65,52,84,26,19
110,levle3_22.jpg,fore,,,0,5,182,23,204,18,22
111,levle3_22.jpg,fore,,,0,28,192,46,214,18,22
112,levle3_22.jpg,fore,,,0,109,190,139,226,30,36
113,levle3_22.jpg,fore,,,0,23,291,39,313,16,22
114,levle3_22.jpg,fore,,,0,50,244,69,263,19,19
115,levle3_22.jpg,fore,,,0,62,257,86,278,24,21
116,levle3_22.jpg,fore,,,0,51,280,64,293,13,13
117,levle3_22.jpg,fore,,,0,76,276,102,293,26,17
118,levle3_22.jpg,fore,,,0,100,244,120,262,20,18
119,levle3_22.jpg,fore,,,0,110,257,129,275,19,18
120,levle3_22.jpg,fore,,,0,100,279,119,296,19,17
121,levle3_22.jpg,fore,,,0,80,169,92,181,12,12
122,levle3_22.jpg,fore,,,0,90,173,100,184,10,11
123,levle3_22.jpg,fore,,,0,34,109,45,120,11,11
124,levle3_22.jpg,fore,,,0,65,117,76,131,11,14
125,levle3_22.jpg,fore,,,0,79,67,95,81,16,14
126,levle3_22.jpg,fore,,,0,16,215,32,231,16,16
127,levle3_22.jpg,fore,,,0,38,215,50,229,12,14
128,levle3_22.jpg,fore,,,0,40,230,58,243,18,13
129,levle3_22.jpg,fore,,,0,54,212,74,226,20,14
130,levle3_22.jpg,fore,,,0,53,189,65,207,12,18
131,levle3_22.jpg,fore,,,0,61,305,77,318,16,13
132,levle3_22.jpg,fore,,,0,77,301,91,316,14,15
133,levle3_22.jpg,fore,,,0,29,91,42,102,13,11
134,levle3_22.jpg,fore,,,0,16,91,29,104,13,13
135,levle3_22.jpg,fore,,,0,4,131,18,144,14,13
136,levle3_22.jpg,fore,,,0,23,152,31,163,8,11
137,levle3_22.jpg,fore,,,0,12,157,26,169,14,12
138,levle3_22.jpg,fore,,,0,68,155,81,171,13,16
139,levle3_22.jpg,fore,,,0,101,148,113,162,12,14
140,levle3_22.jpg,fore,,,0,94,185,114,203,20,18
141,levle3_22.jpg,fore,,,0,68,185,93,201,25,16
142,levle3_22.jpg,fore,,,0,60,58,73,68,13,10
143,levle3_22.jpg,fore,,,0,50,43,67,58,17,15
144,levle3_22.jpg,fore,,,0,5,268,18,284,13,16
145,levle3_22.jpg,fore,,,0,9,250,20,264,11,14
146,levle3_22.jpg,fore,,,0,1,246,7,262,6,16
147,levle3_22.jpg,fore,,,0,9,235,20,246,11,11
148,levle3_22.jpg,fore,,,0,19,245,32,259,13,14
149,levle3_22.jpg,fore,,,0,50,294,67,304,17,10
150,levle3_22.jpg,fore,,,0,86,259,97,270,11,11
151,levle3_22.jpg,fore,,,0,90,268,101,280,11,12
152,levle3_22.jpg,fore,,,0,88,239,103,255,15,16
153,levle3_22.jpg,fore,,,0,33,279,46,295,13,16
154,levle3_22.jpg,fore,,,0,64,67,75,80,11,13
155,levle3_22.jpg,fore,,,0,108,170,124,189,16,19
156,levle3_22.jpg,fore,,,0,118,296,133,312,15,16
157,levle3_22.jpg,fore,,,0,121,330,130,340,9,10
158,levle3_22.jpg,fore,,,0,133,325,144,337,11,12
159,levle3_22.jpg,fore,,,0,132,338,143,345,11,7
160,levle3_22.jpg,fore,,,0,11,285,22,301,11,16
161,levle3_22.jpg,fore,,,0,1,288,9,308,8,20
162,levle1_388.jpg,fore,Unspecified,0.0,0,1244,2773,1382,2911,138,138
163,levle1_388.jpg,fore,Unspecified,0.0,0,2018,504,2102,627,84,123
164,levle1_388.jpg,fore,Unspecified,0.0,0,2279,382,2493,535,214,153
165,levle1_388.jpg,fore,Unspecified,0.0,0,2302,205,2463,366,161,161
166,levle1_388.jpg,fore,Unspecified,0.0,0,2194,635,2340,773,146,138
167,levle1_388.jpg,fore,Unspecified,0.0,0,1650,167,1719,343,69,176
168,levle1_388.jpg,fore,Unspecified,0.0,0,1796,412,1972,566,176,154
169,levle0_67.jpg,fore,Unspecified,0.0,0,2691,1385,2949,1643,258,258
170,levle0_67.jpg,fore,Unspecified,0.0,0,3082,2449,3290,2757,208,308
171,levle0_67.jpg,fore,Unspecified,0.0,0,3755,2632,3905,2848,150,216
172,levle0_67.jpg,fore,Unspecified,0.0,0,3996,2723,4171,2948,175,225
173,levle1_149.jpg,fore,,,0,1344,2466,1489,2558,145,92
174,levle1_149.jpg,fore,,,0,1650,2780,1773,2941,123,161
175,levle1_149.jpg,fore,,,0,1712,2297,1896,2420,184,123
176,levle1_149.jpg,fore,,,0,2217,2313,2302,2397,85,84
177,levle1_149.jpg,fore,,,0,1765,2573,1880,2696,115,123
178,levle1_149.jpg,fore,,,0,2374,2136,2457,2212,83,76
179,levle0_73.jpg,fore,Unspecified,0.0,0,3522,1128,3747,1310,225,182
180,levle0_73.jpg,fore,Unspecified,0.0,0,3074,1144,3248,1335,174,191
181,levle0_73.jpg,fore,Unspecified,0.0,0,3024,1493,3248,1718,224,225
182,levle0_73.jpg,fore,Unspecified,0.0,0,3190,2017,3439,2250,249,233
183,levle0_73.jpg,fore,Unspecified,0.0,0,3514,1809,3722,1975,208,166
184,levle0_428.jpg,fore,Unspecified,0.0,0,784,1363,907,1531,123,168
185,levle0_428.jpg,fore,Unspecified,0.0,0,861,1240,984,1363,123,123
186,levle0_428.jpg,fore,Unspecified,0.0,0,2240,926,2371,1094,131,168
187,levle0_400.jpg,fore,Unspecified,0.0,0,2125,1945,2286,2045,161,100
188,levle0_400.jpg,fore,Unspecified,0.0,0,1796,2941,1903,3064,107,123
189,levle0_400.jpg,fore,Unspecified,0.0,0,1926,3194,2057,3355,131,161
190,levle0_400.jpg,fore,Unspecified,0.0,0,1175,512,1290,635,115,123
191,levle0_400.jpg,fore,Unspecified,0.0,0,608,681,815,903,207,222
192,levle1_613.jpg,fore,Unspecified,0.0,0,1306,1508,1390,1631,84,123
193,levle1_613.jpg,fore,Unspecified,0.0,0,1183,1409,1283,1531,100,122
194,levle1_613.jpg,fore,Unspecified,0.0,0,1252,1025,1428,1156,176,131
195,levle1_613.jpg,fore,Unspecified,0.0,0,2141,2481,2302,2650,161,169
196,levle1_613.jpg,fore,Unspecified,0.0,0,984,2765,1114,2918,130,153
197,levle1_613.jpg,fore,Unspecified,0.0,0,1788,2903,1911,3056,123,153
198,levle1_613.jpg,fore,Unspecified,0.0,0,1382,1171,1505,1286,123,115
199,levle1_175.jpg,fore,Unspecified,0.0,0,2463,2183,2547,2305,84,122
200,levle1_175.jpg,fore,Unspecified,0.0,0,2562,2221,2639,2389,77,168
201,levle1_175.jpg,fore,Unspecified,0.0,0,2125,2251,2271,2343,146,92
202,levle1_175.jpg,fore,Unspecified,0.0,0,1719,796,1888,872,169,76
203,levle1_175.jpg,fore,Unspecified,0.0,0,2179,1876,2286,1968,107,92
204,levle1_175.jpg,fore,Unspecified,0.0,0,2302,1891,2432,2022,130,131
205,levle0_366.jpg,fore,Unspecified,0.0,0,1620,2811,1796,2926,176,115
206,levle0_366.jpg,fore,Unspecified,0.0,0,1252,2949,1397,3071,145,122
207,levle1_161.jpg,fore,Unspecified,0.0,0,1106,2290,1221,2412,115,122
208,levle1_161.jpg,fore,Unspecified,0.0,0,1313,2098,1405,2213,92,115
209,levle1_161.jpg,fore,Unspecified,0.0,0,991,1930,1114,2098,123,168
210,levle1_161.jpg,fore,Unspecified,0.0,0,1451,2343,1597,2497,146,154
211,levle1_161.jpg,fore,Unspecified,0.0,0,1765,2788,1873,2895,108,107
212,levle1_161.jpg,fore,Unspecified,0.0,0,2064,2911,2171,3010,107,99
213,levle1_161.jpg,fore,Unspecified,0.0,0,2003,2995,2133,3110,130,115
214,levle1_161.jpg,fore,Unspecified,0.0,0,2003,3110,2125,3186,122,76
215,levle0_372.jpg,fore,Unspecified,0.0,0,386,1868,570,1945,184,77
216,levle0_372.jpg,fore,Unspecified,0.0,0,486,2083,662,2198,176,115
217,levle0_372.jpg,fore,Unspecified,0.0,0,1888,2964,2011,3110,123,146
218,levle0_372.jpg,fore,Unspecified,0.0,0,1719,3110,1804,3194,85,84
219,levle0_372.jpg,fore,Unspecified,0.0,0,1551,2964,1666,3071,115,107
220,levle0_414.jpg,fore,Unspecified,0.0,0,1505,1623,1620,1761,115,138
221,levle0_414.jpg,fore,Unspecified,0.0,0,1413,2857,1566,2972,153,115
222,levle1_607.jpg,fore,Unspecified,0.0,0,2509,2121,2677,2244,168,123
223,levle1_607.jpg,fore,Unspecified,0.0,0,2263,2428,2409,2596,146,168
224,levle1_607.jpg,fore,Unspecified,0.0,0,2516,2389,2608,2474,92,85
225,levle1_607.jpg,fore,Unspecified,0.0,0,1604,3002,1704,3140,100,138
226,levle1_607.jpg,fore,Unspecified,0.0,0,1382,2918,1497,3018,115,100
227,levle1_607.jpg,fore,Unspecified,0.0,0,1420,3087,1528,3171,108,84
228,levle1_607.jpg,fore,Unspecified,0.0,0,1750,3148,1873,3248,123,100
229,levle1_607.jpg,fore,Unspecified,0.0,0,1696,3002,1819,3079,123,77
230,levle1_607.jpg,fore,Unspecified,0.0,0,1229,1799,1344,1930,115,131
231,levle0_399.jpg,fore,Unspecified,0.0,0,1566,650,1811,796,245,146
232,levle0_399.jpg,fore,Unspecified,0.0,0,1168,2497,1267,2658,99,161
233,levle0_98.jpg,fore,Unspecified,0.0,0,2631,1271,2800,1516,169,245
234,levle0_98.jpg,fore,Unspecified,0.0,0,2371,1730,2478,1868,107,138
235,levle2_62.jpg,fore,Unspecified,0.0,0,1952,1975,2043,2100,91,125
236,levle2_62.jpg,fore,Unspecified,0.0,0,1885,2125,2076,2266,191,141
237,levle2_62.jpg,fore,Unspecified,0.0,0,1985,2225,2151,2333,166,108
238,levle2_62.jpg,fore,Unspecified,0.0,0,1968,2349,2068,2457,100,108
239,levle2_62.jpg,fore,Unspecified,0.0,0,1902,2532,2051,2657,149,125
240,levle2_62.jpg,fore,Unspecified,0.0,0,2101,2067,2218,2191,117,124
241,levle2_62.jpg,fore,Unspecified,0.0,0,2234,2150,2342,2258,108,108
242,levle2_62.jpg,fore,Unspecified,0.0,0,2375,2100,2542,2258,167,158
243,levle2_62.jpg,fore,Unspecified,0.0,0,2259,2316,2417,2441,158,125
244,levle2_62.jpg,fore,Unspecified,0.0,0,2450,2491,2558,2599,108,108
245,levle2_62.jpg,fore,Unspecified,0.0,0,2874,2748,3032,2865,158,117
246,levle2_62.jpg,fore,Unspecified,0.0,0,2916,2890,3074,3023,158,133
247,levle2_62.jpg,fore,Unspecified,0.0,0,1760,1826,1943,1992,183,166
248,levle2_62.jpg,fore,Unspecified,0.0,0,1769,1992,1977,2125,208,133
249,levle2_76.jpg,fore,Unspecified,0.0,0,1781,1999,1880,2137,99,138
250,levle2_76.jpg,fore,Unspecified,0.0,0,1934,1830,2110,2006,176,176
251,levle2_76.jpg,fore,Unspecified,0.0,0,1681,2198,1811,2343,130,145
252,levle2_76.jpg,fore,Unspecified,0.0,0,1888,2229,2079,2458,191,229
253,levle2_76.jpg,fore,Unspecified,0.0,0,1972,2366,2118,2558,146,192
254,levle2_76.jpg,fore,Unspecified,0.0,0,2057,2520,2148,2681,91,161
255,levle2_76.jpg,fore,Unspecified,0.0,0,1811,2665,1980,2849,169,184
256,levle2_76.jpg,fore,Unspecified,0.0,0,1788,2435,1926,2596,138,161
257,levle2_76.jpg,fore,Unspecified,0.0,0,2164,2213,2332,2382,168,169
258,levle2_76.jpg,fore,Unspecified,0.0,0,2248,2474,2332,2589,84,115
259,levle2_76.jpg,fore,Unspecified,0.0,0,2271,2589,2432,2773,161,184
260,levle2_76.jpg,fore,Unspecified,0.0,0,2455,2068,2509,2206,54,138
261,levle2_76.jpg,fore,Unspecified,0.0,0,2516,1914,2662,2060,146,146
262,levle2_76.jpg,fore,Unspecified,0.0,0,2547,2045,2662,2229,115,184
263,levle2_76.jpg,fore,Unspecified,0.0,0,2578,2129,2754,2366,176,237
264,levle2_76.jpg,fore,Unspecified,0.0,0,1145,619,1290,819,145,200
265,levle2_76.jpg,fore,Unspecified,0.0,0,1704,719,1788,903,84,184
266,levle2_76.jpg,fore,Unspecified,0.0,0,1811,796,1980,987,169,191
267,levle2_76.jpg,fore,Unspecified,0.0,0,1474,313,1673,520,199,207
268,levle2_76.jpg,fore,Unspecified,0.0,0,945,320,1099,466,154,146
269,levle2_76.jpg,fore,Unspecified,0.0,0,1106,359,1275,550,169,191
270,levle2_76.jpg,fore,Unspecified,0.0,0,945,642,1022,711,77,69
271,levle2_76.jpg,fore,Unspecified,0.0,0,708,757,876,941,168,184
272,levle2_76.jpg,fore,Unspecified,0.0,0,961,865,1168,1079,207,214
273,levle0_212.jpg,fore,Unspecified,0.0,0,1566,2420,1658,2604,92,184
274,levle0_212.jpg,fore,Unspecified,0.0,0,1934,1156,2102,1294,168,138
275,levle0_206.jpg,fore,Unspecified,0.0,0,1742,2489,1903,2589,161,100
276,levle2_129.jpg,fore,Unspecified,0.0,0,1719,612,1842,734,123,122
277,levle2_129.jpg,fore,Unspecified,0.0,0,1198,880,1344,987,146,107
278,levle2_129.jpg,fore,Unspecified,0.0,0,2478,1209,2585,1294,107,85
279,levle2_129.jpg,fore,Unspecified,0.0,0,2378,1585,2478,1684,100,99
280,levle2_129.jpg,fore,Unspecified,0.0,0,2478,1715,2555,1799,77,84
281,levle2_129.jpg,fore,Unspecified,0.0,0,2432,1807,2578,1899,146,92
282,levle2_129.jpg,fore,Unspecified,0.0,0,2585,1907,2693,1991,108,84
283,levle2_129.jpg,fore,Unspecified,0.0,0,2348,1976,2463,2060,115,84
284,levle2_129.jpg,fore,Unspecified,0.0,0,2256,1899,2363,2014,107,115
285,levle2_129.jpg,fore,Unspecified,0.0,0,2202,2137,2294,2290,92,153
286,levle2_129.jpg,fore,Unspecified,0.0,0,2294,2160,2386,2251,92,91
287,levle2_129.jpg,fore,Unspecified,0.0,0,2286,2267,2394,2374,108,107
288,levle2_129.jpg,fore,Unspecified,0.0,0,2371,2213,2493,2313,122,100
289,levle2_129.jpg,fore,Unspecified,0.0,0,2486,2320,2601,2428,115,108
290,levle2_129.jpg,fore,Unspecified,0.0,0,2601,2366,2700,2466,99,100
291,levle2_129.jpg,fore,Unspecified,0.0,0,1811,2213,1995,2382,184,169
292,levle2_129.jpg,fore,Unspecified,0.0,0,1574,2129,1681,2320,107,191
293,levle2_129.jpg,fore,Unspecified,0.0,0,1627,2359,1727,2458,100,99
294,levle2_129.jpg,fore,Unspecified,0.0,0,1727,2451,1896,2566,169,115
295,levle2_129.jpg,fore,Unspecified,0.0,0,1796,2566,1965,2711,169,145
296,levle2_129.jpg,fore,Unspecified,0.0,0,1926,2451,2049,2520,123,69
297,levle2_129.jpg,fore,Unspecified,0.0,0,2072,2658,2202,2811,130,153
298,levle2_129.jpg,fore,Unspecified,0.0,0,1880,2681,2072,2842,192,161
299,levle2_129.jpg,fore,Unspecified,0.0,0,1995,2857,2148,2972,153,115
300,levle2_129.jpg,fore,Unspecified,0.0,0,1666,2918,1811,3048,145,130
301,levle2_129.jpg,fore,Unspecified,0.0,0,1459,3232,1650,3363,191,131
302,levle2_129.jpg,fore,Unspecified,0.0,0,1834,3133,1988,3278,154,145
303,levle2_129.jpg,fore,Unspecified,0.0,0,2087,3148,2118,3171,31,23
304,levle2_129.jpg,fore,Unspecified,0.0,0,2003,3041,2133,3163,130,122
305,levle1_4.jpg,fore,Unspecified,0.0,0,58,207,97,228,39,21
306,levle1_4.jpg,fore,Unspecified,0.0,0,62,149,101,186,39,37
307,levle1_4.jpg,fore,Unspecified,0.0,0,79,125,112,148,33,23
308,levle1_4.jpg,fore,Unspecified,0.0,0,98,295,139,329,41,34
309,levle1_4.jpg,fore,Unspecified,0.0,0,103,340,142,370,39,30
310,levle1_4.jpg,fore,Unspecified,0.0,0,114,371,150,394,36,23
311,levle1_4.jpg,fore,Unspecified,0.0,0,73,351,104,400,31,49
312,levle1_4.jpg,fore,Unspecified,0.0,0,171,354,202,390,31,36
313,levle1_4.jpg,fore,Unspecified,0.0,0,149,396,191,415,42,19
314,levle1_4.jpg,fore,Unspecified,0.0,0,195,412,222,439,27,27
315,levle1_4.jpg,fore,Unspecified,0.0,0,283,267,293,284,10,17
316,levle1_4.jpg,fore,Unspecified,0.0,0,165,161,217,205,52,44
317,levle1_4.jpg,fore,Unspecified,0.0,0,185,209,225,248,40,39
318,levle2_101.jpg,fore,Unspecified,0.0,0,784,1447,884,1539,100,92
319,levle2_101.jpg,fore,Unspecified,0.0,0,401,1416,532,1562,131,146
320,levle2_101.jpg,fore,Unspecified,0.0,0,294,1661,371,1792,77,131
321,levle2_101.jpg,fore,Unspecified,0.0,0,792,1294,915,1409,123,115
322,levle2_101.jpg,fore,Unspecified,0.0,0,1543,734,1696,910,153,176
323,levle2_101.jpg,fore,Unspecified,0.0,0,1451,910,1581,1041,130,131
324,levle2_101.jpg,fore,Unspecified,0.0,0,1581,1094,1696,1209,115,115
325,levle2_101.jpg,fore,Unspecified,0.0,0,1765,612,1873,734,108,122
326,levle2_101.jpg,fore,Unspecified,0.0,0,1857,681,1949,796,92,115
327,levle2_101.jpg,fore,Unspecified,0.0,0,1298,2527,1443,2658,145,131
328,levle2_101.jpg,fore,Unspecified,0.0,0,1237,2619,1375,2742,138,123
329,levle2_101.jpg,fore,Unspecified,0.0,0,1275,2911,1405,3041,130,130
330,levle2_101.jpg,fore,Unspecified,0.0,0,984,2895,1160,3056,176,161
331,levle2_101.jpg,fore,Unspecified,0.0,0,1459,3255,1535,3416,76,161
332,levle2_101.jpg,fore,Unspecified,0.0,0,1765,3148,1942,3324,177,176
333,levle2_101.jpg,fore,Unspecified,0.0,0,953,2727,1014,2872,61,145
334,levle2_101.jpg,fore,Unspecified,0.0,0,876,2489,991,2581,115,92
335,levle2_101.jpg,fore,Unspecified,0.0,0,815,2573,907,2704,92,131
336,levle2_101.jpg,fore,Unspecified,0.0,0,754,2811,830,2880,76,69
337,levle2_101.jpg,fore,Unspecified,0.0,0,692,2435,754,2566,62,131
338,levle2_101.jpg,fore,Unspecified,0.0,0,578,2474,654,2612,76,138
339,levle2_101.jpg,fore,Unspecified,0.0,0,447,2466,532,2627,85,161
340,levle2_101.jpg,fore,Unspecified,0.0,0,516,2366,654,2474,138,108
341,levle2_101.jpg,fore,Unspecified,0.0,0,432,2259,532,2366,100,107
342,levle2_115.jpg,fore,Unspecified,0.0,0,723,1531,830,1677,107,146
343,levle2_115.jpg,fore,Unspecified,0.0,0,823,1294,922,1439,99,145
344,levle2_115.jpg,fore,Unspecified,0.0,0,654,1156,784,1332,130,176
345,levle2_115.jpg,fore,Unspecified,0.0,0,991,1202,1129,1317,138,115
346,levle2_115.jpg,fore,Unspecified,0.0,0,1750,773,1834,895,84,122
347,levle2_115.jpg,fore,Unspecified,0.0,0,1574,696,1742,811,168,115
348,levle2_115.jpg,fore,Unspecified,0.0,0,1574,842,1635,918,61,76
349,levle2_115.jpg,fore,Unspecified,0.0,0,1635,933,1727,1018,92,85
350,levle2_115.jpg,fore,Unspecified,0.0,0,1658,604,1758,696,100,92
351,levle2_115.jpg,fore,Unspecified,0.0,0,486,2091,608,2221,122,130
352,levle2_115.jpg,fore,Unspecified,0.0,0,708,2144,815,2244,107,100
353,levle2_115.jpg,fore,Unspecified,0.0,0,700,2244,907,2366,207,122
354,levle2_115.jpg,fore,Unspecified,0.0,0,1076,3240,1221,3355,145,115
355,levle2_115.jpg,fore,Unspecified,0.0,0,1237,3163,1367,3347,130,184
356,levle2_115.jpg,fore,Unspecified,0.0,0,1420,3248,1535,3393,115,145
357,levle2_115.jpg,fore,Unspecified,0.0,0,1635,3171,1742,3294,107,123
358,levle2_115.jpg,fore,Unspecified,0.0,0,1666,3301,1788,3355,122,54
359,levle2_115.jpg,fore,Unspecified,0.0,0,777,2466,915,2681,138,215
360,levle2_89.jpg,fore,Unspecified,0.0,0,152,18,158,27,6,9
361,levle2_89.jpg,fore,Unspecified,0.0,0,149,26,158,36,9,10
362,levle2_89.jpg,fore,Unspecified,0.0,0,179,76,195,87,16,11
363,levle2_89.jpg,fore,Unspecified,0.0,0,105,185,111,195,6,10
364,levle2_89.jpg,fore,Unspecified,0.0,0,95,176,103,188,8,12
365,levle2_89.jpg,fore,Unspecified,0.0,0,131,17,144,31,13,14
366,levle2_89.jpg,fore,Unspecified,0.0,0,112,177,123,186,11,9
367,levle2_89.jpg,fore,Unspecified,0.0,0,118,166,129,178,11,12
368,levle2_89.jpg,fore,Unspecified,0.0,0,120,186,133,194,13,8
369,levle2_89.jpg,fore,Unspecified,0.0,0,131,191,140,201,9,10
370,levle2_89.jpg,fore,Unspecified,0.0,0,83,143,98,161,15,18
371,levle2_89.jpg,fore,Unspecified,0.0,0,92,135,106,145,14,10
372,levle2_89.jpg,fore,Unspecified,0.0,0,116,131,133,147,17,16
373,levle2_89.jpg,fore,Unspecified,0.0,0,129,127,142,138,13,11
374,levle2_89.jpg,fore,Unspecified,0.0,0,139,126,152,139,13,13
375,levle2_89.jpg,fore,Unspecified,0.0,0,153,123,170,135,17,12
376,levle2_89.jpg,fore,Unspecified,0.0,0,165,121,178,129,13,8
377,levle2_89.jpg,fore,Unspecified,0.0,0,173,115,186,126,13,11
378,levle2_89.jpg,fore,Unspecified,0.0,0,162,89,180,102,18,13
379,levle2_89.jpg,fore,Unspecified,0.0,0,164,150,183,161,19,11
380,levle2_89.jpg,fore,Unspecified,0.0,0,152,146,167,160,15,14
381,levle2_89.jpg,fore,Unspecified,0.0,0,159,161,174,179,15,18
382,levle2_89.jpg,fore,Unspecified,0.0,0,142,153,153,164,11,11
383,levle2_89.jpg,fore,Unspecified,0.0,0,126,158,145,168,19,10
384,levle1_559.jpg,fore,Unspecified,0.0,0,1581,2964,1742,3133,161,169
385,levle1_203.jpg,fore,Unspecified,0.0,0,1068,1317,1229,1516,161,199
386,levle1_203.jpg,fore,Unspecified,0.0,0,1275,1991,1390,2137,115,146
387,levle1_203.jpg,fore,Unspecified,0.0,0,486,1730,601,1876,115,146
388,levle1_203.jpg,fore,Unspecified,0.0,0,692,2129,807,2313,115,184
389,levle1_203.jpg,fore,Unspecified,0.0,0,991,2566,1083,2658,92,92
390,levle1_203.jpg,fore,Unspecified,0.0,0,899,2796,984,2865,85,69
391,levle1_203.jpg,fore,Unspecified,0.0,0,815,2880,884,3010,69,130
392,levle1_203.jpg,fore,Unspecified,0.0,0,1466,3102,1566,3240,100,138
393,levle1_565.jpg,fore,Unspecified,0.0,0,1811,2359,1980,2458,169,99
394,levle1_565.jpg,fore,Unspecified,0.0,0,1903,2451,2057,2573,154,122
395,levle1_565.jpg,fore,Unspecified,0.0,0,2179,2144,2317,2290,138,146
396,levle1_565.jpg,fore,Unspecified,0.0,0,2455,2137,2585,2229,130,92
397,levle1_565.jpg,fore,Unspecified,0.0,0,2700,2152,2807,2244,107,92
398,levle1_565.jpg,fore,Unspecified,0.0,0,2516,2435,2670,2527,154,92
399,levle1_565.jpg,fore,Unspecified,0.0,0,2386,2343,2509,2443,123,100
400,levle1_565.jpg,fore,Unspecified,0.0,0,2210,2343,2386,2481,176,138
401,levle1_565.jpg,fore,Unspecified,0.0,0,1850,1202,2034,1363,184,161
402,levle1_33.jpg,fore,Unspecified,0.0,0,1099,612,1221,796,122,184
403,levle1_33.jpg,fore,Unspecified,0.0,0,1221,573,1352,658,131,85
404,levle1_33.jpg,fore,Unspecified,0.0,0,1942,796,2049,949,107,153
405,levle1_33.jpg,fore,Unspecified,0.0,0,1942,2167,2079,2351,137,184
406,levle1_33.jpg,fore,Unspecified,0.0,0,1060,2251,1229,2428,169,177
407,levle1_33.jpg,fore,Unspecified,0.0,0,1206,2121,1367,2251,161,130
408,levle1_33.jpg,fore,Unspecified,0.0,0,1382,2244,1505,2351,123,107
409,levle1_33.jpg,fore,Unspecified,0.0,0,1367,2366,1489,2504,122,138
410,levle1_33.jpg,fore,Unspecified,0.0,0,1352,3156,1459,3294,107,138
411,levle1_33.jpg,fore,Unspecified,0.0,0,1704,3133,1857,3240,153,107
412,levle1_33.jpg,fore,Unspecified,0.0,0,424,2734,501,2865,77,131
413,levle1_571.jpg,fore,Unspecified,0.0,0,2217,910,2340,1079,123,169
414,levle1_571.jpg,fore,Unspecified,0.0,0,1122,1363,1252,1516,130,153
415,levle1_571.jpg,fore,Unspecified,0.0,0,1267,1209,1428,1455,161,246
416,levle1_571.jpg,fore,Unspecified,0.0,0,1022,1217,1137,1317,115,100
417,levle1_571.jpg,fore,Unspecified,0.0,0,1037,1071,1206,1171,169,100
418,levle1_571.jpg,fore,Unspecified,0.0,0,907,1033,976,1171,69,138
419,levle1_571.jpg,fore,Unspecified,0.0,0,853,1355,984,1485,131,130
420,levle1_571.jpg,fore,Unspecified,0.0,0,647,1225,784,1378,137,153
421,levle1_571.jpg,fore,Unspecified,0.0,0,578,1501,700,1631,122,130
422,levle1_571.jpg,fore,Unspecified,0.0,0,723,1501,815,1615,92,114
423,levle1_571.jpg,fore,Unspecified,0.0,0,754,1746,869,1838,115,92
424,levle1_571.jpg,fore,Unspecified,0.0,0,823,1822,899,1868,76,46
425,levle1_571.jpg,fore,Unspecified,0.0,0,754,1891,884,2014,130,123
426,levle1_27.jpg,fore,Unspecified,0.0,0,124,101,138,123,14,22
427,levle1_27.jpg,fore,Unspecified,0.0,0,128,193,144,210,16,17
428,levle1_27.jpg,fore,Unspecified,0.0,0,118,248,136,264,18,16
429,levle1_27.jpg,fore,Unspecified,0.0,0,143,265,164,279,21,14
430,levle1_27.jpg,fore,Unspecified,0.0,0,175,202,191,221,16,19
431,levle1_27.jpg,fore,Unspecified,0.0,0,123,296,142,311,19,15
432,levle1_27.jpg,fore,Unspecified,0.0,0,117,315,139,330,22,15
433,levle1_217.jpg,fore,Unspecified,0.0,0,409,1271,585,1386,176,115
434,levle1_217.jpg,fore,Unspecified,0.0,0,478,1148,631,1248,153,100
435,levle1_217.jpg,fore,Unspecified,0.0,0,1298,780,1413,872,115,92
436,levle1_217.jpg,fore,Unspecified,0.0,0,761,2796,846,2895,85,99
437,levle1_217.jpg,fore,Unspecified,0.0,0,838,3010,968,3140,130,130
438,levle1_217.jpg,fore,Unspecified,0.0,0,930,2727,1045,2888,115,161
439,levle1_217.jpg,fore,Unspecified,0.0,0,49,1922,164,2029,115,107
440,levle1_217.jpg,fore,Unspecified,0.0,0,118,1776,325,1930,207,154
441,levle1_217.jpg,fore,Unspecified,0.0,0,141,1547,271,1669,130,122
442,levle1_217.jpg,fore,Unspecified,0.0,0,317,2366,463,2474,146,108
443,levle1_217.jpg,fore,Unspecified,0.0,0,417,2527,516,2604,99,77
444,levle1_217.jpg,fore,Unspecified,0.0,0,516,2566,647,2673,131,107
445,levle1_217.jpg,fore,Unspecified,0.0,0,470,2765,677,2819,207,54
446,levle3_110.jpg,fore,,,0,153,36,164,52,11,16
447,levle3_110.jpg,fore,,,0,144,11,158,23,14,12
448,levle3_110.jpg,fore,,,0,119,18,134,29,15,11
449,levle3_110.jpg,fore,,,0,125,5,138,13,13,8
450,levle3_110.jpg,fore,,,0,130,65,142,76,12,11
451,levle3_110.jpg,fore,,,0,122,68,133,79,11,11
452,levle3_110.jpg,fore,,,0,111,49,123,60,12,11
453,levle3_110.jpg,fore,,,0,161,61,174,73,13,12
454,levle3_110.jpg,fore,,,0,139,78,155,88,16,10
455,levle3_110.jpg,fore,,,0,138,86,153,98,15,12
456,levle3_110.jpg,fore,,,0,155,82,169,96,14,14
457,levle3_110.jpg,fore,,,0,168,83,178,95,10,12
458,levle3_110.jpg,fore,,,0,145,111,159,127,14,16
459,levle3_110.jpg,fore,,,0,113,92,127,108,14,16
460,levle3_110.jpg,fore,,,0,109,75,126,89,17,14
461,levle3_110.jpg,fore,,,0,95,85,111,94,16,9
462,levle3_110.jpg,fore,,,0,73,85,87,96,14,11
463,levle3_110.jpg,fore,,,0,61,78,75,93,14,15
464,levle3_110.jpg,fore,,,0,51,79,64,92,13,13
465,levle3_110.jpg,fore,,,0,80,131,96,144,16,13
466,levle3_110.jpg,fore,,,0,82,143,97,154,15,11
467,levle3_110.jpg,fore,,,0,34,136,47,151,13,15
468,levle3_110.jpg,fore,,,0,99,112,110,126,11,14
469,levle3_110.jpg,fore,,,0,115,113,127,130,12,17
470,levle3_110.jpg,fore,,,0,127,109,141,120,14,11
471,levle3_110.jpg,fore,,,0,111,128,125,142,14,14
472,levle3_110.jpg,fore,,,0,104,140,119,154,15,14
473,levle3_110.jpg,fore,,,0,99,152,112,164,13,12
474,levle3_110.jpg,fore,,,0,72,158,85,170,13,12
475,levle3_110.jpg,fore,,,0,85,174,95,182,10,8
476,levle3_110.jpg,fore,,,0,70,173,85,193,15,20
477,levle3_110.jpg,fore,,,0,98,176,115,187,17,11
478,levle3_110.jpg,fore,,,0,121,141,132,150,11,9
479,levle3_110.jpg,fore,,,0,141,135,156,144,15,9
480,levle3_110.jpg,fore,,,0,123,163,137,171,14,8
481,levle3_110.jpg,fore,,,0,131,157,146,165,15,8
482,levle3_110.jpg,fore,,,0,161,107,182,128,21,21
483,levle3_110.jpg,fore,,,0,85,61,103,75,18,14
484,levle3_110.jpg,fore,,,0,93,72,104,81,11,9
485,levle3_110.jpg,fore,,,0,118,155,133,166,15,11
486,levle3_110.jpg,fore,,,0,146,147,158,158,12,11
487,levle3_110.jpg,fore,,,0,157,155,167,161,10,6
488,levle3_110.jpg,fore,,,0,127,41,141,54,14,13
489,levle3_110.jpg,fore,,,0,146,57,158,67,12,10
490,levle3_110.jpg,fore,,,0,141,27,154,39,13,12
491,levle3_110.jpg,fore,,,0,98,93,111,103,13,10
492,levle3_110.jpg,fore,,,0,64,130,77,142,13,12
493,levle3_110.jpg,fore,,,0,70,121,82,130,12,9
494,levle3_110.jpg,fore,,,0,133,143,146,156,13,13
495,levle3_110.jpg,fore,,,0,124,175,134,185,10,10
496,levle3_110.jpg,fore,,,0,133,172,146,181,13,9
497,levle3_110.jpg,fore,,,0,61,183,75,194,14,11
498,levle3_110.jpg,fore,,,0,144,99,158,112,14,13
499,levle3_110.jpg,fore,,,0,180,79,191,89,11,10
500,levle3_110.jpg,fore,,,0,166,71,182,85,16,14
501,levle3_110.jpg,fore,,,0,144,44,156,56,12,12
502,levle3_110.jpg,fore,,,0,121,60,133,70,12,10
503,levle3_110.jpg,fore,,,0,126,130,138,141,12,11
504,levle3_110.jpg,fore,,,0,50,180,61,188,11,8
505,levle3_110.jpg,fore,,,0,47,187,59,195,12,8
506,levle3_110.jpg,fore,,,0,41,188,47,195,6,7
507,levle3_110.jpg,fore,,,0,33,186,40,195,7,9
508,levle3_110.jpg,fore,,,0,102,186,114,195,12,9
509,levle3_110.jpg,fore,,,0,132,123,143,133,11,10
510,levle3_6.jpg,fore,,,0,199,49,246,110,47,61
511,levle3_6.jpg,fore,,,0,203,12,250,65,47,53
512,levle3_6.jpg,fore,,,0,171,51,197,75,26,24
513,levle3_6.jpg,fore,,,0,150,8,191,53,41,45
514,levle3_6.jpg,fore,,,0,273,31,319,67,46,36
515,levle3_6.jpg,fore,,,0,248,86,291,124,43,38
516,levle3_6.jpg,fore,,,0,287,177,330,228,43,51
517,levle3_6.jpg,fore,,,0,224,288,252,332,28,44
518,levle3_6.jpg,fore,,,0,250,298,287,337,37,39
519,levle3_6.jpg,fore,,,0,213,375,246,414,33,39
520,levle3_6.jpg,fore,,,0,242,361,289,400,47,39
521,levle3_6.jpg,fore,,,0,67,310,136,349,69,39
522,levle3_6.jpg,fore,,,0,28,359,69,398,41,39
523,levle3_6.jpg,fore,,,0,89,400,150,428,61,28
524,levle3_6.jpg,fore,,,0,89,426,130,467,41,41
525,levle3_6.jpg,fore,,,0,67,422,101,461,34,39
526,levle3_6.jpg,fore,,,0,140,414,187,457,47,43
527,levle3_6.jpg,fore,,,0,209,422,262,459,53,37
528,levle3_6.jpg,fore,,,0,220,469,240,504,20,35
529,levle3_6.jpg,fore,,,0,234,506,277,532,43,26
530,levle3_6.jpg,fore,,,0,264,524,297,557,33,33
531,levle3_6.jpg,fore,,,0,185,490,230,553,45,63
532,levle3_6.jpg,fore,,,0,205,590,252,632,47,42
533,levle3_6.jpg,fore,,,0,264,575,326,618,62,43
534,levle3_6.jpg,fore,,,0,191,245,224,290,33,45
535,levle3_6.jpg,fore,,,0,130,286,197,341,67,55
536,levle3_6.jpg,fore,,,0,160,318,220,381,60,63
537,levle3_6.jpg,fore,,,0,110,533,139,570,29,37
538,levle3_6.jpg,fore,,,0,116,498,147,533,31,35
539,levle3_6.jpg,fore,,,0,152,495,181,531,29,36
540,levle3_6.jpg,fore,,,0,89,362,120,386,31,24
541,levle3_6.jpg,fore,,,0,4,415,33,444,29,29
542,levle3_6.jpg,fore,,,0,287,225,324,260,37,35
543,levle3_6.jpg,fore,,,0,95,601,133,625,38,24
544,levle3_6.jpg,fore,,,0,161,554,186,584,25,30
545,levle3_6.jpg,fore,,,0,34,654,63,680,29,26
546,levle3_6.jpg,fore,,,0,6,701,41,733,35,32
547,levle3_6.jpg,fore,,,0,158,740,184,770,26,30
548,levle3_6.jpg,fore,,,0,185,636,230,680,45,44
549,levle3_6.jpg,fore,,,0,123,615,154,646,31,31
550,levle3_6.jpg,fore,,,0,69,684,98,717,29,33
551,levle3_6.jpg,fore,,,0,92,693,123,726,31,33
552,levle3_6.jpg,fore,,,0,195,706,230,730,35,24
553,levle3_6.jpg,fore,,,0,204,666,239,705,35,39
554,levle3_6.jpg,fore,,,0,250,655,275,679,25,24
555,levle3_6.jpg,fore,,,0,325,603,358,640,33,37
556,levle3_6.jpg,fore,,,0,69,470,102,495,33,25
557,levle3_6.jpg,fore,,,0,156,392,192,429,36,37
558,levle3_6.jpg,fore,,,0,299,404,326,432,27,28
559,levle3_6.jpg,fore,,,0,308,474,340,507,32,33
560,levle3_6.jpg,fore,,,0,1,648,21,673,20,25
561,levle3_6.jpg,fore,,,0,191,741,226,766,35,25
562,levle3_6.jpg,fore,,,0,144,686,181,722,37,36
563,levle3_6.jpg,fore,,,0,270,631,300,664,30,33
564,levle3_6.jpg,fore,,,0,290,614,319,636,29,22
565,levle3_6.jpg,fore,,,0,330,564,356,594,26,30
566,levle3_6.jpg,fore,,,0,298,434,324,459,26,25
567,levle3_6.jpg,fore,,,0,242,404,276,436,34,32
568,levle3_6.jpg,fore,,,0,324,329,354,361,30,32
569,levle3_6.jpg,fore,,,0,85,784,134,819,49,35
570,levle3_6.jpg,fore,,,0,106,759,134,787,28,28
571,levle3_6.jpg,fore,,,0,84,725,117,752,33,27
572,levle3_6.jpg,fore,,,0,149,772,179,802,30,30
573,levle3_6.jpg,fore,,,0,64,500,101,537,37,37
574,levle3_6.jpg,fore,,,0,126,563,161,596,35,33
575,levle3_104.jpg,fore,Unspecified,0.0,0,293,3,331,23,38,20
576,levle3_104.jpg,fore,Unspecified,0.0,0,69,226,101,263,32,37
577,levle3_104.jpg,fore,Unspecified,0.0,0,6,319,33,340,27,21
578,levle3_104.jpg,fore,Unspecified,0.0,0,19,340,49,362,30,22
579,levle3_104.jpg,fore,Unspecified,0.0,0,9,279,46,308,37,29
580,levle3_104.jpg,fore,Unspecified,0.0,0,327,382,364,430,37,48
581,levle3_104.jpg,fore,Unspecified,0.0,0,22,419,70,452,48,33
582,levle3_104.jpg,fore,Unspecified,0.0,0,54,412,96,433,42,21
583,levle3_104.jpg,fore,Unspecified,0.0,0,461,196,503,241,42,45
584,levle3_104.jpg,fore,Unspecified,0.0,0,267,226,306,279,39,53
585,levle3_104.jpg,fore,Unspecified,0.0,0,221,220,283,273,62,53
586,levle3_104.jpg,fore,Unspecified,0.0,0,174,321,235,374,61,53
587,levle3_104.jpg,fore,Unspecified,0.0,0,97,329,149,366,52,37
588,levle3_104.jpg,fore,Unspecified,0.0,0,99,366,134,414,35,48
589,levle3_104.jpg,fore,Unspecified,0.0,0,75,443,118,471,43,28
590,levle3_104.jpg,fore,Unspecified,0.0,0,59,500,112,552,53,52
591,levle3_104.jpg,fore,Unspecified,0.0,0,115,491,165,544,50,53
592,levle3_104.jpg,fore,Unspecified,0.0,0,125,439,181,492,56,53
593,levle3_104.jpg,fore,Unspecified,0.0,0,8,548,53,595,45,47
594,levle3_104.jpg,fore,Unspecified,0.0,0,65,556,125,601,60,45
595,levle3_104.jpg,fore,Unspecified,0.0,0,99,593,155,632,56,39
596,levle3_104.jpg,fore,Unspecified,0.0,0,131,621,179,662,48,41
597,levle3_104.jpg,fore,Unspecified,0.0,0,170,593,221,635,51,42
598,levle3_104.jpg,fore,Unspecified,0.0,0,160,561,194,592,34,31
599,levle3_104.jpg,fore,Unspecified,0.0,0,179,534,224,566,45,32
600,levle3_104.jpg,fore,Unspecified,0.0,0,235,548,263,584,28,36
601,levle3_104.jpg,fore,Unspecified,0.0,0,213,580,267,629,54,49
602,levle3_104.jpg,fore,Unspecified,0.0,0,229,462,266,511,37,49
603,levle3_104.jpg,fore,Unspecified,0.0,0,189,497,235,532,46,35
604,levle3_104.jpg,fore,Unspecified,0.0,0,229,419,267,459,38,40
605,levle3_104.jpg,fore,Unspecified,0.0,0,182,417,235,467,53,50
606,levle3_104.jpg,fore,Unspecified,0.0,0,279,443,311,470,32,27
607,levle3_104.jpg,fore,Unspecified,0.0,0,259,465,306,500,47,35
608,levle3_104.jpg,fore,Unspecified,0.0,0,250,499,304,544,54,45
609,levle3_104.jpg,fore,Unspecified,0.0,0,312,513,359,548,47,35
610,levle3_104.jpg,fore,Unspecified,0.0,0,285,552,339,584,54,32
611,levle3_104.jpg,fore,Unspecified,0.0,0,341,287,378,340,37,53
612,levle3_104.jpg,fore,Unspecified,0.0,0,315,478,359,516,44,38
613,levle3_104.jpg,fore,Unspecified,0.0,0,386,314,412,362,26,48
614,levle3_104.jpg,fore,Unspecified,0.0,0,408,319,452,359,44,40
615,levle3_104.jpg,fore,Unspecified,0.0,0,407,249,440,290,33,41
616,levle3_104.jpg,fore,Unspecified,0.0,0,429,241,468,281,39,40
617,levle3_104.jpg,fore,Unspecified,0.0,0,396,191,442,221,46,30
618,levle3_104.jpg,fore,Unspecified,0.0,0,455,316,476,351,21,35
619,levle3_104.jpg,fore,Unspecified,0.0,0,468,311,500,338,32,27
620,levle3_104.jpg,fore,Unspecified,0.0,0,428,354,468,407,40,53
621,levle3_104.jpg,fore,Unspecified,0.0,0,465,358,490,388,25,30
622,levle3_104.jpg,fore,Unspecified,0.0,0,474,382,503,406,29,24
623,levle3_104.jpg,fore,Unspecified,0.0,0,381,402,418,441,37,39
624,levle3_104.jpg,fore,Unspecified,0.0,0,416,430,448,451,32,21
625,levle3_104.jpg,fore,Unspecified,0.0,0,370,439,420,483,50,44
626,levle3_104.jpg,fore,Unspecified,0.0,0,365,470,394,497,29,27
627,levle3_104.jpg,fore,Unspecified,0.0,0,381,489,429,521,48,32
628,levle3_105.jpg,fore,,,0,286,112,312,141,26,29
629,levle3_105.jpg,fore,,,0,234,57,271,121,37,64
630,levle3_105.jpg,fore,,,0,213,119,260,151,47,32
631,levle3_105.jpg,fore,,,0,268,144,303,178,35,34
632,levle3_105.jpg,fore,,,0,197,15,218,39,21,24
633,levle3_105.jpg,fore,,,0,223,28,251,59,28,31
634,levle3_105.jpg,fore,,,0,258,27,288,72,30,45
635,levle3_105.jpg,fore,,,0,292,197,322,228,30,31
636,levle3_105.jpg,fore,,,0,282,234,318,266,36,32
637,levle3_105.jpg,fore,,,0,199,206,254,233,55,27
638,levle3_105.jpg,fore,,,0,194,173,238,202,44,29
639,levle3_105.jpg,fore,,,0,154,165,210,206,56,41
640,levle3_105.jpg,fore,,,0,114,165,161,198,47,33
641,levle3_105.jpg,fore,,,0,143,329,174,358,31,29
642,levle3_105.jpg,fore,,,0,146,375,174,411,28,36
643,levle3_105.jpg,fore,,,0,227,361,251,391,24,30
644,levle3_105.jpg,fore,,,0,252,311,288,349,36,38
645,levle3_105.jpg,fore,,,0,275,290,308,322,33,32
646,levle3_105.jpg,fore,,,0,290,322,336,351,46,29
647,levle3_105.jpg,fore,,,0,316,272,355,310,39,38
648,levle3_105.jpg,fore,,,0,330,197,363,230,33,33
649,levle3_105.jpg,fore,,,0,340,237,364,266,24,29
650,levle3_105.jpg,fore,,,0,203,233,238,254,35,21
651,levle3_105.jpg,fore,,,0,271,200,287,225,16,25
652,levle3_105.jpg,fore,,,0,111,415,125,441,14,26
653,levle3_105.jpg,fore,,,0,70,495,101,520,31,25
654,levle3_105.jpg,fore,,,0,223,321,250,338,27,17
655,levle3_105.jpg,fore,,,0,222,496,254,518,32,22
656,levle3_105.jpg,fore,,,0,248,486,292,512,44,26
657,levle3_105.jpg,fore,,,0,228,429,264,464,36,35
658,levle3_105.jpg,fore,,,0,203,407,230,425,27,18
659,levle3_105.jpg,fore,,,0,72,244,103,278,31,34
660,levle3_105.jpg,fore,,,0,98,225,133,265,35,40
661,levle3_105.jpg,fore,,,0,103,261,133,285,30,24
662,levle3_105.jpg,fore,,,0,77,282,113,307,36,25
663,levle3_105.jpg,fore,,,0,82,331,125,374,43,43
664,levle3_105.jpg,fore,,,0,130,213,163,245,33,32
665,levle3_105.jpg,fore,,,0,150,237,182,282,32,45
666,levle3_105.jpg,fore,,,0,155,284,181,300,26,16
667,levle3_105.jpg,fore,,,0,187,273,217,303,30,30
668,levle3_105.jpg,fore,,,0,167,355,199,378,32,23
669,levle3_105.jpg,fore,,,0,199,369,228,398,29,29
670,levle3_105.jpg,fore,,,0,302,355,330,379,28,24
671,levle3_105.jpg,fore,,,0,318,399,344,426,26,27
672,levle3_105.jpg,fore,,,0,274,403,312,423,38,20
673,levle3_105.jpg,fore,,,0,270,437,306,455,36,18
674,levle3_105.jpg,fore,,,0,275,458,310,488,35,30
675,levle3_105.jpg,fore,,,0,243,184,278,201,35,17
676,levle3_105.jpg,fore,,,0,248,165,287,182,39,17
677,levle3_105.jpg,fore,,,0,135,54,156,69,21,15
678,levle3_105.jpg,fore,,,0,164,137,193,164,29,27
679,levle3_105.jpg,fore,,,0,84,197,112,220,28,23
680,levle3_111.jpg,fore,,,0,2489,1011,2577,1108,88,97
681,levle3_111.jpg,fore,,,0,2507,880,2603,959,96,79
682,levle3_111.jpg,fore,,,0,2270,959,2410,1082,140,123
683,levle3_111.jpg,fore,,,0,2174,1143,2402,1196,228,53
684,levle3_111.jpg,fore,,,0,2077,959,2209,1073,132,114
685,levle3_111.jpg,fore,,,0,1954,1213,2060,1327,106,114
686,levle3_111.jpg,fore,,,0,1832,1178,1954,1248,122,70
687,levle3_111.jpg,fore,,,0,1840,1266,1963,1397,123,131
688,levle3_111.jpg,fore,,,0,1735,1441,1911,1608,176,167
689,levle3_111.jpg,fore,,,0,1726,1687,1832,1818,106,131
690,levle3_111.jpg,fore,,,0,1832,1792,1954,1924,122,132
691,levle3_111.jpg,fore,,,0,1779,1924,1893,2029,114,105
692,levle3_111.jpg,fore,,,0,1884,1880,1981,2029,97,149
693,levle3_111.jpg,fore,,,0,2016,1862,2156,1994,140,132
694,levle3_111.jpg,fore,,,0,1902,2108,2077,2257,175,149
695,levle3_111.jpg,fore,,,0,1832,2213,1919,2389,87,176
696,levle3_111.jpg,fore,,,0,1954,2213,2060,2353,106,140
697,levle3_111.jpg,fore,,,0,2095,1968,2244,2134,149,166
698,levle3_111.jpg,fore,,,0,2253,1810,2375,1897,122,87
699,levle3_111.jpg,fore,,,0,2235,1950,2340,2029,105,79
700,levle3_111.jpg,fore,,,0,2489,1985,2568,2099,79,114
701,levle3_111.jpg,fore,,,0,2568,1976,2691,2064,123,88
702,levle3_111.jpg,fore,,,0,2244,2239,2358,2371,114,132
703,levle3_111.jpg,fore,,,0,2402,2239,2454,2318,52,79
704,levle3_111.jpg,fore,,,0,2419,2362,2498,2424,79,62
705,levle3_111.jpg,fore,,,0,2060,2327,2235,2450,175,123
706,levle3_111.jpg,fore,,,0,2253,2397,2402,2511,149,114
707,levle3_111.jpg,fore,,,0,1710,2363,1827,2488,117,125
708,levle3_111.jpg,fore,,,0,1951,1415,2017,1467,66,52
709,levle3_111.jpg,fore,,,0,1922,1465,1983,1510,61,45
710,levle3_111.jpg,fore,,,0,1924,1510,1990,1551,66,41
711,levle3_111.jpg,fore,,,0,1908,1542,1981,1597,73,55
712,levle3_111.jpg,fore,,,0,1949,1842,2017,1901,68,59
713,levle3_111.jpg,fore,,,0,2144,2163,2219,2219,75,56
714,levle3_111.jpg,fore,,,0,2179,2115,2252,2181,73,66
715,levle3_111.jpg,fore,,,0,2329,1933,2422,2019,93,86
716,levle3_111.jpg,fore,,,0,1785,2065,1863,2149,78,84
717,levle3_111.jpg,fore,,,0,1835,2035,1929,2104,94,69
718,levle3_111.jpg,fore,,,0,1942,2056,2015,2117,73,61
719,levle3_111.jpg,fore,,,0,1988,1997,2076,2104,88,107
720,levle3_111.jpg,fore,,,0,2040,2079,2117,2144,77,65
721,levle3_111.jpg,fore,,,0,2065,2151,2138,2217,73,66
722,levle3_111.jpg,fore,,,0,2415,2435,2488,2488,73,53
723,levle3_111.jpg,fore,,,0,2354,2310,2433,2376,79,66
724,levle3_111.jpg,fore,,,0,2458,2265,2542,2333,84,68
725,levle3_111.jpg,fore,,,0,1733,1626,1810,1692,77,66
726,levle3_111.jpg,fore,,,0,2365,951,2463,1026,98,75
727,levle3_111.jpg,fore,,,0,2699,1097,2785,1167,86,70
728,levle3_111.jpg,fore,,,0,2765,1138,2842,1206,77,68
729,levle3_111.jpg,fore,,,0,2769,1081,2847,1144,78,63
730,levle3_111.jpg,fore,,,0,2640,1229,2726,1313,86,84
731,levle3_111.jpg,fore,,,0,2533,1206,2615,1290,82,84
732,levle3_111.jpg,fore,,,0,2642,1131,2697,1210,55,79
733,levle3_111.jpg,fore,,,0,2665,1154,2751,1222,86,68
734,levle3_111.jpg,fore,,,0,2590,2344,2644,2419,54,75
735,levle3_111.jpg,fore,,,0,2617,2367,2683,2449,66,82
736,levle3_111.jpg,fore,,,0,1651,2281,1717,2347,66,66
737,levle3_111.jpg,fore,,,0,2024,1774,2113,1833,89,59
738,levle3_111.jpg,fore,,,0,2185,1888,2265,1960,80,72
739,levle3_111.jpg,fore,,,0,2154,2204,2249,2294,95,90
740,levle3_111.jpg,fore,,,0,2356,2231,2424,2315,68,84
741,levle3_111.jpg,fore,,,0,2042,2254,2133,2338,91,84
742,levle3_7.jpg,fore,,,0,466,530,495,561,29,31
743,levle3_7.jpg,fore,,,0,432,530,466,563,34,33
744,levle3_7.jpg,fore,,,0,415,402,440,432,25,30
745,levle3_7.jpg,fore,,,0,456,569,517,626,61,57
746,levle3_7.jpg,fore,,,0,397,606,438,649,41,43
747,levle3_7.jpg,fore,,,0,387,590,428,634,41,44
748,levle3_7.jpg,fore,,,0,368,557,405,575,37,18
749,levle3_7.jpg,fore,,,0,336,583,383,628,47,45
750,levle3_7.jpg,fore,,,0,307,596,340,616,33,20
751,levle3_7.jpg,fore,,,0,305,565,338,598,33,33
752,levle3_7.jpg,fore,,,0,309,536,350,573,41,37
753,levle3_7.jpg,fore,,,0,258,506,305,555,47,49
754,levle3_7.jpg,fore,,,0,289,481,307,506,18,25
755,levle3_7.jpg,fore,,,0,319,467,360,502,41,35
756,levle3_7.jpg,fore,,,0,309,428,348,461,39,33
757,levle3_7.jpg,fore,,,0,250,471,291,512,41,41
758,levle3_7.jpg,fore,,,0,234,400,279,443,45,43
759,levle3_7.jpg,fore,,,0,266,573,303,612,37,39
760,levle3_7.jpg,fore,,,0,258,616,305,647,47,31
761,levle3_7.jpg,fore,,,0,283,636,315,681,32,45
762,levle3_7.jpg,fore,,,0,309,638,350,677,41,39
763,levle3_7.jpg,fore,,,0,334,645,368,679,34,34
764,levle3_7.jpg,fore,,,0,358,657,391,694,33,37
765,levle3_7.jpg,fore,,,0,405,673,460,710,55,37
766,levle3_7.jpg,fore,,,0,368,692,417,743,49,51
767,levle3_7.jpg,fore,,,0,279,292,311,343,32,51
768,levle3_7.jpg,fore,,,0,305,249,338,304,33,55
769,levle3_7.jpg,fore,,,0,295,212,330,255,35,43
770,levle3_7.jpg,fore,,,0,340,196,364,237,24,41
771,levle3_7.jpg,fore,,,0,354,216,391,257,37,41
772,levle3_7.jpg,fore,,,0,346,167,381,204,35,37
773,levle3_7.jpg,fore,,,0,360,186,399,224,39,38
774,levle3_7.jpg,fore,,,0,395,184,430,220,35,36
775,levle3_7.jpg,fore,,,0,362,114,393,153,31,39
776,levle3_7.jpg,fore,,,0,391,153,432,192,41,39
777,levle3_7.jpg,fore,,,0,421,157,456,190,35,33
778,levle3_7.jpg,fore,,,0,421,108,468,147,47,39
779,levle3_7.jpg,fore,,,0,450,182,487,218,37,36
780,levle3_7.jpg,fore,,,0,319,718,358,753,39,35
781,levle3_7.jpg,fore,,,0,199,557,238,600,39,43
782,levle3_7.jpg,fore,,,0,489,215,519,244,30,29
783,levle3_7.jpg,fore,,,0,546,225,580,250,34,25
784,levle3_7.jpg,fore,,,0,525,208,554,238,29,30
785,levle3_7.jpg,fore,,,0,490,191,531,212,41,21
786,levle3_7.jpg,fore,,,0,366,415,392,451,26,36
787,levle3_7.jpg,fore,,,0,404,648,441,677,37,29
788,levle3_7.jpg,fore,,,0,333,794,361,821,28,27
789,levle3_7.jpg,fore,,,0,345,776,375,796,30,20
790,levle3_7.jpg,fore,,,0,399,503,437,540,38,37
791,levle3_7.jpg,fore,,,0,300,506,327,531,27,25
792,levle3_7.jpg,fore,,,0,546,166,587,196,41,30
793,levle3_7.jpg,fore,,,0,242,559,275,591,33,32
794,levle3_7.jpg,fore,,,0,382,390,411,415,29,25
795,levle3_7.jpg,fore,,,0,401,546,439,578,38,32
796,levle3_7.jpg,fore,,,0,459,631,489,670,30,39
797,levle3_7.jpg,fore,,,0,380,252,409,283,29,31
798,levle3_7.jpg,fore,,,0,322,328,360,358,38,30
799,levle3_7.jpg,fore,,,0,332,366,367,397,35,31
800,levle1_26.jpg,fore,Unspecified,0.0,0,261,268,276,282,15,14
801,levle1_26.jpg,fore,Unspecified,0.0,0,239,292,261,312,22,20
802,levle1_26.jpg,fore,Unspecified,0.0,0,239,314,256,331,17,17
803,levle1_26.jpg,fore,Unspecified,0.0,0,231,328,268,342,37,14
804,levle1_26.jpg,fore,Unspecified,0.0,0,272,393,294,415,22,22
805,levle1_26.jpg,fore,Unspecified,0.0,0,212,377,232,399,20,22
806,levle1_570.jpg,fore,Unspecified,0.0,0,922,1317,1068,1470,146,153
807,levle1_570.jpg,fore,Unspecified,0.0,0,892,1148,1053,1278,161,130
808,levle1_570.jpg,fore,Unspecified,0.0,0,800,995,899,1125,99,130
809,levle1_570.jpg,fore,Unspecified,0.0,0,746,1309,915,1439,169,130
810,levle1_570.jpg,fore,Unspecified,0.0,0,777,1485,1007,1707,230,222
811,levle1_570.jpg,fore,Unspecified,0.0,0,938,1876,1083,2037,145,161
812,levle1_570.jpg,fore,Unspecified,0.0,0,1206,2029,1375,2167,169,138
813,levle1_570.jpg,fore,Unspecified,0.0,0,1221,1753,1390,1953,169,200
814,levle1_570.jpg,fore,Unspecified,0.0,0,1742,2612,1865,2742,123,130
815,levle1_570.jpg,fore,Unspecified,0.0,0,1244,2926,1367,3071,123,145
816,levle1_216.jpg,fore,Unspecified,0.0,0,1635,2520,1742,2688,107,168
817,levle1_216.jpg,fore,Unspecified,0.0,0,1443,2550,1543,2681,100,131
818,levle1_216.jpg,fore,Unspecified,0.0,0,1551,2903,1635,3071,84,168
819,levle1_216.jpg,fore,Unspecified,0.0,0,1972,2466,2095,2612,123,146
820,levle1_216.jpg,fore,Unspecified,0.0,0,1873,2259,2011,2397,138,138
821,levle1_216.jpg,fore,Unspecified,0.0,0,1520,642,1673,803,153,161
822,levle1_216.jpg,fore,Unspecified,0.0,0,2156,2696,2263,2803,107,107
823,levle1_216.jpg,fore,Unspecified,0.0,0,2348,2389,2470,2558,122,169
824,levle1_202.jpg,fore,Unspecified,0.0,0,1926,2121,2057,2274,131,153
825,levle1_202.jpg,fore,Unspecified,0.0,0,1942,2497,2102,2673,160,176
826,levle1_202.jpg,fore,Unspecified,0.0,0,2601,2137,2731,2251,130,114
827,levle1_202.jpg,fore,Unspecified,0.0,0,2202,2842,2286,2949,84,107
828,levle1_202.jpg,fore,Unspecified,0.0,0,2187,3071,2325,3209,138,138
829,levle1_202.jpg,fore,Unspecified,0.0,0,2394,2466,2516,2650,122,184
830,levle1_32.jpg,fore,Unspecified,0.0,0,2072,1240,2225,1416,153,176
831,levle1_32.jpg,fore,Unspecified,0.0,0,2034,1094,2125,1240,91,146
832,levle1_32.jpg,fore,Unspecified,0.0,0,1221,1478,1313,1592,92,114
833,levle1_32.jpg,fore,Unspecified,0.0,0,1988,2274,2110,2435,122,161
834,levle1_32.jpg,fore,Unspecified,0.0,0,2570,2106,2746,2305,176,199
835,levle1_32.jpg,fore,Unspecified,0.0,0,2171,2504,2371,2658,200,154
836,levle1_32.jpg,fore,Unspecified,0.0,0,1811,2581,1949,2727,138,146
837,levle1_32.jpg,fore,Unspecified,0.0,0,2194,3064,2317,3225,123,161
838,levle1_32.jpg,fore,Unspecified,0.0,0,1183,3064,1298,3225,115,161
839,levle1_32.jpg,fore,Unspecified,0.0,0,1375,3125,1497,3317,122,192
840,levle1_32.jpg,fore,Unspecified,0.0,0,815,2206,961,2359,146,153
841,levle1_564.jpg,fore,Unspecified,0.0,0,1382,964,1566,1041,184,77
842,levle1_564.jpg,fore,Unspecified,0.0,0,1604,926,1689,1018,85,92
843,levle1_564.jpg,fore,Unspecified,0.0,0,1712,933,1796,1048,84,115
844,levle1_564.jpg,fore,Unspecified,0.0,0,1727,1332,1827,1439,100,107
845,levle1_564.jpg,fore,Unspecified,0.0,0,915,2006,1030,2144,115,138
846,levle1_564.jpg,fore,Unspecified,0.0,0,723,2351,830,2443,107,92
847,levle1_564.jpg,fore,Unspecified,0.0,0,1007,2359,1191,2512,184,153
848,levle1_564.jpg,fore,Unspecified,0.0,0,1214,2420,1283,2512,69,92
849,levle1_564.jpg,fore,Unspecified,0.0,0,1367,2282,1482,2382,115,100
850,levle1_564.jpg,fore,Unspecified,0.0,0,1260,2121,1413,2206,153,85
851,levle1_564.jpg,fore,Unspecified,0.0,0,984,2550,1068,2665,84,115
852,levle1_564.jpg,fore,Unspecified,0.0,0,455,2175,570,2313,115,138
853,levle1_558.jpg,fore,Unspecified,0.0,0,738,1991,884,2106,146,115
854,levle1_558.jpg,fore,Unspecified,0.0,0,26,1922,171,2052,145,130
855,levle1_558.jpg,fore,Unspecified,0.0,0,562,2022,784,2259,222,237
856,levle1_558.jpg,fore,Unspecified,0.0,0,578,2389,708,2520,130,131
857,levle1_558.jpg,fore,Unspecified,0.0,0,700,2604,784,2757,84,153
858,levle1_558.jpg,fore,Unspecified,0.0,0,754,2466,861,2566,107,100
859,levle1_558.jpg,fore,Unspecified,0.0,0,570,2826,647,2934,77,108
860,levle1_558.jpg,fore,Unspecified,0.0,0,509,2842,570,2918,61,76
861,levle1_558.jpg,fore,Unspecified,0.0,0,233,2596,355,2742,122,146
862,levle1_558.jpg,fore,Unspecified,0.0,0,217,2412,340,2550,123,138
863,levle2_88.jpg,fore,,,0,1191,2704,1298,2865,107,161
864,levle2_88.jpg,fore,,,0,1474,2389,1589,2520,115,131
865,levle2_88.jpg,fore,,,0,1321,2244,1459,2397,138,153
866,levle2_88.jpg,fore,,,0,1237,2374,1352,2512,115,138
867,levle2_88.jpg,fore,,,0,1014,2336,1214,2489,200,153
868,levle2_88.jpg,fore,,,0,1014,2221,1129,2351,115,130
869,levle2_88.jpg,fore,,,0,1014,2060,1198,2183,184,123
870,levle2_88.jpg,fore,,,0,1030,1930,1152,2060,122,130
871,levle2_88.jpg,fore,,,0,861,1439,1030,1615,169,176
872,levle2_88.jpg,fore,,,0,830,1677,945,1815,115,138
873,levle2_88.jpg,fore,,,0,846,1945,999,2060,153,115
874,levle2_88.jpg,fore,,,0,2248,933,2424,1133,176,200
875,levle2_88.jpg,fore,,,0,1972,742,2049,903,77,161
876,levle2_88.jpg,fore,,,0,2057,711,2179,880,122,169
877,levle2_88.jpg,fore,,,0,1949,527,2110,704,161,177
878,levle2_88.jpg,fore,,,0,2325,773,2447,941,122,168
879,levle2_88.jpg,fore,,,0,2064,3002,2148,3133,84,131
880,levle2_88.jpg,fore,,,0,2133,2995,2256,3117,123,122
881,levle2_88.jpg,fore,,,0,1873,3079,1988,3163,115,84
882,levle2_88.jpg,fore,,,0,1505,2539,1674,2688,169,149
883,levle2_88.jpg,fore,,,0,1143,2225,1277,2339,134,114
884,levle2_114.jpg,fore,Unspecified,0.0,0,2486,2297,2593,2428,107,131
885,levle2_114.jpg,fore,Unspecified,0.0,0,2624,2098,2723,2305,99,207
886,levle2_114.jpg,fore,Unspecified,0.0,0,2417,2183,2562,2313,145,130
887,levle2_114.jpg,fore,Unspecified,0.0,0,1842,3025,1965,3140,123,115
888,levle2_114.jpg,fore,Unspecified,0.0,0,1689,3156,1850,3240,161,84
889,levle2_114.jpg,fore,Unspecified,0.0,0,1076,941,1221,1064,145,123
890,levle2_114.jpg,fore,Unspecified,0.0,0,1175,765,1329,918,154,153
891,levle2_114.jpg,fore,Unspecified,0.0,0,2555,1462,2677,1608,122,146
892,levle2_114.jpg,fore,Unspecified,0.0,0,2463,1370,2585,1508,122,138
893,levle2_114.jpg,fore,Unspecified,0.0,0,2125,1010,2256,1202,131,192
894,levle2_114.jpg,fore,Unspecified,0.0,0,1758,3248,1865,3347,107,99
895,levle1_5.jpg,fore,Unspecified,0.0,0,162,195,184,222,22,27
896,levle1_5.jpg,fore,Unspecified,0.0,0,292,195,315,217,23,22
897,levle1_5.jpg,fore,Unspecified,0.0,0,313,244,337,275,24,31
898,levle1_5.jpg,fore,Unspecified,0.0,0,190,234,209,250,19,16
899,levle1_5.jpg,fore,Unspecified,0.0,0,232,296,270,319,38,23
900,levle1_5.jpg,fore,Unspecified,0.0,0,282,279,309,301,27,22
901,levle1_5.jpg,fore,Unspecified,0.0,0,166,329,189,352,23,23
902,levle1_5.jpg,fore,Unspecified,0.0,0,216,313,241,345,25,32
903,levle1_5.jpg,fore,Unspecified,0.0,0,224,362,249,386,25,24
904,levle1_5.jpg,fore,Unspecified,0.0,0,261,383,292,405,31,22
905,levle1_5.jpg,fore,Unspecified,0.0,0,239,400,265,417,26,17
906,levle1_5.jpg,fore,Unspecified,0.0,0,220,403,233,421,13,18
907,levle1_5.jpg,fore,Unspecified,0.0,0,209,415,224,437,15,22
908,levle1_5.jpg,fore,Unspecified,0.0,0,243,436,255,457,12,21
909,levle1_5.jpg,fore,Unspecified,0.0,0,268,436,284,463,16,27
910,levle2_100.jpg,fore,,,0,1796,359,1926,474,130,115
911,levle2_100.jpg,fore,,,0,1965,167,2164,328,199,161
912,levle2_100.jpg,fore,,,0,961,2144,1191,2343,230,199
913,levle2_100.jpg,fore,,,0,1183,1094,1321,1209,138,115
914,levle2_100.jpg,fore,,,0,1198,2075,1397,2244,199,169
915,levle2_100.jpg,fore,,,0,1037,1891,1214,2068,177,177
916,levle2_100.jpg,fore,,,0,1397,2343,1451,2397,54,54
917,levle2_100.jpg,fore,,,0,1290,2320,1390,2412,100,92
918,levle2_100.jpg,fore,,,0,1313,2466,1466,2642,153,176
919,levle2_100.jpg,fore,,,0,1413,2834,1520,2926,107,92
920,levle2_100.jpg,fore,,,0,1375,2949,1528,3048,153,99
921,levle2_100.jpg,fore,,,0,1466,2282,1612,2428,146,146
922,levle2_100.jpg,fore,,,0,1643,2359,1788,2520,145,161
923,levle2_100.jpg,fore,,,0,1735,2206,1903,2336,168,130
924,levle2_100.jpg,fore,,,0,1742,2504,1911,2665,169,161
925,levle2_100.jpg,fore,,,0,1635,2144,1796,2305,161,161
926,levle2_100.jpg,fore,,,0,2348,1010,2493,1186,145,176
927,levle2_100.jpg,fore,,,0,2348,696,2486,865,138,169
928,levle2_100.jpg,fore,,,0,1160,3174,1322,3305,162,131
929,levle2_100.jpg,fore,,,0,984,2029,1115,2170,131,141
930,levle2_100.jpg,fore,,,0,1474,2443,1653,2601,179,158
931,levle2_128.jpg,fore,Unspecified,0.0,0,1352,2075,1474,2190,122,115
932,levle2_128.jpg,fore,Unspecified,0.0,0,164,1692,294,1815,130,123
933,levle2_128.jpg,fore,Unspecified,0.0,0,424,1125,516,1263,92,138
934,levle2_128.jpg,fore,Unspecified,0.0,0,792,964,876,1048,84,84
935,levle2_128.jpg,fore,Unspecified,0.0,0,892,2650,976,2742,84,92
936,levle2_128.jpg,fore,Unspecified,0.0,0,1175,3064,1298,3202,123,138
937,levle2_128.jpg,fore,Unspecified,0.0,0,1045,3324,1160,3432,115,108
938,levle2_128.jpg,fore,Unspecified,0.0,0,815,3286,915,3378,100,92
939,levle2_128.jpg,fore,Unspecified,0.0,0,1359,3133,1451,3294,92,161
940,levle2_128.jpg,fore,Unspecified,0.0,0,1451,3194,1597,3332,146,138
941,levle2_128.jpg,fore,Unspecified,0.0,0,1643,3232,1765,3340,122,108
942,levle2_128.jpg,fore,Unspecified,0.0,0,1620,3033,1804,3209,184,176
943,levle2_128.jpg,fore,Unspecified,0.0,0,1160,3248,1267,3378,107,130
944,levle2_128.jpg,fore,Unspecified,0.0,0,547,3148,792,3309,245,161
945,levle0_207.jpg,fore,Unspecified,0.0,0,647,2474,769,2696,122,222
946,levle0_213.jpg,fore,Unspecified,0.0,0,1168,1240,1237,1355,69,115
947,levle0_213.jpg,fore,Unspecified,0.0,0,2217,2573,2325,2681,108,108
948,levle2_77.jpg,fore,,,0,1658,1891,1850,2098,192,207
949,levle2_77.jpg,fore,,,0,1397,2681,1497,2857,100,176
950,levle2_77.jpg,fore,,,0,1352,2022,1489,2190,137,168
951,levle2_77.jpg,fore,,,0,1206,1700,1459,1999,253,299
952,levle2_77.jpg,fore,,,0,907,1876,1183,2060,276,184
953,levle2_77.jpg,fore,,,0,685,1968,800,2114,115,146
954,levle2_77.jpg,fore,,,0,555,2068,715,2282,160,214
955,levle2_77.jpg,fore,,,0,486,1853,631,2060,145,207
956,levle2_77.jpg,fore,,,0,271,1592,470,1815,199,223
957,levle2_77.jpg,fore,,,0,1129,428,1267,596,138,168
958,levle2_77.jpg,fore,,,0,1397,175,1597,389,200,214
959,levle2_77.jpg,fore,,,0,1704,137,1850,282,146,145
960,levle2_77.jpg,fore,,,0,1903,251,2049,343,146,92
961,levle2_77.jpg,fore,,,0,1942,389,2279,481,337,92
962,levle2_77.jpg,fore,,,0,1942,474,2171,727,229,253
963,levle2_77.jpg,fore,,,0,2302,466,2470,673,168,207
964,levle2_77.jpg,fore,,,0,2018,834,2164,1018,146,184
965,levle2_77.jpg,fore,,,0,815,2129,1045,2359,230,230
966,levle2_77.jpg,fore,,,0,1064,2822,1240,2950,176,128
967,levle2_77.jpg,fore,,,0,1129,2729,1274,2839,145,110
968,levle2_77.jpg,fore,,,0,874,2274,1008,2394,134,120
969,levle2_63.jpg,fore,Unspecified,0.0,0,2625,870,2708,961,83,91
970,levle2_63.jpg,fore,Unspecified,0.0,0,2749,945,2841,1044,92,99
971,levle2_63.jpg,fore,Unspecified,0.0,0,1478,2125,1603,2216,125,91
972,levle2_63.jpg,fore,Unspecified,0.0,0,1461,1992,1544,2125,83,133
973,levle2_63.jpg,fore,Unspecified,0.0,0,1694,1792,1835,1950,141,158
974,levle2_63.jpg,fore,Unspecified,0.0,0,1802,1684,1935,1768,133,84
975,levle2_63.jpg,fore,Unspecified,0.0,0,1860,1734,1943,1859,83,125
976,levle2_63.jpg,fore,Unspecified,0.0,0,1885,1851,1943,1950,58,99
977,levle2_63.jpg,fore,Unspecified,0.0,0,2110,1784,2292,1901,182,117
978,levle2_63.jpg,fore,Unspecified,0.0,0,2101,1925,2226,2017,125,92
979,levle2_63.jpg,fore,Unspecified,0.0,0,2043,2034,2134,2208,91,174
980,levle2_63.jpg,fore,Unspecified,0.0,0,2242,1784,2459,1917,217,133
981,levle2_63.jpg,fore,Unspecified,0.0,0,2409,1809,2592,1942,183,133
982,levle2_63.jpg,fore,Unspecified,0.0,0,2334,2133,2484,2299,150,166
983,levle2_63.jpg,fore,Unspecified,0.0,0,2093,2383,2226,2516,133,133
984,levle2_63.jpg,fore,Unspecified,0.0,0,2301,2383,2500,2582,199,199
985,levle2_63.jpg,fore,Unspecified,0.0,0,2650,2050,2824,2225,174,175
986,levle2_63.jpg,fore,Unspecified,0.0,0,1802,2075,1918,2208,116,133
987,levle2_63.jpg,fore,Unspecified,0.0,0,1968,1792,2118,1925,150,133
988,levle2_63.jpg,fore,Unspecified,0.0,0,1902,1892,2085,2092,183,200
989,levle2_63.jpg,fore,Unspecified,0.0,0,1744,2150,1877,2308,133,158
990,levle2_63.jpg,fore,Unspecified,0.0,0,2276,1992,2384,2133,108,141
991,levle2_63.jpg,fore,Unspecified,0.0,0,2459,2050,2708,2175,249,125
992,levle0_99.jpg,fore,Unspecified,0.0,0,2593,1286,2800,1524,207,238
993,levle0_99.jpg,fore,Unspecified,0.0,0,2470,1822,2532,1868,62,46
994,levle0_398.jpg,fore,Unspecified,0.0,0,899,2428,976,2573,77,145
995,levle0_373.jpg,fore,Unspecified,0.0,0,670,2068,815,2221,145,153
996,levle1_160.jpg,fore,,,0,1030,1608,1237,1707,207,99
997,levle1_160.jpg,fore,,,0,2003,1853,2125,1960,122,107
998,levle1_160.jpg,fore,,,0,2179,1654,2279,1776,100,122
999,levle1_160.jpg,fore,,,0,2271,1569,2340,1677,69,108
1000,levle1_160.jpg,fore,,,0,1612,1753,1765,1937,153,184
1001,levle1_160.jpg,fore,,,0,2533,938,2632,1022,99,84
1002,levle1_606.jpg,fore,Unspecified,0.0,0,631,1439,846,1600,215,161
1003,levle1_606.jpg,fore,Unspecified,0.0,0,1911,849,2049,972,138,123
1004,levle1_606.jpg,fore,Unspecified,0.0,0,1397,2305,1497,2428,100,123
1005,levle1_606.jpg,fore,Unspecified,0.0,0,1451,2566,1574,2642,123,76
1006,levle1_606.jpg,fore,Unspecified,0.0,0,1076,2788,1298,2926,222,138
1007,levle1_606.jpg,fore,Unspecified,0.0,0,915,2757,1045,2888,130,131
1008,levle1_606.jpg,fore,Unspecified,0.0,0,708,2834,930,3041,222,207
1009,levle1_606.jpg,fore,Unspecified,0.0,0,708,2627,838,2711,130,84
1010,levle1_606.jpg,fore,Unspecified,0.0,0,853,2251,945,2351,92,100
1011,levle1_606.jpg,fore,Unspecified,0.0,0,578,2075,723,2160,145,85
1012,levle1_606.jpg,fore,Unspecified,0.0,0,1060,2106,1160,2190,100,84
1013,levle1_606.jpg,fore,Unspecified,0.0,0,670,2282,784,2412,114,130
1014,levle1_606.jpg,fore,Unspecified,0.0,0,325,1769,493,1960,168,191
1015,levle1_606.jpg,fore,Unspecified,0.0,0,470,2274,601,2397,131,123
1016,levle0_415.jpg,fore,Unspecified,0.0,0,1344,489,1566,688,222,199
1017,levle0_415.jpg,fore,Unspecified,0.0,0,1482,2098,1673,2259,191,161
1018,levle1_612.jpg,fore,Unspecified,0.0,0,2708,2068,2838,2167,130,99
1019,levle1_612.jpg,fore,Unspecified,0.0,0,2693,2190,2930,2397,237,207
1020,levle1_612.jpg,fore,Unspecified,0.0,0,2125,2903,2279,3110,154,207
1021,levle1_612.jpg,fore,Unspecified,0.0,0,1865,2934,1988,3033,123,99
1022,levle1_612.jpg,fore,Unspecified,0.0,0,1965,2842,2095,2987,130,145
1023,levle1_612.jpg,fore,Unspecified,0.0,0,1574,2995,1612,3094,38,99
1024,levle1_612.jpg,fore,Unspecified,0.0,0,1750,3018,1834,3071,84,53
1025,levle1_612.jpg,fore,Unspecified,0.0,0,1834,3071,1980,3194,146,123
1026,levle1_612.jpg,fore,Unspecified,0.0,0,2869,1255,2976,1347,107,92
1027,levle1_612.jpg,fore,Unspecified,0.0,0,2846,1156,2938,1225,92,69
1028,levle1_612.jpg,fore,Unspecified,0.0,0,2800,796,2930,887,130,91
1029,levle1_612.jpg,fore,Unspecified,0.0,0,938,734,1014,826,76,92
1030,levle1_612.jpg,fore,Unspecified,0.0,0,1168,1117,1306,1255,138,138
1031,levle1_612.jpg,fore,Unspecified,0.0,0,1390,1554,1482,1700,92,146
1032,levle0_401.jpg,fore,Unspecified,0.0,0,945,2803,1099,2949,154,146
1033,levle0_401.jpg,fore,Unspecified,0.0,0,723,2129,876,2328,153,199
1034,levle0_401.jpg,fore,Unspecified,0.0,0,1995,2481,2118,2573,123,92
1035,levle0_401.jpg,fore,Unspecified,0.0,0,447,2558,647,2834,200,276
1036,levle0_401.jpg,fore,Unspecified,0.0,0,2286,543,2440,742,154,199
1037,levle0_367.jpg,fore,Unspecified,0.0,0,1666,2903,1758,3064,92,161
1038,levle0_367.jpg,fore,Unspecified,0.0,0,1298,2152,1405,2405,107,253
1039,levle1_174.jpg,fore,Unspecified,0.0,0,286,2075,348,2229,62,154
1040,levle1_174.jpg,fore,Unspecified,0.0,0,409,2106,493,2267,84,161
1041,levle1_174.jpg,fore,Unspecified,0.0,0,501,2428,601,2558,100,130
1042,levle1_174.jpg,fore,Unspecified,0.0,0,631,2451,708,2535,77,84
1043,levle1_174.jpg,fore,Unspecified,0.0,0,1336,305,1482,466,146,161
1044,levle1_174.jpg,fore,Unspecified,0.0,0,1390,573,1451,681,61,108
1045,levle1_174.jpg,fore,Unspecified,0.0,0,1903,750,2034,872,131,122
1046,levle1_174.jpg,fore,Unspecified,0.0,0,1957,880,2064,1018,107,138
1047,levle1_174.jpg,fore,Unspecified,0.0,0,1796,550,1926,711,130,161
1048,levle1_174.jpg,fore,Unspecified,0.0,0,1995,328,2110,497,115,169
1049,levle1_174.jpg,fore,Unspecified,0.0,0,2125,719,2233,819,108,100
1050,levle1_174.jpg,fore,Unspecified,0.0,0,2256,972,2348,1102,92,130
1051,levle0_429.jpg,fore,Unspecified,0.0,0,440,1202,601,1501,161,299
1052,levle0_429.jpg,fore,Unspecified,0.0,0,1735,811,1873,964,138,153
1053,levle0_72.jpg,fore,Unspecified,0.0,0,4520,496,4753,770,233,274
1054,levle0_66.jpg,fore,Unspecified,0.0,0,1569,2698,1752,2848,183,150
1055,levle0_66.jpg,fore,Unspecified,0.0,0,1785,2873,1960,3097,175,224
1056,levle0_66.jpg,fore,Unspecified,0.0,0,2351,2391,2691,2632,340,241
1057,levle1_389.jpg,fore,Unspecified,0.0,0,754,1907,922,2006,168,99
1058,levle1_389.jpg,fore,Unspecified,0.0,0,915,1914,1053,2068,138,154
1059,levle1_389.jpg,fore,Unspecified,0.0,0,815,2083,976,2198,161,115
1060,levle1_389.jpg,fore,Unspecified,0.0,0,1114,2029,1244,2206,130,177
1061,levle1_389.jpg,fore,Unspecified,0.0,0,1313,2083,1466,2236,153,153
1062,levle1_389.jpg,fore,Unspecified,0.0,0,1336,2251,1497,2366,161,115
1063,levle1_389.jpg,fore,Unspecified,0.0,0,884,2573,999,2773,115,200
1064,levle1_389.jpg,fore,Unspecified,0.0,0,968,2481,1152,2635,184,154
1065,levle1_389.jpg,fore,Unspecified,0.0,0,1030,2642,1168,2757,138,115
1066,levle1_389.jpg,fore,Unspecified,0.0,0,1122,2750,1244,2979,122,229
1067,levle1_404.jpg,fore,Unspecified,0.0,0,424,2757,593,2918,169,161
1068,levle1_404.jpg,fore,Unspecified,0.0,0,692,2949,838,3117,146,168
1069,levle1_404.jpg,fore,Unspecified,0.0,0,892,2987,999,3179,107,192
1070,levle1_404.jpg,fore,Unspecified,0.0,0,984,2995,1191,3110,207,115
1071,levle1_404.jpg,fore,Unspecified,0.0,0,1045,3117,1168,3194,123,77
1072,levle1_404.jpg,fore,Unspecified,0.0,0,1014,3194,1160,3286,146,92
1073,levle1_404.jpg,fore,Unspecified,0.0,0,1237,3156,1390,3278,153,122
1074,levle3_23.jpg,fore,,,0,383,90,444,151,61,61
1075,levle3_23.jpg,fore,,,0,251,339,295,398,44,59
1076,levle3_23.jpg,fore,,,0,292,312,356,359,64,47
1077,levle3_23.jpg,fore,,,0,397,784,451,832,54,48
1078,levle3_23.jpg,fore,,,0,187,762,248,813,61,51
1079,levle3_23.jpg,fore,,,0,300,539,346,598,46,59
1080,levle3_23.jpg,fore,,,0,346,459,402,515,56,56
1081,levle3_23.jpg,fore,,,0,431,217,473,281,42,64
1082,levle3_23.jpg,fore,,,0,334,376,395,447,61,71
1083,levle3_23.jpg,fore,,,0,270,398,324,481,54,83
1084,levle3_23.jpg,fore,,,0,444,549,507,605,63,56
1085,levle3_23.jpg,fore,,,0,473,632,529,701,56,69
1086,levle3_23.jpg,fore,,,0,331,576,405,657,74,81
1087,levle3_23.jpg,fore,,,0,302,696,375,754,73,58
1088,levle3_23.jpg,fore,,,0,456,698,534,766,78,68
1089,levle3_23.jpg,fore,,,0,441,749,507,815,66,66
1090,levle3_23.jpg,fore,,,0,314,752,368,823,54,71
1091,levle3_23.jpg,fore,,,0,253,737,319,805,66,68
1092,levle3_23.jpg,fore,,,0,229,803,307,879,78,76
1093,levle3_23.jpg,fore,,,0,356,871,427,935,71,64
1094,levle3_23.jpg,fore,,,0,449,840,553,903,104,63
1095,levle3_23.jpg,fore,,,0,461,920,512,962,51,42
1096,levle3_23.jpg,fore,,,0,612,925,700,996,88,71
1097,levle3_23.jpg,fore,,,0,578,632,644,710,66,78
1098,levle3_23.jpg,fore,,,0,517,615,571,679,54,64
1099,levle3_23.jpg,fore,,,0,400,610,478,679,78,69
1100,levle3_23.jpg,fore,,,0,562,126,604,172,42,46
1101,levle3_23.jpg,fore,,,0,358,173,417,227,59,54
1102,levle3_23.jpg,fore,,,0,272,492,334,528,62,36
1103,levle3_23.jpg,fore,,,0,229,581,282,630,53,49
1104,levle3_23.jpg,fore,,,0,537,815,581,857,44,42
1105,levle3_23.jpg,fore,,,0,632,838,680,873,48,35
1106,levle3_23.jpg,fore,,,0,692,833,731,878,39,45
1107,levle3_23.jpg,fore,,,0,764,573,811,626,47,53
1108,levle3_23.jpg,fore,,,0,631,541,664,574,33,33
1109,levle3_23.jpg,fore,,,0,661,537,717,579,56,42
1110,levle3_23.jpg,fore,,,0,639,581,697,629,58,48
1111,levle3_23.jpg,fore,,,0,627,479,661,511,34,32
1112,levle3_23.jpg,fore,,,0,652,497,683,526,31,29
1113,levle3_23.jpg,fore,,,0,668,362,707,394,39,32
1114,levle3_23.jpg,fore,,,0,581,250,627,297,46,47
1115,levle3_23.jpg,fore,,,0,487,105,535,149,48,44
1116,levle3_23.jpg,fore,,,0,276,883,335,939,59,56
1117,levle3_23.jpg,fore,,,0,198,705,242,745,44,40
1118,levle3_23.jpg,fore,,,0,376,686,426,773,50,87
1119,levle3_23.jpg,fore,,,0,201,906,242,950,41,44
1120,levle3_23.jpg,fore,,,0,241,974,308,1042,67,68
1121,levle3_23.jpg,fore,,,0,524,979,578,1035,54,56
1122,levle3_23.jpg,fore,,,0,556,916,617,970,61,54
1123,levle3_23.jpg,fore,,,0,487,771,560,831,73,60
1124,levle3_23.jpg,fore,,,0,330,539,368,579,38,40
1125,levle3_23.jpg,fore,,,0,467,973,514,1013,47,40
1126,levle3_23.jpg,fore,,,0,417,538,454,572,37,34
1127,levle3_23.jpg,fore,,,0,404,506,443,546,39,40
1128,levle3_23.jpg,fore,,,0,445,513,495,552,50,39
1129,levle3_23.jpg,fore,,,0,648,272,686,299,38,27
1130,levle3_23.jpg,fore,,,0,380,235,434,299,54,64
1131,levle3_23.jpg,fore,,,0,329,261,383,315,54,54
1132,levle3_23.jpg,fore,,,0,346,322,393,373,47,51
1133,levle3_23.jpg,fore,,,0,374,300,424,352,50,52
1134,levle3_23.jpg,fore,,,0,227,456,271,499,44,43
1135,levle3_23.jpg,fore,,,0,223,510,263,560,40,50
1136,levle3_23.jpg,fore,,,0,381,940,418,986,37,46
1137,levle3_23.jpg,fore,,,0,342,963,391,1016,49,53
1138,levle1_362.jpg,fore,Unspecified,0.0,0,1612,2934,1719,3087,107,153
1139,levle1_362.jpg,fore,Unspecified,0.0,0,1420,2857,1512,3018,92,161
1140,levle1_362.jpg,fore,Unspecified,0.0,0,1719,2972,1819,3102,100,130
1141,levle1_362.jpg,fore,Unspecified,0.0,0,1911,2711,2102,2872,191,161
1142,levle1_362.jpg,fore,Unspecified,0.0,0,2110,2826,2210,3018,100,192
1143,levle1_362.jpg,fore,Unspecified,0.0,0,2087,2612,2233,2780,146,168
1144,levle1_362.jpg,fore,Unspecified,0.0,0,2233,2773,2340,2934,107,161
1145,levle0_171.jpg,fore,Unspecified,0.0,0,532,2167,685,2290,153,123
1146,levle1_376.jpg,fore,Unspecified,0.0,0,378,1738,593,1976,215,238
1147,levle1_376.jpg,fore,Unspecified,0.0,0,256,1784,332,1953,76,169
1148,levle1_376.jpg,fore,Unspecified,0.0,0,263,1960,378,2121,115,161
1149,levle1_376.jpg,fore,Unspecified,0.0,0,79,1845,240,2068,161,223
1150,levle1_376.jpg,fore,Unspecified,0.0,0,202,2320,302,2451,100,131
1151,levle1_376.jpg,fore,Unspecified,0.0,0,64,2397,171,2566,107,169
1152,levle1_376.jpg,fore,Unspecified,0.0,0,386,2558,486,2727,100,169
1153,levle1_376.jpg,fore,Unspecified,0.0,0,723,2612,830,2803,107,191
1154,levle1_376.jpg,fore,Unspecified,0.0,0,685,3048,784,3186,99,138
1155,levle0_165.jpg,fore,Unspecified,0.0,0,1765,2045,1896,2183,131,138
1156,levle0_165.jpg,fore,Unspecified,0.0,0,1627,2305,1773,2451,146,146
1157,levle0_165.jpg,fore,Unspecified,0.0,0,2072,2558,2164,2719,92,161
1158,levle3_37.jpg,fore,Unspecified,0.0,0,117,36,124,44,7,8
1159,levle3_37.jpg,fore,Unspecified,0.0,0,131,36,139,44,8,8
1160,levle3_37.jpg,fore,Unspecified,0.0,0,124,15,132,22,8,7
1161,levle3_37.jpg,fore,Unspecified,0.0,0,137,3,144,13,7,10
1162,levle3_37.jpg,fore,Unspecified,0.0,0,107,7,120,16,13,9
1163,levle3_37.jpg,fore,Unspecified,0.0,0,111,15,119,24,8,9
1164,levle3_37.jpg,fore,Unspecified,0.0,0,105,26,113,33,8,7
1165,levle3_37.jpg,fore,Unspecified,0.0,0,97,17,102,23,5,6
1166,levle3_37.jpg,fore,Unspecified,0.0,0,75,4,91,16,16,12
1167,levle3_37.jpg,fore,Unspecified,0.0,0,79,18,85,24,6,6
1168,levle3_37.jpg,fore,Unspecified,0.0,0,74,24,82,31,8,7
1169,levle3_37.jpg,fore,Unspecified,0.0,0,91,24,102,33,11,9
1170,levle3_37.jpg,fore,Unspecified,0.0,0,86,31,90,38,4,7
1171,levle3_37.jpg,fore,Unspecified,0.0,0,80,44,87,51,7,7
1172,levle3_37.jpg,fore,Unspecified,0.0,0,69,47,78,54,9,7
1173,levle3_37.jpg,fore,Unspecified,0.0,0,59,31,67,36,8,5
1174,levle3_37.jpg,fore,Unspecified,0.0,0,47,38,55,47,8,9
1175,levle3_37.jpg,fore,Unspecified,0.0,0,62,47,70,56,8,9
1176,levle3_37.jpg,fore,Unspecified,0.0,0,50,49,57,58,7,9
1177,levle3_37.jpg,fore,Unspecified,0.0,0,62,58,68,63,6,5
1178,levle3_37.jpg,fore,Unspecified,0.0,0,75,65,84,71,9,6
1179,levle3_37.jpg,fore,Unspecified,0.0,0,66,66,71,73,5,7
1180,levle3_37.jpg,fore,Unspecified,0.0,0,83,73,90,80,7,7
1181,levle3_37.jpg,fore,Unspecified,0.0,0,93,87,102,97,9,10
1182,levle3_37.jpg,fore,Unspecified,0.0,0,126,90,139,99,13,9
1183,levle3_37.jpg,fore,Unspecified,0.0,0,110,59,115,68,5,9
1184,levle3_37.jpg,fore,Unspecified,0.0,0,117,47,124,58,7,11
1185,levle3_37.jpg,fore,Unspecified,0.0,0,117,64,125,74,8,10
1186,levle3_37.jpg,fore,Unspecified,0.0,0,158,35,166,44,8,9
1187,levle3_37.jpg,fore,Unspecified,0.0,0,158,69,169,82,11,13
1188,levle3_37.jpg,fore,Unspecified,0.0,0,150,78,158,84,8,6
1189,levle3_37.jpg,fore,Unspecified,0.0,0,169,98,175,104,6,6
1190,levle3_37.jpg,fore,Unspecified,0.0,0,172,110,183,120,11,10
1191,levle3_37.jpg,fore,Unspecified,0.0,0,175,96,183,105,8,9
1192,levle3_37.jpg,fore,Unspecified,0.0,0,192,96,201,105,9,9
1193,levle3_37.jpg,fore,Unspecified,0.0,0,44,91,52,98,8,7
1194,levle3_37.jpg,fore,Unspecified,0.0,0,57,101,66,111,9,10
1195,levle3_37.jpg,fore,Unspecified,0.0,0,68,117,84,133,16,16
1196,levle3_37.jpg,fore,Unspecified,0.0,0,86,120,96,129,10,9
1197,levle3_37.jpg,fore,Unspecified,0.0,0,106,129,114,141,8,12
1198,levle3_37.jpg,fore,Unspecified,0.0,0,106,143,112,151,6,8
1199,levle3_37.jpg,fore,Unspecified,0.0,0,95,136,102,144,7,8
1200,levle3_37.jpg,fore,Unspecified,0.0,0,56,146,66,155,10,9
1201,levle3_37.jpg,fore,Unspecified,0.0,0,45,115,58,127,13,12
1202,levle3_37.jpg,fore,Unspecified,0.0,0,134,104,141,111,7,7
1203,levle3_37.jpg,fore,Unspecified,0.0,0,35,66,42,75,7,9
1204,levle3_37.jpg,fore,Unspecified,0.0,0,106,49,115,58,9,9
1205,levle3_37.jpg,fore,Unspecified,0.0,0,95,35,108,44,13,9
1206,levle3_37.jpg,fore,Unspecified,0.0,0,93,51,102,61,9,10
1207,levle3_37.jpg,fore,Unspecified,0.0,0,87,65,94,71,7,6
1208,levle3_37.jpg,fore,Unspecified,0.0,0,93,77,102,85,9,8
1209,levle3_37.jpg,fore,Unspecified,0.0,0,108,71,114,80,6,9
1210,levle3_37.jpg,fore,Unspecified,0.0,0,63,89,71,97,8,8
1211,levle3_37.jpg,fore,Unspecified,0.0,0,33,106,44,117,11,11
1212,levle3_37.jpg,fore,Unspecified,0.0,0,139,83,146,92,7,9
1213,levle1_410.jpg,fore,Unspecified,0.0,0,807,2543,984,2688,177,145
1214,levle1_410.jpg,fore,Unspecified,0.0,0,647,2129,823,2290,176,161
1215,levle1_410.jpg,fore,Unspecified,0.0,0,1091,3217,1298,3340,207,123
1216,levle1_410.jpg,fore,Unspecified,0.0,0,1704,3278,1865,3424,161,146
1217,levle1_410.jpg,fore,Unspecified,0.0,0,340,2221,532,2405,192,184
1218,levle1_410.jpg,fore,Unspecified,0.0,0,1152,780,1298,926,146,146
1219,levle0_159.jpg,fore,Unspecified,0.0,0,1030,2336,1191,2543,161,207
1220,levle1_348.jpg,fore,Unspecified,0.0,0,1137,2006,1260,2137,123,131
1221,levle1_348.jpg,fore,Unspecified,0.0,0,1880,2037,2041,2137,161,100
1222,levle1_348.jpg,fore,Unspecified,0.0,0,1827,2144,1949,2290,122,146
1223,levle1_348.jpg,fore,Unspecified,0.0,0,1949,2297,2102,2443,153,146
1224,levle1_348.jpg,fore,Unspecified,0.0,0,1804,2382,1972,2535,168,153
1225,levle1_348.jpg,fore,Unspecified,0.0,0,1681,2558,1857,2704,176,146
1226,levle1_348.jpg,fore,Unspecified,0.0,0,1528,2267,1727,2489,199,222
1227,levle0_173.jpg,fore,Unspecified,0.0,0,1811,1654,1949,1769,138,115
1228,levle1_360.jpg,fore,Unspecified,0.0,0,1758,2911,1857,3079,99,168
1229,levle1_360.jpg,fore,Unspecified,0.0,0,2095,2711,2271,2842,176,131
1230,levle1_360.jpg,fore,Unspecified,0.0,0,1696,2727,1781,2895,85,168
1231,levle1_360.jpg,fore,Unspecified,0.0,0,1321,2750,1474,2941,153,191
1232,levle3_21.jpg,fore,Unspecified,0.0,0,403,116,437,145,34,29
1233,levle3_21.jpg,fore,Unspecified,0.0,0,341,121,369,157,28,36
1234,levle3_21.jpg,fore,Unspecified,0.0,0,378,156,425,201,47,45
1235,levle3_21.jpg,fore,Unspecified,0.0,0,277,238,300,273,23,35
1236,levle3_21.jpg,fore,Unspecified,0.0,0,215,211,257,256,42,45
1237,levle3_21.jpg,fore,Unspecified,0.0,0,155,368,214,401,59,33
1238,levle3_21.jpg,fore,Unspecified,0.0,0,58,373,91,404,33,31
1239,levle3_21.jpg,fore,Unspecified,0.0,0,59,309,97,347,38,38
1240,levle3_21.jpg,fore,Unspecified,0.0,0,238,102,281,129,43,27
1241,levle3_21.jpg,fore,Unspecified,0.0,0,385,67,446,89,61,22
1242,levle3_21.jpg,fore,Unspecified,0.0,0,236,89,251,104,15,15
1243,levle3_21.jpg,fore,Unspecified,0.0,0,221,49,257,84,36,35
1244,levle3_21.jpg,fore,Unspecified,0.0,0,201,176,225,206,24,30
1245,levle3_21.jpg,fore,Unspecified,0.0,0,113,197,152,255,39,58
1246,levle3_21.jpg,fore,Unspecified,0.0,0,164,174,191,209,27,35
1247,levle3_21.jpg,fore,Unspecified,0.0,0,175,250,215,287,40,37
1248,levle3_21.jpg,fore,Unspecified,0.0,0,201,332,221,353,20,21
1249,levle3_21.jpg,fore,Unspecified,0.0,0,239,315,292,354,53,39
1250,levle3_21.jpg,fore,Unspecified,0.0,0,149,466,185,509,36,43
1251,levle3_21.jpg,fore,Unspecified,0.0,0,64,472,117,518,53,46
1252,levle3_21.jpg,fore,Unspecified,0.0,0,247,398,296,446,49,48
1253,levle3_21.jpg,fore,Unspecified,0.0,0,288,419,333,450,45,31
1254,levle3_21.jpg,fore,Unspecified,0.0,0,290,300,319,342,29,42
1255,levle3_21.jpg,fore,Unspecified,0.0,0,237,153,261,180,24,27
1256,levle3_21.jpg,fore,Unspecified,0.0,0,308,212,341,250,33,38
1257,levle3_21.jpg,fore,Unspecified,0.0,0,134,383,178,426,44,43
1258,levle1_406.jpg,fore,Unspecified,0.0,0,1773,1409,1850,1547,77,138
1259,levle1_406.jpg,fore,Unspecified,0.0,0,1535,750,1704,887,169,137
1260,levle1_406.jpg,fore,Unspecified,0.0,0,1658,481,1804,635,146,154
1261,levle1_406.jpg,fore,Unspecified,0.0,0,792,734,876,910,84,176
1262,levle1_406.jpg,fore,Unspecified,0.0,0,378,1186,639,1340,261,154
1263,levle1_406.jpg,fore,Unspecified,0.0,0,447,1355,585,1478,138,123
1264,levle1_406.jpg,fore,Unspecified,0.0,0,846,2627,1022,2742,176,115
1265,levle1_406.jpg,fore,Unspecified,0.0,0,547,2773,670,2949,123,176
1266,levle1_406.jpg,fore,Unspecified,0.0,0,999,2328,1152,2466,153,138
1267,levle1_412.jpg,fore,Unspecified,0.0,0,2432,1225,2570,1370,138,145
1268,levle1_412.jpg,fore,Unspecified,0.0,0,2516,1753,2647,1853,131,100
1269,levle1_412.jpg,fore,Unspecified,0.0,0,2547,1899,2731,2045,184,146
1270,levle1_412.jpg,fore,Unspecified,0.0,0,2677,2029,2823,2160,146,131
1271,levle1_412.jpg,fore,Unspecified,0.0,0,2348,2589,2455,2719,107,130
1272,levle1_412.jpg,fore,Unspecified,0.0,0,2302,2888,2455,2964,153,76
1273,levle1_412.jpg,fore,Unspecified,0.0,0,2662,2481,2731,2573,69,92
1274,levle1_412.jpg,fore,Unspecified,0.0,0,2662,2351,2861,2520,199,169
1275,levle1_412.jpg,fore,Unspecified,0.0,0,1122,3202,1206,3324,84,122
1276,levle1_412.jpg,fore,Unspecified,0.0,0,1413,3317,1589,3370,176,53
1277,levle0_167.jpg,fore,Unspecified,0.0,0,1068,2796,1229,2956,161,160
1278,levle1_374.jpg,fore,Unspecified,0.0,0,2179,1171,2363,1370,184,199
1279,levle1_374.jpg,fore,Unspecified,0.0,0,2057,903,2194,1102,137,199
1280,levle1_374.jpg,fore,Unspecified,0.0,0,1949,803,2110,1010,161,207
1281,levle1_374.jpg,fore,Unspecified,0.0,0,2830,1753,2976,1876,146,123
1282,levle1_374.jpg,fore,Unspecified,0.0,0,2769,1930,2922,2114,153,184
1283,levle1_374.jpg,fore,Unspecified,0.0,0,2784,2152,2976,2305,192,153
1284,levle1_374.jpg,fore,Unspecified,0.0,0,2003,2719,2179,2888,176,169
1285,levle1_374.jpg,fore,Unspecified,0.0,0,2057,2949,2164,3018,107,69
1286,levle1_374.jpg,fore,Unspecified,0.0,0,2455,1960,2593,2129,138,169
1287,levle1_374.jpg,fore,Unspecified,0.0,0,2555,1861,2723,2006,168,145
1288,levle1_374.jpg,fore,Unspecified,0.0,0,2547,1554,2746,1761,199,207
1289,levle0_198.jpg,fore,Unspecified,0.0,0,1198,114,1420,282,222,168
1290,levle0_198.jpg,fore,Unspecified,0.0,0,700,658,953,926,253,268
1291,levle0_198.jpg,fore,Unspecified,0.0,0,1919,2964,2102,3056,183,92
1292,levle0_70.jpg,fore,Unspecified,0.0,0,3015,2092,3198,2258,183,166
1293,levle0_70.jpg,fore,Unspecified,0.0,0,2633,2673,2866,2906,233,233
1294,levle1_638.jpg,fore,Unspecified,0.0,0,42,138,51,145,9,7
1295,levle1_638.jpg,fore,Unspecified,0.0,0,46,145,57,153,11,8
1296,levle1_638.jpg,fore,Unspecified,0.0,0,52,130,63,143,11,13
1297,levle1_638.jpg,fore,Unspecified,0.0,0,69,136,82,143,13,7
1298,levle1_638.jpg,fore,Unspecified,0.0,0,66,143,79,153,13,10
1299,levle1_638.jpg,fore,Unspecified,0.0,0,60,158,70,169,10,11
1300,levle1_638.jpg,fore,Unspecified,0.0,0,81,157,86,171,5,14
1301,levle1_638.jpg,fore,Unspecified,0.0,0,86,152,106,164,20,12
1302,levle1_638.jpg,fore,Unspecified,0.0,0,89,163,105,181,16,18
1303,levle1_638.jpg,fore,Unspecified,0.0,0,153,109,172,125,19,16
1304,levle0_359.jpg,fore,Unspecified,0.0,0,1704,3294,1811,3439,107,145
1305,levle0_64.jpg,fore,Unspecified,0.0,0,2184,1086,2342,1269,158,183
1306,levle0_64.jpg,fore,Unspecified,0.0,0,3099,1319,3232,1551,133,232
1307,levle0_417.jpg,fore,Unspecified,0.0,0,2263,1240,2386,1340,123,100
1308,levle0_417.jpg,fore,Unspecified,0.0,0,2286,1577,2386,1700,100,123
1309,levle0_417.jpg,fore,Unspecified,0.0,0,1405,2926,1528,3048,123,122
1310,levle0_417.jpg,fore,Unspecified,0.0,0,2708,2029,2807,2152,99,123
1311,levle1_604.jpg,fore,Unspecified,0.0,0,647,918,800,1094,153,176
1312,levle1_604.jpg,fore,Unspecified,0.0,0,2156,1807,2348,1999,192,192
1313,levle1_604.jpg,fore,Unspecified,0.0,0,1850,2374,2026,2520,176,146
1314,levle1_604.jpg,fore,Unspecified,0.0,0,2064,2343,2210,2451,146,108
1315,levle1_604.jpg,fore,Unspecified,0.0,0,1827,2688,1965,2780,138,92
1316,levle1_604.jpg,fore,Unspecified,0.0,0,2011,2665,2171,2788,160,123
1317,levle1_604.jpg,fore,Unspecified,0.0,0,1773,2796,1995,2880,222,84
1318,levle1_604.jpg,fore,Unspecified,0.0,0,1896,2880,2057,3048,161,168
1319,levle1_162.jpg,fore,Unspecified,0.0,0,1896,2267,1988,2366,92,99
1320,levle1_162.jpg,fore,Unspecified,0.0,0,1329,2374,1420,2512,91,138
1321,levle1_162.jpg,fore,Unspecified,0.0,0,1313,2213,1436,2343,123,130
1322,levle1_162.jpg,fore,Unspecified,0.0,0,1198,2366,1321,2481,123,115
1323,levle1_162.jpg,fore,Unspecified,0.0,0,976,2343,1129,2474,153,131
1324,levle1_162.jpg,fore,Unspecified,0.0,0,1796,2558,1896,2650,100,92
1325,levle1_162.jpg,fore,Unspecified,0.0,0,1658,2612,1735,2681,77,69
1326,levle1_162.jpg,fore,Unspecified,0.0,0,1712,2857,1811,2949,99,92
1327,levle1_162.jpg,fore,Unspecified,0.0,0,1459,3148,1558,3255,99,107
1328,levle1_162.jpg,fore,Unspecified,0.0,0,1834,3171,1888,3255,54,84
1329,levle0_371.jpg,fore,Unspecified,0.0,0,1781,3094,1903,3202,122,108
1330,levle0_371.jpg,fore,Unspecified,0.0,0,1336,3125,1466,3255,130,130
1331,levle0_371.jpg,fore,Unspecified,0.0,0,2156,727,2233,842,77,115
1332,levle1_176.jpg,fore,Unspecified,0.0,0,516,2045,578,2160,62,115
1333,levle1_176.jpg,fore,Unspecified,0.0,0,593,2037,692,2144,99,107
1334,levle1_176.jpg,fore,Unspecified,0.0,0,562,2190,647,2305,85,115
1335,levle1_176.jpg,fore,Unspecified,0.0,0,846,2006,961,2098,115,92
1336,levle1_176.jpg,fore,Unspecified,0.0,0,922,2091,1037,2167,115,76
1337,levle1_176.jpg,fore,Unspecified,0.0,0,922,2466,1022,2573,100,107
1338,levle1_176.jpg,fore,Unspecified,0.0,0,708,2397,815,2489,107,92
1339,levle1_176.jpg,fore,Unspecified,0.0,0,1206,2512,1352,2589,146,77
1340,levle1_176.jpg,fore,Unspecified,0.0,0,1229,2581,1359,2665,130,84
1341,levle1_176.jpg,fore,Unspecified,0.0,0,1436,2949,1551,3087,115,138
1342,levle1_176.jpg,fore,Unspecified,0.0,0,1206,2290,1283,2389,77,99
1343,levle1_176.jpg,fore,Unspecified,0.0,0,700,2206,777,2305,77,99
1344,levle0_365.jpg,fore,Unspecified,0.0,0,508,193,533,221,25,28
1345,levle0_58.jpg,fore,Unspecified,0.0,0,4104,2856,4287,3031,183,175
1346,levle0_58.jpg,fore,Unspecified,0.0,0,2533,2532,2791,2831,258,299
1347,levle0_58.jpg,fore,Unspecified,0.0,0,1927,770,2118,1053,191,283
1348,levle0_403.jpg,fore,Unspecified,0.0,0,1949,2972,2095,3094,146,122
1349,levle1_610.jpg,fore,Unspecified,0.0,0,1290,2412,1428,2573,138,161
1350,levle1_610.jpg,fore,Unspecified,0.0,0,1152,2642,1359,2796,207,154
1351,levle1_610.jpg,fore,Unspecified,0.0,0,1014,2282,1214,2420,200,138
1352,levle1_610.jpg,fore,Unspecified,0.0,0,1045,2144,1252,2213,207,69
1353,levle1_610.jpg,fore,Unspecified,0.0,0,738,2006,968,2075,230,69
1354,levle1_610.jpg,fore,Unspecified,0.0,0,715,2083,838,2290,123,207
1355,levle1_610.jpg,fore,Unspecified,0.0,0,1850,2834,1988,2979,138,145
1356,levle1_610.jpg,fore,Unspecified,0.0,0,1673,2926,1834,3041,161,115
1357,levle1_610.jpg,fore,Unspecified,0.0,0,1773,3048,1995,3202,222,154
1358,levle1_189.jpg,fore,Unspecified,0.0,0,1880,3163,1988,3294,108,131
1359,levle1_189.jpg,fore,Unspecified,0.0,0,1704,3002,1834,3140,130,138
1360,levle1_189.jpg,fore,Unspecified,0.0,0,1589,3079,1704,3217,115,138
1361,levle1_189.jpg,fore,Unspecified,0.0,0,1505,2489,1551,2619,46,130
1362,levle1_189.jpg,fore,Unspecified,0.0,0,1114,2075,1313,2198,199,123
1363,levle1_189.jpg,fore,Unspecified,0.0,0,1758,527,1942,658,184,131
1364,levle0_239.jpg,fore,Unspecified,0.0,0,792,1516,930,1692,138,176
1365,levle0_239.jpg,fore,Unspecified,0.0,0,1168,2229,1359,2443,191,214
1366,levle0_239.jpg,fore,Unspecified,0.0,0,1221,2474,1375,2612,154,138
1367,levle2_75.jpg,fore,,,0,892,566,1083,734,191,168
1368,levle2_75.jpg,fore,,,0,1053,274,1152,374,99,100
1369,levle2_75.jpg,fore,,,0,2501,2121,2670,2343,169,222
1370,levle2_75.jpg,fore,,,0,2409,2236,2578,2435,169,199
1371,levle2_75.jpg,fore,,,0,2302,2443,2432,2512,130,69
1372,levle2_75.jpg,fore,,,0,2156,2451,2371,2658,215,207
1373,levle2_75.jpg,fore,,,0,2003,2366,2148,2581,145,215
1374,levle2_75.jpg,fore,,,0,1857,2183,2011,2351,154,168
1375,levle2_75.jpg,fore,,,0,1880,2389,1980,2481,100,92
1376,levle2_75.jpg,fore,,,0,1704,2803,1880,2979,176,176
1377,levle2_75.jpg,fore,,,0,2424,1255,2547,1363,123,108
1378,levle2_75.jpg,fore,,,0,1543,887,1773,1087,230,200
1379,levle2_75.jpg,fore,,,0,1612,681,1811,895,199,214
1380,levle2_75.jpg,fore,,,0,1666,504,1796,688,130,184
1381,levle2_75.jpg,fore,,,0,1934,956,2087,1117,153,161
1382,levle2_75.jpg,fore,,,0,1206,719,1329,865,123,146
1383,levle2_75.jpg,fore,,,0,884,773,1053,995,169,222
1384,levle2_75.jpg,fore,,,0,731,688,884,887,153,199
1385,levle2_75.jpg,fore,,,0,1081,1877,1277,2032,196,155
1386,levle2_75.jpg,fore,,,0,1867,1232,2105,1439,238,207
1387,levle2_75.jpg,fore,,,0,957,1274,1146,1457,189,183
1388,levle2_61.jpg,fore,,,0,3805,1551,3921,1701,116,150
1389,levle2_61.jpg,fore,,,0,3489,1726,3664,1867,175,141
1390,levle2_61.jpg,fore,,,0,3572,1834,3664,2017,92,183
1391,levle2_61.jpg,fore,,,0,3680,1834,3755,1909,75,75
1392,levle2_61.jpg,fore,,,0,3747,1901,3872,2017,125,116
1393,levle2_61.jpg,fore,,,0,3664,1984,3896,2225,232,241
1394,levle2_61.jpg,fore,,,0,3539,2009,3655,2167,116,158
1395,levle2_61.jpg,fore,,,0,3381,1909,3464,2025,83,116
1396,levle2_61.jpg,fore,,,0,3448,2017,3564,2158,116,141
1397,levle2_61.jpg,fore,,,0,3414,2133,3606,2266,192,133
1398,levle2_61.jpg,fore,,,0,3223,2117,3356,2299,133,182
1399,levle2_61.jpg,fore,,,0,2991,2299,3123,2424,132,125
1400,levle2_61.jpg,fore,,,0,3049,2383,3207,2532,158,149
1401,levle2_61.jpg,fore,,,0,3182,2441,3315,2582,133,141
1402,levle2_61.jpg,fore,,,0,3248,2341,3398,2432,150,91
1403,levle2_61.jpg,fore,,,0,3057,2565,3256,2682,199,117
1404,levle2_61.jpg,fore,,,0,3157,2649,3265,2765,108,116
1405,levle2_61.jpg,fore,,,0,2957,2715,3115,2881,158,166
1406,levle2_61.jpg,fore,,,0,2924,2499,3090,2640,166,141
1407,levle2_61.jpg,fore,,,0,3680,1726,3921,1959,241,233
1408,levle2_61.jpg,fore,,,0,3406,2394,3514,2514,108,120
1409,levle2_49.jpg,fore,Unspecified,0.0,0,2508,1094,2700,1269,192,175
1410,levle2_49.jpg,fore,Unspecified,0.0,0,2276,754,2600,970,324,216
1411,levle2_49.jpg,fore,Unspecified,0.0,0,2600,920,2774,1111,174,191
1412,levle2_49.jpg,fore,Unspecified,0.0,0,2783,862,2966,1020,183,158
1413,levle2_49.jpg,fore,Unspecified,0.0,0,2708,720,2799,853,91,133
1414,levle2_49.jpg,fore,Unspecified,0.0,0,2749,612,2899,754,150,142
1415,levle2_49.jpg,fore,Unspecified,0.0,0,3556,305,3722,454,166,149
1416,levle2_49.jpg,fore,Unspecified,0.0,0,2218,1610,2375,1817,157,207
1417,levle2_49.jpg,fore,Unspecified,0.0,0,2118,1352,2375,1551,257,199
1418,levle2_49.jpg,fore,Unspecified,0.0,0,2342,1817,2450,1925,108,108
1419,levle2_49.jpg,fore,Unspecified,0.0,0,2409,2158,2583,2324,174,166
1420,levle2_49.jpg,fore,Unspecified,0.0,0,2317,2009,2409,2158,92,149
1421,levle2_49.jpg,fore,Unspecified,0.0,0,2425,1892,2550,2025,125,133
1422,levle2_49.jpg,fore,Unspecified,0.0,0,2592,1876,2858,2025,266,149
1423,levle2_49.jpg,fore,Unspecified,0.0,0,2700,2009,2791,2117,91,108
1424,levle2_49.jpg,fore,Unspecified,0.0,0,2924,2092,3032,2266,108,174
1425,levle2_49.jpg,fore,Unspecified,0.0,0,3040,1984,3173,2191,133,207
1426,levle2_49.jpg,fore,Unspecified,0.0,0,3140,1934,3273,2092,133,158
1427,levle2_49.jpg,fore,Unspecified,0.0,0,2991,745,3123,887,132,142
1428,levle2_49.jpg,fore,Unspecified,0.0,0,2342,1053,2450,1202,108,149
1429,levle2_49.jpg,fore,Unspecified,0.0,0,2716,2549,2874,2757,158,208
1430,levle2_49.jpg,fore,Unspecified,0.0,0,3024,2383,3173,2524,149,141
1431,levle2_49.jpg,fore,Unspecified,0.0,0,3140,2233,3256,2358,116,125
1432,levle2_49.jpg,fore,Unspecified,0.0,0,2899,2840,3057,3023,158,183
1433,levle0_205.jpg,fore,Unspecified,0.0,0,1597,3056,1788,3255,191,199
1434,levle0_205.jpg,fore,Unspecified,0.0,0,731,2075,915,2259,184,184
1435,levle0_205.jpg,fore,Unspecified,0.0,0,1551,320,1704,481,153,161
1436,levle0_211.jpg,fore,Unspecified,0.0,0,869,1631,991,1799,122,168
1437,levle2_116.jpg,fore,Unspecified,0.0,0,345,30,364,48,19,18
1438,levle2_116.jpg,fore,Unspecified,0.0,0,326,91,338,107,12,16
1439,levle2_116.jpg,fore,Unspecified,0.0,0,360,84,373,98,13,14
1440,levle2_116.jpg,fore,Unspecified,0.0,0,240,218,258,232,18,14
1441,levle2_116.jpg,fore,Unspecified,0.0,0,222,253,236,268,14,15
1442,levle2_116.jpg,fore,Unspecified,0.0,0,197,278,218,293,21,15
1443,levle2_116.jpg,fore,Unspecified,0.0,0,186,242,200,258,14,16
1444,levle2_116.jpg,fore,Unspecified,0.0,0,210,209,237,225,27,16
1445,levle2_116.jpg,fore,Unspecified,0.0,0,118,118,127,136,9,18
1446,levle2_116.jpg,fore,Unspecified,0.0,0,127,127,149,145,22,18
1447,levle2_116.jpg,fore,Unspecified,0.0,0,173,85,194,106,21,21
1448,levle2_116.jpg,fore,Unspecified,0.0,0,251,93,267,110,16,17
1449,levle2_116.jpg,fore,Unspecified,0.0,0,157,218,169,231,12,13
1450,levle2_116.jpg,fore,Unspecified,0.0,0,392,101,414,121,22,20
1451,levle2_116.jpg,fore,Unspecified,0.0,0,283,108,309,136,26,28
1452,levle2_116.jpg,fore,Unspecified,0.0,0,223,74,244,98,21,24
1453,levle2_116.jpg,fore,Unspecified,0.0,0,132,163,145,176,13,13
1454,levle2_116.jpg,fore,Unspecified,0.0,0,135,177,150,196,15,19
1455,levle2_116.jpg,fore,Unspecified,0.0,0,172,197,185,208,13,11
1456,levle2_116.jpg,fore,Unspecified,0.0,0,198,184,219,200,21,16
1457,levle2_116.jpg,fore,Unspecified,0.0,0,180,222,197,235,17,13
1458,levle2_116.jpg,fore,Unspecified,0.0,0,255,153,274,177,19,24
1459,levle2_116.jpg,fore,Unspecified,0.0,0,284,159,303,175,19,16
1460,levle2_116.jpg,fore,Unspecified,0.0,0,328,158,348,178,20,20
1461,levle2_116.jpg,fore,Unspecified,0.0,0,316,202,336,219,20,17
1462,levle2_116.jpg,fore,Unspecified,0.0,0,237,149,252,165,15,16
1463,levle2_116.jpg,fore,Unspecified,0.0,0,273,184,294,199,21,15
1464,levle2_116.jpg,fore,Unspecified,0.0,0,159,239,172,254,13,15
1465,levle2_102.jpg,fore,Unspecified,0.0,0,1742,857,1873,1018,131,161
1466,levle2_102.jpg,fore,Unspecified,0.0,0,1413,696,1497,857,84,161
1467,levle2_102.jpg,fore,Unspecified,0.0,0,1382,926,1520,1018,138,92
1468,levle2_102.jpg,fore,Unspecified,0.0,0,1367,1033,1581,1148,214,115
1469,levle2_102.jpg,fore,Unspecified,0.0,0,1045,619,1252,796,207,177
1470,levle2_102.jpg,fore,Unspecified,0.0,0,2363,1117,2486,1255,123,138
1471,levle2_102.jpg,fore,Unspecified,0.0,0,2815,2152,2930,2290,115,138
1472,levle2_102.jpg,fore,Unspecified,0.0,0,2616,2167,2746,2297,130,130
1473,levle2_102.jpg,fore,Unspecified,0.0,0,2440,2336,2570,2458,130,122
1474,levle2_102.jpg,fore,Unspecified,0.0,0,2340,2435,2463,2535,123,100
1475,levle2_102.jpg,fore,Unspecified,0.0,0,2248,2512,2363,2665,115,153
1476,levle2_102.jpg,fore,Unspecified,0.0,0,2049,2711,2156,2857,107,146
1477,levle2_102.jpg,fore,Unspecified,0.0,0,1911,2520,2003,2650,92,130
1478,levle2_102.jpg,fore,Unspecified,0.0,0,1804,2604,1972,2757,168,153
1479,levle2_102.jpg,fore,Unspecified,0.0,0,1735,2987,1873,3125,138,138
1480,levle2_102.jpg,fore,Unspecified,0.0,0,1919,3048,2049,3186,130,138
1481,levle2_102.jpg,fore,Unspecified,0.0,0,2240,2934,2355,3079,115,145
1482,levle2_102.jpg,fore,Unspecified,0.0,0,1390,3194,1489,3294,99,100
1483,levle2_102.jpg,fore,Unspecified,0.0,0,1566,3140,1627,3255,61,115
1484,levle2_102.jpg,fore,Unspecified,0.0,0,1160,3110,1267,3255,107,145
1485,levle2_102.jpg,fore,Unspecified,0.0,0,2156,3156,2256,3263,100,107
1486,levle1_7.jpg,fore,Unspecified,0.0,0,504,460,523,487,19,27
1487,levle1_7.jpg,fore,Unspecified,0.0,0,557,473,573,491,16,18
1488,levle1_7.jpg,fore,Unspecified,0.0,0,279,458,321,492,42,34
1489,levle1_7.jpg,fore,Unspecified,0.0,0,115,305,157,339,42,34
1490,levle1_7.jpg,fore,Unspecified,0.0,0,135,196,158,223,23,27
1491,levle1_7.jpg,fore,Unspecified,0.0,0,161,217,187,250,26,33
1492,levle1_7.jpg,fore,Unspecified,0.0,0,228,177,265,225,37,48
1493,levle1_7.jpg,fore,Unspecified,0.0,0,111,110,157,142,46,32
1494,levle1_7.jpg,fore,Unspecified,0.0,0,48,108,82,155,34,47
1495,levle1_7.jpg,fore,Unspecified,0.0,0,28,78,73,105,45,27
1496,levle1_7.jpg,fore,Unspecified,0.0,0,112,151,152,176,40,25
1497,levle1_7.jpg,fore,Unspecified,0.0,0,91,204,133,236,42,32
1498,levle1_7.jpg,fore,Unspecified,0.0,0,52,197,84,225,32,28
1499,levle1_7.jpg,fore,Unspecified,0.0,0,77,34,122,76,45,42
1500,levle1_7.jpg,fore,Unspecified,0.0,0,77,264,128,301,51,37
1501,levle1_7.jpg,fore,Unspecified,0.0,0,198,226,233,257,35,31
1502,levle1_7.jpg,fore,Unspecified,0.0,0,286,289,324,324,38,35
1503,levle1_7.jpg,fore,Unspecified,0.0,0,198,141,242,183,44,42
1504,levle1_228.jpg,fore,Unspecified,0.0,0,754,1922,846,2075,92,153
1505,levle1_228.jpg,fore,Unspecified,0.0,0,792,2374,861,2512,69,138
1506,levle1_228.jpg,fore,Unspecified,0.0,0,884,2512,968,2612,84,100
1507,levle1_228.jpg,fore,Unspecified,0.0,0,953,2290,1053,2428,100,138
1508,levle1_228.jpg,fore,Unspecified,0.0,0,1030,2550,1106,2658,76,108
1509,levle1_228.jpg,fore,Unspecified,0.0,0,1106,2911,1206,3025,100,114
1510,levle1_228.jpg,fore,Unspecified,0.0,0,1114,2328,1214,2481,100,153
1511,levle1_228.jpg,fore,Unspecified,0.0,0,1068,2719,1145,2819,77,100
1512,levle1_18.jpg,fore,Unspecified,0.0,0,188,0,200,11,12,11
1513,levle1_18.jpg,fore,Unspecified,0.0,0,108,177,119,197,11,20
1514,levle1_18.jpg,fore,Unspecified,0.0,0,106,224,125,243,19,19
1515,levle1_18.jpg,fore,Unspecified,0.0,0,176,130,185,147,9,17
1516,levle1_18.jpg,fore,Unspecified,0.0,0,81,157,96,177,15,20
1517,levle1_18.jpg,fore,Unspecified,0.0,0,106,147,125,162,19,15
1518,levle1_18.jpg,fore,Unspecified,0.0,0,87,188,99,203,12,15
1519,levle1_18.jpg,fore,Unspecified,0.0,0,136,159,153,173,17,14
1520,levle1_18.jpg,fore,Unspecified,0.0,0,95,28,106,42,11,14
1521,levle1_18.jpg,fore,Unspecified,0.0,0,111,34,131,48,20,14
1522,levle1_18.jpg,fore,Unspecified,0.0,0,96,60,113,76,17,16
1523,levle1_18.jpg,fore,Unspecified,0.0,0,124,200,138,218,14,18
1524,levle1_214.jpg,fore,Unspecified,0.0,0,1689,2474,1827,2642,138,168
1525,levle1_214.jpg,fore,Unspecified,0.0,0,1244,2972,1405,3140,161,168
1526,levle1_214.jpg,fore,Unspecified,0.0,0,2240,2366,2348,2512,108,146
1527,levle1_214.jpg,fore,Unspecified,0.0,0,2424,2206,2524,2336,100,130
1528,levle1_214.jpg,fore,Unspecified,0.0,0,2424,2420,2547,2589,123,169
1529,levle1_214.jpg,fore,Unspecified,0.0,0,2210,2734,2340,2857,130,123
1530,levle1_214.jpg,fore,Unspecified,0.0,0,1650,3156,1834,3286,184,130
1531,levle1_214.jpg,fore,Unspecified,0.0,0,1650,2972,1788,3087,138,115
1532,levle1_214.jpg,fore,Unspecified,0.0,0,1106,727,1283,811,177,84
1533,levle1_24.jpg,fore,Unspecified,0.0,0,267,109,290,137,23,28
1534,levle1_24.jpg,fore,Unspecified,0.0,0,294,174,322,200,28,26
1535,levle1_24.jpg,fore,Unspecified,0.0,0,303,90,327,115,24,25
1536,levle1_24.jpg,fore,Unspecified,0.0,0,347,224,379,261,32,37
1537,levle1_24.jpg,fore,Unspecified,0.0,0,401,203,427,231,26,28
1538,levle1_24.jpg,fore,Unspecified,0.0,0,401,170,430,190,29,20
1539,levle1_24.jpg,fore,Unspecified,0.0,0,443,154,463,175,20,21
1540,levle1_24.jpg,fore,Unspecified,0.0,0,467,174,483,194,16,20
1541,levle1_24.jpg,fore,Unspecified,0.0,0,478,141,506,167,28,26
1542,levle1_24.jpg,fore,Unspecified,0.0,0,470,219,489,237,19,18
1543,levle1_24.jpg,fore,Unspecified,0.0,0,502,232,526,262,24,30
1544,levle1_572.jpg,fore,Unspecified,0.0,0,1336,1501,1489,1669,153,168
1545,levle1_572.jpg,fore,Unspecified,0.0,0,1466,1278,1627,1439,161,161
1546,levle1_572.jpg,fore,Unspecified,0.0,0,1290,1332,1459,1470,169,138
1547,levle1_572.jpg,fore,Unspecified,0.0,0,1137,1470,1298,1623,161,153
1548,levle1_572.jpg,fore,Unspecified,0.0,0,1037,1562,1198,1730,161,168
1549,levle1_572.jpg,fore,Unspecified,0.0,0,807,1478,938,1608,131,130
1550,levle1_572.jpg,fore,Unspecified,0.0,0,746,1715,899,1845,153,130
1551,levle1_572.jpg,fore,Unspecified,0.0,0,999,2060,1106,2167,107,107
1552,levle1_572.jpg,fore,Unspecified,0.0,0,1030,1907,1129,2014,99,107
1553,levle1_572.jpg,fore,Unspecified,0.0,0,738,1930,922,2068,184,138
1554,levle1_572.jpg,fore,Unspecified,0.0,0,394,2734,486,2888,92,154
1555,levle1_30.jpg,fore,,,0,1095,359,1166,408,71,49
1556,levle1_30.jpg,fore,,,0,945,444,1017,522,72,78
1557,levle1_30.jpg,fore,,,0,1023,600,1098,697,75,97
1558,levle1_30.jpg,fore,,,0,1046,457,1111,538,65,81
1559,levle1_30.jpg,fore,,,0,1023,288,1072,350,49,62
1560,levle1_30.jpg,fore,,,0,786,301,864,359,78,58
1561,levle1_30.jpg,fore,,,0,890,307,939,366,49,59
1562,levle1_30.jpg,fore,,,0,796,437,864,496,68,59
1563,levle1_30.jpg,fore,,,0,753,519,838,571,85,52
1564,levle1_30.jpg,fore,,,0,867,460,948,522,81,62
1565,levle1_30.jpg,fore,,,0,1000,704,1039,756,39,52
1566,levle1_30.jpg,fore,,,0,1062,775,1124,817,62,42
1567,levle1_30.jpg,fore,,,0,1124,584,1195,639,71,55
1568,levle1_30.jpg,fore,,,0,1156,496,1234,584,78,88
1569,levle1_30.jpg,fore,,,0,1121,421,1172,483,51,62
1570,levle1_30.jpg,fore,,,0,1108,268,1159,346,51,78
1571,levle1_30.jpg,fore,,,0,1182,252,1244,311,62,59
1572,levle1_30.jpg,fore,,,0,987,242,1039,291,52,49
1573,levle1_30.jpg,fore,,,0,1163,671,1205,710,42,39
1574,levle1_30.jpg,fore,,,0,974,535,1033,590,59,55
1575,levle1_30.jpg,fore,,,0,1145,817,1195,868,50,51
1576,levle1_566.jpg,fore,Unspecified,0.0,0,1045,650,1221,803,176,153
1577,levle1_566.jpg,fore,Unspecified,0.0,0,2125,474,2256,612,131,138
1578,levle1_566.jpg,fore,Unspecified,0.0,0,2386,796,2631,972,245,176
1579,levle1_566.jpg,fore,Unspecified,0.0,0,2355,1117,2555,1217,200,100
1580,levle1_566.jpg,fore,Unspecified,0.0,0,2601,1140,2792,1286,191,146
1581,levle1_566.jpg,fore,Unspecified,0.0,0,2501,1784,2677,1899,176,115
1582,levle1_566.jpg,fore,Unspecified,0.0,0,2578,1891,2739,2014,161,123
1583,levle1_566.jpg,fore,Unspecified,0.0,0,2286,2091,2440,2251,154,160
1584,levle1_566.jpg,fore,Unspecified,0.0,0,2455,2313,2570,2474,115,161
1585,levle1_566.jpg,fore,Unspecified,0.0,0,2279,2328,2417,2535,138,207
1586,levle1_566.jpg,fore,Unspecified,0.0,0,2102,2619,2363,2780,261,161
1587,levle1_566.jpg,fore,Unspecified,0.0,0,2179,2788,2302,2918,123,130
1588,levle1_566.jpg,fore,Unspecified,0.0,0,2317,2911,2447,3010,130,99
1589,levle1_566.jpg,fore,Unspecified,0.0,0,2409,2773,2570,2903,161,130
1590,levle1_566.jpg,fore,Unspecified,0.0,0,1972,3079,2102,3209,130,130
1591,levle1_200.jpg,fore,Unspecified,0.0,0,2332,1631,2463,1822,131,191
1592,levle1_200.jpg,fore,Unspecified,0.0,0,1597,2359,1719,2512,122,153
1593,levle1_200.jpg,fore,Unspecified,0.0,0,1819,2520,1972,2642,153,122
1594,levle1_200.jpg,fore,Unspecified,0.0,0,2164,2297,2332,2397,168,100
1595,levle1_200.jpg,fore,Unspecified,0.0,0,2585,2274,2685,2389,100,115
1596,levle1_200.jpg,fore,Unspecified,0.0,0,1965,2313,2079,2443,114,130
1597,levle1_200.jpg,fore,Unspecified,0.0,0,2179,1914,2294,2075,115,161
1598,levle1_599.jpg,fore,Unspecified,0.0,0,1712,2282,1865,2420,153,138
1599,levle1_599.jpg,fore,Unspecified,0.0,0,1934,2658,2072,2757,138,99
1600,levle1_599.jpg,fore,Unspecified,0.0,0,1957,2788,2064,2941,107,153
1601,levle1_599.jpg,fore,Unspecified,0.0,0,2018,2979,2118,3125,100,146
1602,levle1_599.jpg,fore,Unspecified,0.0,0,1880,3071,1995,3194,115,123
1603,levle1_599.jpg,fore,Unspecified,0.0,0,2202,2742,2309,2895,107,153
1604,levle1_599.jpg,fore,Unspecified,0.0,0,2102,2642,2187,2811,85,169
1605,levle1_599.jpg,fore,Unspecified,0.0,0,2478,2520,2578,2658,100,138
1606,levle1_599.jpg,fore,Unspecified,0.0,0,2547,1968,2670,2098,123,130
1607,levle1_599.jpg,fore,Unspecified,0.0,0,2302,2022,2432,2167,130,145
1608,levle1_599.jpg,fore,Unspecified,0.0,0,2378,2206,2547,2320,169,114
1609,levle1_599.jpg,fore,Unspecified,0.0,0,1957,3186,2102,3271,145,85
1610,levle3_107.jpg,fore,,,0,265,217,282,230,17,13
1611,levle3_107.jpg,fore,,,0,268,265,284,280,16,15
1612,levle3_107.jpg,fore,,,0,268,231,288,246,20,15
1613,levle3_107.jpg,fore,,,0,244,283,258,303,14,20
1614,levle3_107.jpg,fore,,,0,262,294,275,306,13,12
1615,levle3_107.jpg,fore,,,0,213,306,230,326,17,20
1616,levle3_107.jpg,fore,,,0,219,192,234,199,15,7
1617,levle3_107.jpg,fore,,,0,231,64,246,77,15,13
1618,levle3_107.jpg,fore,,,0,216,67,229,78,13,11
1619,levle3_107.jpg,fore,,,0,234,79,252,91,18,12
1620,levle3_107.jpg,fore,,,0,223,99,237,109,14,10
1621,levle3_107.jpg,fore,,,0,211,109,234,121,23,12
1622,levle3_107.jpg,fore,,,0,263,79,287,94,24,15
1623,levle3_107.jpg,fore,,,0,272,98,286,121,14,23
1624,levle3_107.jpg,fore,,,0,302,113,318,132,16,19
1625,levle3_107.jpg,fore,,,0,257,117,273,129,16,12
1626,levle3_107.jpg,fore,,,0,293,108,305,125,12,17
1627,levle3_107.jpg,fore,,,0,291,88,302,100,11,12
1628,levle3_107.jpg,fore,,,0,255,129,268,139,13,10
1629,levle3_107.jpg,fore,,,0,233,125,253,145,20,20
1630,levle3_107.jpg,fore,,,0,226,144,235,155,9,11
1631,levle3_107.jpg,fore,,,0,258,147,271,161,13,14
1632,levle3_107.jpg,fore,,,0,207,134,221,151,14,17
1633,levle3_107.jpg,fore,,,0,203,159,219,173,16,14
1634,levle3_107.jpg,fore,,,0,203,200,230,219,27,19
1635,levle3_107.jpg,fore,,,0,209,225,233,243,24,18
1636,levle3_107.jpg,fore,,,0,226,238,239,251,13,13
1637,levle3_107.jpg,fore,,,0,239,238,260,259,21,21
1638,levle3_107.jpg,fore,,,0,219,258,244,274,25,16
1639,levle3_107.jpg,fore,,,0,239,268,254,281,15,13
1640,levle3_107.jpg,fore,,,0,196,241,216,255,20,14
1641,levle3_107.jpg,fore,,,0,193,251,207,271,14,20
1642,levle3_107.jpg,fore,,,0,184,229,202,242,18,13
1643,levle3_107.jpg,fore,,,0,171,231,184,245,13,14
1644,levle3_107.jpg,fore,,,0,175,273,194,286,19,13
1645,levle3_107.jpg,fore,,,0,195,294,206,312,11,18
1646,levle3_107.jpg,fore,,,0,194,270,216,294,22,24
1647,levle3_107.jpg,fore,,,0,279,251,290,264,11,13
1648,levle3_107.jpg,fore,,,0,224,274,240,290,16,16
1649,levle3_107.jpg,fore,,,0,232,145,257,173,25,28
1650,levle3_107.jpg,fore,,,0,263,168,283,180,20,12
1651,levle3_107.jpg,fore,,,0,254,174,269,185,15,11
1652,levle3_107.jpg,fore,,,0,234,108,250,121,16,13
1653,levle3_107.jpg,fore,,,0,247,110,261,124,14,14
1654,levle3_107.jpg,fore,,,0,171,254,183,263,12,9
1655,levle3_107.jpg,fore,,,0,168,261,180,272,12,11
1656,levle3_107.jpg,fore,,,0,177,259,189,275,12,16
1657,levle3_107.jpg,fore,,,0,199,188,213,200,14,12
1658,levle3_107.jpg,fore,,,0,274,138,286,151,12,13
1659,levle3_107.jpg,fore,,,0,212,184,228,195,16,11
1660,levle3_107.jpg,fore,,,0,255,252,268,268,13,16
1661,levle3_107.jpg,fore,,,0,245,141,263,161,18,20
1662,levle3_107.jpg,fore,,,0,212,91,228,105,16,14
1663,levle3_5.jpg,fore,,,0,324,397,375,436,51,39
1664,levle3_5.jpg,fore,,,0,309,495,352,545,43,50
1665,levle3_5.jpg,fore,,,0,258,609,295,657,37,48
1666,levle3_5.jpg,fore,,,0,405,670,464,723,59,53
1667,levle3_5.jpg,fore,,,0,519,653,596,708,77,55
1668,levle3_5.jpg,fore,,,0,488,613,521,649,33,36
1669,levle3_5.jpg,fore,,,0,635,617,678,657,43,40
1670,levle3_5.jpg,fore,,,0,584,757,629,802,45,45
1671,levle3_5.jpg,fore,,,0,552,719,592,763,40,44
1672,levle3_5.jpg,fore,,,0,484,721,511,771,27,50
1673,levle3_5.jpg,fore,,,0,303,678,340,716,37,38
1674,levle3_5.jpg,fore,,,0,336,657,375,706,39,49
1675,levle3_5.jpg,fore,,,0,297,584,332,633,35,49
1676,levle3_5.jpg,fore,,,0,550,354,590,379,40,25
1677,levle3_5.jpg,fore,,,0,389,381,415,452,26,71
1678,levle3_5.jpg,fore,,,0,265,438,303,493,38,55
1679,levle3_5.jpg,fore,,,0,375,529,423,592,48,63
1680,levle3_5.jpg,fore,,,0,596,403,678,470,82,67
1681,levle3_5.jpg,fore,,,0,507,564,568,615,61,51
1682,levle3_5.jpg,fore,,,0,377,753,409,780,32,27
1683,levle3_5.jpg,fore,,,0,413,765,436,812,23,47
1684,levle3_5.jpg,fore,,,0,456,765,478,806,22,41
1685,levle3_5.jpg,fore,,,0,395,824,436,859,41,35
1686,levle3_5.jpg,fore,,,0,391,855,434,902,43,47
1687,levle3_5.jpg,fore,,,0,476,767,521,835,45,68
1688,levle3_5.jpg,fore,,,0,383,487,423,517,40,30
1689,levle3_5.jpg,fore,,,0,481,415,514,447,33,32
1690,levle3_5.jpg,fore,,,0,478,508,517,536,39,28
1691,levle3_5.jpg,fore,,,0,445,535,481,572,36,37
1692,levle3_5.jpg,fore,,,0,448,592,478,626,30,34
1693,levle3_5.jpg,fore,,,0,426,576,455,605,29,29
1694,levle3_5.jpg,fore,,,0,332,614,364,641,32,27
1695,levle3_5.jpg,fore,,,0,358,582,392,620,34,38
1696,levle3_5.jpg,fore,,,0,271,506,296,547,25,41
1697,levle3_5.jpg,fore,,,0,371,652,409,686,38,34
1698,levle3_5.jpg,fore,,,0,340,719,370,744,30,25
1699,levle3_5.jpg,fore,,,0,341,776,372,818,31,42
1700,levle3_5.jpg,fore,,,0,595,576,633,614,38,38
1701,levle3_5.jpg,fore,,,0,636,552,678,597,42,45
1702,levle3_5.jpg,fore,,,0,611,480,641,517,30,37
1703,levle3_5.jpg,fore,,,0,348,361,381,390,33,29
1704,levle3_5.jpg,fore,,,0,379,329,411,357,32,28
1705,levle3_5.jpg,fore,,,0,603,289,643,326,40,37
1706,levle3_5.jpg,fore,,,0,643,330,683,363,40,33
1707,levle3_5.jpg,fore,,,0,645,368,681,403,36,35
1708,levle3_5.jpg,fore,,,0,425,501,475,530,50,29
1709,levle3_5.jpg,fore,,,0,306,554,341,584,35,30
1710,levle3_5.jpg,fore,,,0,340,551,363,587,23,36
1711,levle3_5.jpg,fore,,,0,285,666,306,719,21,53
1712,levle3_5.jpg,fore,,,0,461,634,499,676,38,42
1713,levle3_5.jpg,fore,,,0,619,511,647,555,28,44
1714,levle3_5.jpg,fore,,,0,358,460,414,489,56,29
1715,levle3_5.jpg,fore,,,0,314,441,348,468,34,27
1716,levle3_5.jpg,fore,,,0,568,447,606,482,38,35
1717,levle3_5.jpg,fore,,,0,635,721,667,756,32,35
1718,levle3_5.jpg,fore,,,0,614,682,659,715,45,33
1719,levle3_5.jpg,fore,,,0,665,669,690,706,25,37
1720,levle3_5.jpg,fore,,,0,456,727,486,764,30,37
1721,levle3_113.jpg,fore,,,0,2437,1213,2525,1310,88,97
1722,levle3_113.jpg,fore,,,0,2410,1318,2551,1389,141,71
1723,levle3_113.jpg,fore,,,0,3060,1047,3139,1196,79,149
1724,levle3_113.jpg,fore,,,0,2919,1099,3007,1231,88,132
1725,levle3_113.jpg,fore,,,0,2410,1511,2481,1625,71,114
1726,levle3_113.jpg,fore,,,0,2463,1503,2568,1546,105,43
1727,levle3_113.jpg,fore,,,0,2428,1608,2568,1696,140,88
1728,levle3_113.jpg,fore,,,0,2410,1704,2551,1748,141,44
1729,levle3_113.jpg,fore,,,0,2402,1871,2498,1932,96,61
1730,levle3_113.jpg,fore,,,0,2507,2020,2621,2152,114,132
1731,levle3_113.jpg,fore,,,0,2744,1836,2884,1906,140,70
1732,levle3_113.jpg,fore,,,0,2823,2011,2972,2064,149,53
1733,levle3_113.jpg,fore,,,0,2779,2020,2893,2169,114,149
1734,levle3_113.jpg,fore,,,0,2568,2187,2682,2292,114,105
1735,levle3_113.jpg,fore,,,0,2665,2187,2744,2266,79,79
1736,levle3_113.jpg,fore,,,0,2735,2239,2814,2389,79,150
1737,levle3_113.jpg,fore,,,0,2779,2169,2893,2239,114,70
1738,levle3_113.jpg,fore,,,0,2849,2196,2946,2275,97,79
1739,levle3_113.jpg,fore,,,0,2928,2160,3016,2222,88,62
1740,levle3_113.jpg,fore,,,0,2805,2318,2875,2441,70,123
1741,levle3_113.jpg,fore,,,0,2858,2327,3007,2415,149,88
1742,levle3_113.jpg,fore,,,0,3077,2239,3147,2362,70,123
1743,levle3_113.jpg,fore,,,0,3112,2327,3191,2406,79,79
1744,levle3_113.jpg,fore,,,0,3165,2397,3296,2511,131,114
1745,levle3_113.jpg,fore,,,0,3288,2310,3358,2371,70,61
1746,levle3_113.jpg,fore,,,0,3349,2371,3410,2432,61,61
1747,levle3_113.jpg,fore,,,0,3402,2415,3507,2476,105,61
1748,levle3_113.jpg,fore,,,0,3367,2248,3560,2380,193,132
1749,levle3_113.jpg,fore,,,0,2621,1968,2744,2090,123,122
1750,levle3_113.jpg,fore,,,0,2560,1818,2665,1915,105,97
1751,levle3_113.jpg,fore,,,0,2498,1889,2647,2003,149,114
1752,levle3_113.jpg,fore,,,0,2967,1338,3047,1399,80,61
1753,levle3_113.jpg,fore,,,0,2749,1315,2833,1367,84,52
1754,levle3_113.jpg,fore,,,0,2676,1374,2756,1431,80,57
1755,levle3_113.jpg,fore,,,0,2649,1310,2719,1394,70,84
1756,levle3_113.jpg,fore,,,0,3156,1294,3215,1349,59,55
1757,levle3_113.jpg,fore,,,0,3285,1224,3354,1281,69,57
1758,levle3_113.jpg,fore,,,0,3351,1151,3424,1224,73,73
1759,levle3_113.jpg,fore,,,0,2819,1938,2915,2015,96,77
1760,levle3_113.jpg,fore,,,0,2710,1894,2788,1947,78,53
1761,levle3_113.jpg,fore,,,0,2926,2076,3006,2129,80,53
1762,levle3_113.jpg,fore,,,0,3019,2367,3079,2435,60,68
1763,levle3_113.jpg,fore,,,0,2490,1801,2574,1883,84,82
1764,levle3_113.jpg,fore,,,0,2576,1674,2635,1726,59,52
1765,levle3_113.jpg,fore,,,0,2460,1565,2574,1649,114,84
1766,levle3_113.jpg,fore,,,0,3106,1594,3192,1674,86,80
1767,levle3_113.jpg,fore,,,0,2610,2113,2688,2179,78,66
1768,levle3_113.jpg,fore,,,0,2738,2067,2806,2140,68,73
1769,levle3_113.jpg,fore,,,0,2660,1817,2774,1874,114,57
1770,levle3_113.jpg,fore,,,0,2490,1722,2576,1804,86,82
1771,levle3_113.jpg,fore,,,0,3454,1656,3552,1747,98,91
1772,levle3_113.jpg,fore,,,0,3129,2406,3199,2483,70,77
1773,levle3_113.jpg,fore,,,0,2576,2297,2688,2383,112,86
1774,levle3_113.jpg,fore,,,0,2379,1824,2449,1894,70,70
1775,levle3_113.jpg,fore,,,0,2442,1947,2517,2010,75,63
1776,levle3_113.jpg,fore,,,0,2517,2142,2583,2219,66,77
1777,levle3_113.jpg,fore,,,0,3040,2422,3117,2497,77,75
1778,levle3_113.jpg,fore,,,0,3199,2283,3274,2360,75,77
1779,levle3_113.jpg,fore,,,0,3160,1072,3238,1140,78,68
1780,levle3_113.jpg,fore,,,0,3108,1122,3208,1197,100,75
1781,levle3_113.jpg,fore,,,0,3033,1860,3104,1931,71,71
1782,levle3_113.jpg,fore,,,0,3240,890,3308,949,68,59
1783,levle3_113.jpg,fore,,,0,3076,813,3158,874,82,61
1784,levle3_113.jpg,fore,,,0,3031,954,3122,1013,91,59
1785,levle3_4.jpg,fore,,,0,190,196,238,249,48,53
1786,levle3_4.jpg,fore,,,0,180,271,223,304,43,33
1787,levle3_4.jpg,fore,,,0,314,309,336,345,22,36
1788,levle3_4.jpg,fore,,,0,398,376,412,424,14,48
1789,levle3_4.jpg,fore,,,0,235,156,288,201,53,45
1790,levle3_4.jpg,fore,,,0,293,149,345,204,52,55
1791,levle3_4.jpg,fore,,,0,302,216,319,247,17,31
1792,levle3_4.jpg,fore,,,0,242,206,276,237,34,31
1793,levle3_4.jpg,fore,,,0,329,213,381,254,52,41
1794,levle3_4.jpg,fore,,,0,353,165,415,223,62,58
1795,levle3_4.jpg,fore,,,0,319,266,365,321,46,55
1796,levle3_4.jpg,fore,,,0,285,276,309,309,24,33
1797,levle3_4.jpg,fore,,,0,245,288,297,340,52,52
1798,levle3_4.jpg,fore,,,0,261,323,305,379,44,56
1799,levle3_4.jpg,fore,,,0,254,403,302,465,48,62
1800,levle3_4.jpg,fore,,,0,290,446,343,491,53,45
1801,levle3_4.jpg,fore,,,0,302,374,331,422,29,48
1802,levle3_4.jpg,fore,,,0,319,369,365,412,46,43
1803,levle3_4.jpg,fore,,,0,348,400,389,463,41,63
1804,levle3_4.jpg,fore,,,0,377,288,396,338,19,50
1805,levle3_4.jpg,fore,,,0,398,242,439,280,41,38
1806,levle3_4.jpg,fore,,,0,415,206,463,249,48,43
1807,levle3_4.jpg,fore,,,0,420,175,460,223,40,48
1808,levle3_4.jpg,fore,,,0,448,170,520,206,72,36
1809,levle3_4.jpg,fore,,,0,453,125,496,187,43,62
1810,levle3_4.jpg,fore,,,0,434,81,482,134,48,53
1811,levle3_4.jpg,fore,,,0,446,41,494,91,48,50
1812,levle3_4.jpg,fore,,,0,209,357,259,429,50,72
1813,levle3_4.jpg,fore,,,0,394,310,425,331,31,21
1814,levle3_4.jpg,fore,,,0,399,285,423,309,24,24
1815,levle3_4.jpg,fore,,,0,250,273,276,290,26,17
1816,levle3_4.jpg,fore,,,0,55,315,87,333,32,18
1817,levle3_4.jpg,fore,,,0,1,375,17,404,16,29
1818,levle3_4.jpg,fore,,,0,15,400,50,427,35,27
1819,levle3_4.jpg,fore,,,0,190,328,219,349,29,21
1820,levle3_4.jpg,fore,,,0,161,229,191,251,30,22
1821,levle3_4.jpg,fore,,,0,171,203,193,225,22,22
1822,levle3_4.jpg,fore,,,0,265,128,299,154,34,26
1823,levle3_4.jpg,fore,,,0,319,119,343,139,24,20
1824,levle3_4.jpg,fore,,,0,462,310,486,335,24,25
1825,levle3_4.jpg,fore,,,0,360,344,388,371,28,27
1826,levle3_4.jpg,fore,,,0,457,340,504,365,47,25
1827,levle3_4.jpg,fore,,,0,417,424,473,456,56,32
1828,levle3_4.jpg,fore,,,0,207,452,240,484,33,32
1829,levle3_4.jpg,fore,,,0,207,431,251,451,44,20
1830,levle3_4.jpg,fore,,,0,288,256,315,279,27,23
1831,levle3_4.jpg,fore,,,0,408,23,442,43,34,20
1832,levle3_4.jpg,fore,,,0,282,86,310,112,28,26
1833,levle3_4.jpg,fore,,,0,305,90,332,114,27,24
1834,levle3_4.jpg,fore,,,0,325,84,355,108,30,24
1835,levle3_4.jpg,fore,,,0,195,250,245,280,50,30
1836,levle3_4.jpg,fore,,,0,176,423,203,444,27,21
1837,levle3_4.jpg,fore,,,0,126,460,166,493,40,33
1838,levle3_4.jpg,fore,,,0,335,482,380,512,45,30
1839,levle3_4.jpg,fore,,,0,110,520,141,542,31,22
1840,levle3_4.jpg,fore,,,0,16,435,37,452,21,17
1841,levle3_4.jpg,fore,,,0,34,423,59,443,25,20
1842,levle3_4.jpg,fore,,,0,39,445,64,462,25,17
1843,levle3_4.jpg,fore,,,0,145,335,178,362,33,27
1844,levle3_4.jpg,fore,,,0,458,254,487,277,29,23
1845,levle3_4.jpg,fore,,,0,390,340,428,375,38,35
1846,levle3_112.jpg,fore,Unspecified,0.0,0,2989,1143,3060,1266,71,123
1847,levle3_112.jpg,fore,Unspecified,0.0,0,2823,1213,2972,1336,149,123
1848,levle3_112.jpg,fore,Unspecified,0.0,0,2981,1266,3077,1371,96,105
1849,levle3_112.jpg,fore,Unspecified,0.0,0,3156,1643,3296,1766,140,123
1850,levle3_112.jpg,fore,Unspecified,0.0,0,2981,1775,3095,1889,114,114
1851,levle3_112.jpg,fore,Unspecified,0.0,0,2954,1836,3068,2011,114,175
1852,levle3_112.jpg,fore,Unspecified,0.0,0,2796,1906,2937,2064,141,158
1853,levle3_112.jpg,fore,Unspecified,0.0,0,2656,1889,2753,1968,97,79
1854,levle3_112.jpg,fore,Unspecified,0.0,0,2621,1968,2717,2090,96,122
1855,levle3_112.jpg,fore,Unspecified,0.0,0,2665,2064,2779,2143,114,79
1856,levle3_112.jpg,fore,Unspecified,0.0,0,2840,2073,2893,2196,53,123
1857,levle3_112.jpg,fore,Unspecified,0.0,0,2919,2029,2998,2125,79,96
1858,levle3_112.jpg,fore,Unspecified,0.0,0,2533,2345,2674,2424,141,79
1859,levle3_112.jpg,fore,Unspecified,0.0,0,2463,2441,2542,2494,79,53
1860,levle3_112.jpg,fore,Unspecified,0.0,0,2779,2310,2832,2380,53,70
1861,levle3_112.jpg,fore,Unspecified,0.0,0,2858,2204,3016,2353,158,149
1862,levle3_112.jpg,fore,Unspecified,0.0,0,2340,1038,2463,1187,123,149
1863,levle3_112.jpg,fore,Unspecified,0.0,0,2209,976,2296,1099,87,123
1864,levle3_112.jpg,fore,Unspecified,0.0,0,2226,845,2340,985,114,140
1865,levle3_112.jpg,fore,Unspecified,0.0,0,2744,1082,2884,1292,140,210
1866,levle3_112.jpg,fore,Unspecified,0.0,0,3060,1380,3191,1555,131,175
1867,levle3_112.jpg,fore,Unspecified,0.0,0,2463,2292,2595,2397,132,105
1868,levle3_106.jpg,fore,,,0,164,1271,325,1424,161,153
1869,levle3_106.jpg,fore,,,0,348,1064,493,1140,145,76
1870,levle3_106.jpg,fore,,,0,317,1171,570,1309,253,138
1871,levle3_106.jpg,fore,,,0,64,1516,256,1623,192,107
1872,levle3_106.jpg,fore,,,0,95,1707,217,1845,122,138
1873,levle3_106.jpg,fore,,,0,125,1822,256,1922,131,100
1874,levle3_106.jpg,fore,,,0,217,1830,371,1983,154,153
1875,levle3_106.jpg,fore,,,0,355,1715,509,1845,154,130
1876,levle3_106.jpg,fore,,,0,371,1884,555,2022,184,138
1877,levle3_106.jpg,fore,,,0,210,2006,394,2098,184,92
1878,levle3_106.jpg,fore,,,0,118,2083,263,2190,145,107
1879,levle3_106.jpg,fore,,,0,179,2183,309,2313,130,130
1880,levle3_106.jpg,fore,,,0,325,2083,394,2190,69,107
1881,levle3_106.jpg,fore,,,0,378,2144,578,2206,200,62
1882,levle3_106.jpg,fore,,,0,233,2313,355,2451,122,138
1883,levle3_106.jpg,fore,,,0,355,2336,493,2481,138,145
1884,levle3_106.jpg,fore,,,0,501,2359,731,2481,230,122
1885,levle3_106.jpg,fore,,,0,670,2343,815,2481,145,138
1886,levle3_106.jpg,fore,,,0,800,2389,915,2543,115,154
1887,levle3_106.jpg,fore,,,0,355,2527,532,2642,177,115
1888,levle3_106.jpg,fore,,,0,187,2504,424,2627,237,123
1889,levle3_106.jpg,fore,,,0,539,2466,677,2589,138,123
1890,levle3_106.jpg,fore,,,0,570,2627,715,2742,145,115
1891,levle3_106.jpg,fore,,,0,631,2719,777,2819,146,100
1892,levle3_106.jpg,fore,,,0,792,2604,961,2788,169,184
1893,levle3_106.jpg,fore,,,0,478,2780,585,2857,107,77
1894,levle3_106.jpg,fore,,,0,624,2834,792,2995,168,161
1895,levle3_106.jpg,fore,,,0,1152,2160,1283,2267,131,107
1896,levle3_106.jpg,fore,,,0,470,757,639,926,169,169
1897,levle3_106.jpg,fore,,,0,624,451,823,504,199,53
1898,levle3_106.jpg,fore,,,0,708,535,938,750,230,215
1899,levle3_106.jpg,fore,,,0,876,412,1053,596,177,184
1900,levle3_106.jpg,fore,,,0,1014,481,1206,696,192,215
1901,levle3_106.jpg,fore,,,0,1152,596,1290,727,138,131
1902,levle3_106.jpg,fore,,,0,1260,451,1352,619,92,168
1903,levle3_106.jpg,fore,,,0,1375,504,1512,658,137,154
1904,levle3_106.jpg,fore,,,0,1474,366,1597,481,123,115
1905,levle3_106.jpg,fore,,,0,1275,267,1413,435,138,168
1906,levle3_106.jpg,fore,,,0,1436,221,1597,366,161,145
1907,levle3_106.jpg,fore,,,0,1604,359,1773,466,169,107
1908,levle3_106.jpg,fore,,,0,1489,489,1620,604,131,115
1909,levle3_106.jpg,fore,,,0,1474,604,1635,688,161,84
1910,levle3_106.jpg,fore,,,0,1612,987,1765,1171,153,184
1911,levle3_106.jpg,fore,,,0,1727,374,1850,527,123,153
1912,levle3_106.jpg,fore,,,0,1091,244,1260,412,169,168
1913,levle3_106.jpg,fore,,,0,1681,2619,1805,2719,124,100
1914,levle3_106.jpg,fore,,,0,1540,1177,1657,1270,117,93
1915,levle3_106.jpg,fore,,,0,43,1963,198,2067,155,104
1916,levle3_106.jpg,fore,,,0,398,2260,533,2363,135,103
1917,levle3_106.jpg,fore,,,0,295,2222,422,2325,127,103
1918,levle3_106.jpg,fore,,,0,261,2619,399,2702,138,83
1919,levle3_106.jpg,fore,,,0,726,2563,808,2674,82,111
1920,levle3_106.jpg,fore,,,0,60,1281,184,1432,124,151
1921,levle3_106.jpg,fore,,,0,1736,508,1846,598,110,90
1922,levle3_106.jpg,fore,,,0,522,960,629,1084,107,124
1923,levle3_106.jpg,fore,,,0,1108,2319,1277,2446,169,127
1924,levle1_598.jpg,fore,Unspecified,0.0,0,938,842,1030,949,92,107
1925,levle1_598.jpg,fore,Unspecified,0.0,0,1528,688,1604,842,76,154
1926,levle1_598.jpg,fore,Unspecified,0.0,0,1666,803,1865,1025,199,222
1927,levle1_598.jpg,fore,Unspecified,0.0,0,1244,2267,1390,2428,146,161
1928,levle1_598.jpg,fore,Unspecified,0.0,0,899,2351,1076,2451,177,100
1929,levle1_598.jpg,fore,Unspecified,0.0,0,1091,2481,1168,2604,77,123
1930,levle1_598.jpg,fore,Unspecified,0.0,0,1191,2543,1313,2627,122,84
1931,levle1_598.jpg,fore,Unspecified,0.0,0,1045,2604,1206,2734,161,130
1932,levle1_598.jpg,fore,Unspecified,0.0,0,1214,2635,1283,2780,69,145
1933,levle1_598.jpg,fore,Unspecified,0.0,0,815,2734,961,2872,146,138
1934,levle1_598.jpg,fore,Unspecified,0.0,0,961,2849,1076,2956,115,107
1935,levle1_598.jpg,fore,Unspecified,0.0,0,1007,2995,1114,3133,107,138
1936,levle1_567.jpg,fore,Unspecified,0.0,0,2194,1355,2279,1439,85,84
1937,levle1_567.jpg,fore,Unspecified,0.0,0,2133,1232,2271,1340,138,108
1938,levle1_567.jpg,fore,Unspecified,0.0,0,1980,1340,2141,1485,161,145
1939,levle1_567.jpg,fore,Unspecified,0.0,0,1896,1179,2003,1286,107,107
1940,levle1_567.jpg,fore,Unspecified,0.0,0,1681,1347,1796,1447,115,100
1941,levle1_567.jpg,fore,Unspecified,0.0,0,1581,1432,1719,1562,138,130
1942,levle1_567.jpg,fore,Unspecified,0.0,0,1788,1416,1934,1524,146,108
1943,levle1_567.jpg,fore,Unspecified,0.0,0,1834,1547,1942,1692,108,145
1944,levle1_567.jpg,fore,Unspecified,0.0,0,2309,1830,2394,1914,85,84
1945,levle1_567.jpg,fore,Unspecified,0.0,0,2302,1723,2432,1807,130,84
1946,levle1_567.jpg,fore,Unspecified,0.0,0,2432,1577,2532,1707,100,130
1947,levle1_567.jpg,fore,Unspecified,0.0,0,2256,2029,2409,2129,153,100
1948,levle1_567.jpg,fore,Unspecified,0.0,0,2486,1991,2593,2114,107,123
1949,levle1_567.jpg,fore,Unspecified,0.0,0,1972,1937,2164,2075,192,138
1950,levle1_31.jpg,fore,Unspecified,0.0,0,581,476,623,538,42,62
1951,levle1_31.jpg,fore,Unspecified,0.0,0,627,463,688,554,61,91
1952,levle1_31.jpg,fore,Unspecified,0.0,0,708,411,753,480,45,69
1953,levle1_31.jpg,fore,Unspecified,0.0,0,669,203,705,249,36,46
1954,levle1_31.jpg,fore,Unspecified,0.0,0,448,337,519,421,71,84
1955,levle1_31.jpg,fore,Unspecified,0.0,0,542,337,591,411,49,74
1956,levle1_31.jpg,fore,Unspecified,0.0,0,675,629,727,704,52,75
1957,levle1_31.jpg,fore,Unspecified,0.0,0,757,632,812,710,55,78
1958,levle1_31.jpg,fore,Unspecified,0.0,0,857,655,922,746,65,91
1959,levle1_31.jpg,fore,Unspecified,0.0,0,978,645,1052,710,74,65
1960,levle1_31.jpg,fore,Unspecified,0.0,0,1104,629,1146,707,42,78
1961,levle1_31.jpg,fore,Unspecified,0.0,0,1036,701,1088,778,52,77
1962,levle1_31.jpg,fore,Unspecified,0.0,0,955,756,1026,808,71,52
1963,levle1_31.jpg,fore,Unspecified,0.0,0,890,856,961,895,71,39
1964,levle1_31.jpg,fore,Unspecified,0.0,0,841,869,903,925,62,56
1965,levle1_31.jpg,fore,Unspecified,0.0,0,818,795,887,850,69,55
1966,levle1_31.jpg,fore,Unspecified,0.0,0,727,720,786,769,59,49
1967,levle1_31.jpg,fore,Unspecified,0.0,0,740,837,789,892,49,55
1968,levle1_31.jpg,fore,Unspecified,0.0,0,536,623,575,688,39,65
1969,levle1_31.jpg,fore,Unspecified,0.0,0,545,707,630,811,85,104
1970,levle1_31.jpg,fore,Unspecified,0.0,0,627,632,662,713,35,81
1971,levle1_31.jpg,fore,Unspecified,0.0,0,913,584,978,642,65,58
1972,levle1_201.jpg,fore,Unspecified,0.0,0,1888,865,2034,972,146,107
1973,levle1_201.jpg,fore,Unspecified,0.0,0,784,1807,938,1899,154,92
1974,levle1_201.jpg,fore,Unspecified,0.0,0,715,1976,853,2098,138,122
1975,levle1_201.jpg,fore,Unspecified,0.0,0,876,2290,1007,2420,131,130
1976,levle1_201.jpg,fore,Unspecified,0.0,0,876,2052,961,2160,85,108
1977,levle1_201.jpg,fore,Unspecified,0.0,0,1068,2114,1191,2290,123,176
1978,levle1_201.jpg,fore,Unspecified,0.0,0,984,2535,1076,2642,92,107
1979,levle1_201.jpg,fore,Unspecified,0.0,0,1344,2497,1497,2635,153,138
1980,levle1_215.jpg,fore,Unspecified,0.0,0,2133,2474,2286,2619,153,145
1981,levle1_215.jpg,fore,Unspecified,0.0,0,2455,2343,2555,2420,100,77
1982,levle1_215.jpg,fore,Unspecified,0.0,0,2562,2374,2662,2504,100,130
1983,levle1_215.jpg,fore,Unspecified,0.0,0,2639,2558,2731,2719,92,161
1984,levle1_215.jpg,fore,Unspecified,0.0,0,2639,2152,2792,2351,153,199
1985,levle1_215.jpg,fore,Unspecified,0.0,0,2049,2642,2187,2780,138,138
1986,levle1_215.jpg,fore,Unspecified,0.0,0,2424,2673,2509,2773,85,100
1987,levle1_215.jpg,fore,Unspecified,0.0,0,2409,2451,2532,2581,123,130
1988,levle1_215.jpg,fore,Unspecified,0.0,0,1719,3171,1880,3294,161,123
1989,levle1_215.jpg,fore,Unspecified,0.0,0,1244,3002,1390,3110,146,108
1990,levle1_573.jpg,fore,Unspecified,0.0,0,823,2550,1022,2765,199,215
1991,levle1_573.jpg,fore,Unspecified,0.0,0,915,2175,1060,2328,145,153
1992,levle1_573.jpg,fore,Unspecified,0.0,0,1329,2842,1512,2972,183,130
1993,levle1_573.jpg,fore,Unspecified,0.0,0,1857,1861,1957,2045,100,184
1994,levle1_573.jpg,fore,Unspecified,0.0,0,1865,1692,2072,1937,207,245
1995,levle1_573.jpg,fore,Unspecified,0.0,0,1842,1493,1926,1600,84,107
1996,levle1_573.jpg,fore,Unspecified,0.0,0,1689,1501,1788,1615,99,114
1997,levle1_573.jpg,fore,Unspecified,0.0,0,1689,1715,1796,1830,107,115
1998,levle1_573.jpg,fore,Unspecified,0.0,0,1972,1409,2118,1554,146,145
1999,levle1_573.jpg,fore,Unspecified,0.0,0,2041,1102,2102,1217,61,115
2000,levle1_573.jpg,fore,Unspecified,0.0,0,2133,1002,2317,1232,184,230
2001,levle1_573.jpg,fore,Unspecified,0.0,0,2118,1217,2279,1370,161,153
2002,levle1_573.jpg,fore,Unspecified,0.0,0,2079,1370,2279,1493,200,123
2003,levle1_573.jpg,fore,Unspecified,0.0,0,2179,1501,2271,1600,92,99
2004,levle1_573.jpg,fore,Unspecified,0.0,0,2348,1386,2470,1531,122,145
2005,levle1_573.jpg,fore,Unspecified,0.0,0,2302,1186,2417,1363,115,177
2006,levle1_25.jpg,fore,Unspecified,0.0,0,153,67,169,79,16,12
2007,levle1_25.jpg,fore,Unspecified,0.0,0,143,70,152,85,9,15
2008,levle1_25.jpg,fore,Unspecified,0.0,0,108,88,121,99,13,11
2009,levle1_25.jpg,fore,Unspecified,0.0,0,111,109,122,116,11,7
2010,levle1_25.jpg,fore,Unspecified,0.0,0,114,117,129,128,15,11
2011,levle1_25.jpg,fore,Unspecified,0.0,0,111,129,122,139,11,10
2012,levle1_25.jpg,fore,Unspecified,0.0,0,105,145,115,155,10,10
2013,levle1_25.jpg,fore,Unspecified,0.0,0,121,148,134,157,13,9
2014,levle1_25.jpg,fore,Unspecified,0.0,0,116,146,121,151,5,5
2015,levle1_25.jpg,fore,Unspecified,0.0,0,128,183,138,195,10,12
2016,levle1_25.jpg,fore,Unspecified,0.0,0,138,138,147,148,9,10
2017,levle1_25.jpg,fore,Unspecified,0.0,0,134,127,147,136,13,9
2018,levle1_229.jpg,fore,Unspecified,0.0,0,386,1976,493,2098,107,122
2019,levle1_229.jpg,fore,Unspecified,0.0,0,394,1853,509,1960,115,107
2020,levle1_229.jpg,fore,Unspecified,0.0,0,493,2091,624,2213,131,122
2021,levle1_229.jpg,fore,Unspecified,0.0,0,892,2819,999,2934,107,115
2022,levle1_229.jpg,fore,Unspecified,0.0,0,570,2428,700,2550,130,122
2023,levle1_229.jpg,fore,Unspecified,0.0,0,884,2351,1014,2458,130,107
2024,levle1_229.jpg,fore,Unspecified,0.0,0,1313,3033,1428,3163,115,130
2025,levle1_19.jpg,fore,Unspecified,0.0,0,150,99,162,111,12,12
2026,levle1_19.jpg,fore,Unspecified,0.0,0,181,96,191,107,10,11
2027,levle1_19.jpg,fore,Unspecified,0.0,0,191,105,199,117,8,12
2028,levle1_19.jpg,fore,Unspecified,0.0,0,126,73,139,85,13,12
2029,levle1_19.jpg,fore,Unspecified,0.0,0,140,136,149,151,9,15
2030,levle1_19.jpg,fore,Unspecified,0.0,0,175,135,188,148,13,13
2031,levle1_19.jpg,fore,Unspecified,0.0,0,75,45,87,56,12,11
2032,levle1_19.jpg,fore,Unspecified,0.0,0,124,88,137,99,13,11
2033,levle1_6.jpg,fore,Unspecified,0.0,0,215,204,239,231,24,27
2034,levle1_6.jpg,fore,Unspecified,0.0,0,187,201,217,230,30,29
2035,levle1_6.jpg,fore,Unspecified,0.0,0,203,188,232,211,29,23
2036,levle1_6.jpg,fore,Unspecified,0.0,0,191,245,214,273,23,28
2037,levle1_6.jpg,fore,Unspecified,0.0,0,125,236,151,269,26,33
2038,levle1_6.jpg,fore,Unspecified,0.0,0,162,268,185,287,23,19
2039,levle2_117.jpg,fore,Unspecified,0.0,0,2501,1830,2624,1968,123,138
2040,levle2_117.jpg,fore,Unspecified,0.0,0,2501,2022,2624,2129,123,107
2041,levle2_117.jpg,fore,Unspecified,0.0,0,2486,2167,2624,2290,138,123
2042,levle2_117.jpg,fore,Unspecified,0.0,0,2478,2627,2593,2788,115,161
2043,levle2_117.jpg,fore,Unspecified,0.0,0,2348,2612,2455,2681,107,69
2044,levle2_117.jpg,fore,Unspecified,0.0,0,2248,2259,2363,2397,115,138
2045,levle2_117.jpg,fore,Unspecified,0.0,0,2179,2083,2325,2244,146,161
2046,levle0_210.jpg,fore,Unspecified,0.0,0,1696,2359,1834,2543,138,184
2047,levle0_210.jpg,fore,Unspecified,0.0,0,1543,2627,1666,2757,123,130
2048,levle0_204.jpg,fore,Unspecified,0.0,0,2286,2397,2409,2520,123,123
2049,levle0_204.jpg,fore,Unspecified,0.0,0,2524,2389,2700,2558,176,169
2050,levle2_48.jpg,fore,Unspecified,0.0,0,3198,1144,3439,1327,241,183
2051,levle2_48.jpg,fore,Unspecified,0.0,0,2941,1078,3190,1186,249,108
2052,levle2_48.jpg,fore,Unspecified,0.0,0,2858,862,2941,1003,83,141
2053,levle2_48.jpg,fore,Unspecified,0.0,0,2974,654,3265,953,291,299
2054,levle2_48.jpg,fore,Unspecified,0.0,0,3473,1244,3597,1394,124,150
2055,levle2_48.jpg,fore,Unspecified,0.0,0,3406,1385,3539,1493,133,108
2056,levle2_48.jpg,fore,Unspecified,0.0,0,3290,1518,3481,1693,191,175
2057,levle2_48.jpg,fore,Unspecified,0.0,0,3132,1551,3348,1784,216,233
2058,levle2_48.jpg,fore,Unspecified,0.0,0,3240,1743,3381,1859,141,116
2059,levle2_48.jpg,fore,Unspecified,0.0,0,3348,1801,3473,1975,125,174
2060,levle2_48.jpg,fore,Unspecified,0.0,0,3431,1601,3581,1792,150,191
2061,levle2_48.jpg,fore,Unspecified,0.0,0,2932,1801,3082,1950,150,149
2062,levle2_48.jpg,fore,Unspecified,0.0,0,3123,1975,3198,2017,75,42
2063,levle2_48.jpg,fore,Unspecified,0.0,0,3140,1809,3248,1975,108,166
2064,levle2_48.jpg,fore,Unspecified,0.0,0,3248,1942,3406,2067,158,125
2065,levle2_48.jpg,fore,Unspecified,0.0,0,3057,2050,3215,2225,158,175
2066,levle2_48.jpg,fore,Unspecified,0.0,0,2874,2100,3057,2225,183,125
2067,levle2_48.jpg,fore,Unspecified,0.0,0,2966,2200,3123,2391,157,191
2068,levle2_48.jpg,fore,Unspecified,0.0,0,2508,1768,2633,1884,125,116
2069,levle2_48.jpg,fore,Unspecified,0.0,0,2675,2167,2791,2366,116,199
2070,levle2_48.jpg,fore,Unspecified,0.0,0,2799,1876,3115,2075,316,199
2071,levle2_48.jpg,fore,Unspecified,0.0,0,3173,2233,3315,2466,142,233
2072,levle2_48.jpg,fore,Unspecified,0.0,0,3265,2092,3389,2275,124,183
2073,levle2_48.jpg,fore,Unspecified,0.0,0,3564,1543,3730,1701,166,158
2074,levle2_48.jpg,fore,Unspecified,0.0,0,3572,1884,3788,2117,216,233
2075,levle2_48.jpg,fore,Unspecified,0.0,0,3099,928,3265,1069,166,141
2076,levle2_60.jpg,fore,,,0,3481,1020,3597,1161,116,141
2077,levle2_60.jpg,fore,,,0,3431,1269,3614,1410,183,141
2078,levle2_60.jpg,fore,,,0,2434,2017,2633,2175,199,158
2079,levle2_60.jpg,fore,,,0,2675,2142,2891,2341,216,199
2080,levle2_60.jpg,fore,,,0,2974,2108,3115,2266,141,158
2081,levle2_60.jpg,fore,,,0,2866,2366,3015,2507,149,141
2082,levle2_60.jpg,fore,,,0,2907,2466,3032,2624,125,158
2083,levle2_60.jpg,fore,,,0,3099,2432,3240,2624,141,192
2084,levle2_60.jpg,fore,,,0,3198,2757,3323,2915,125,158
2085,levle2_60.jpg,fore,,,0,3107,2657,3248,2815,141,158
2086,levle2_60.jpg,fore,,,0,2791,2599,2941,2723,150,124
2087,levle2_60.jpg,fore,,,0,2575,2698,2700,2890,125,192
2088,levle2_60.jpg,fore,,,0,3290,2067,3423,2200,133,133
2089,levle2_60.jpg,fore,,,0,1985,2341,2151,2549,166,208
2090,levle2_60.jpg,fore,,,0,2941,2740,3107,2939,166,199
2091,levle2_60.jpg,fore,,,0,3286,1570,3414,1698,128,128
2092,levle2_60.jpg,fore,,,0,2330,1558,2630,1914,300,356
2093,levle2_60.jpg,fore,,,0,1858,1978,1962,2110,104,132
2094,levle2_60.jpg,fore,,,0,2446,2666,2582,2830,136,164
2095,levle2_60.jpg,fore,,,0,2322,2450,2506,2682,184,232
2096,levle2_60.jpg,fore,,,0,2674,2390,2854,2574,180,184
2097,levle2_74.jpg,fore,,,0,1237,2412,1390,2543,153,131
2098,levle2_74.jpg,fore,,,0,1896,3002,2072,3148,176,146
2099,levle2_74.jpg,fore,,,0,2194,2734,2432,3048,238,314
2100,levle2_74.jpg,fore,,,0,2018,2290,2164,2405,146,115
2101,levle2_74.jpg,fore,,,0,1919,2389,2102,2573,183,184
2102,levle2_74.jpg,fore,,,0,2317,2343,2478,2527,161,184
2103,levle2_74.jpg,fore,,,0,2409,2359,2585,2504,176,145
2104,levle2_74.jpg,fore,,,0,2470,2160,2639,2343,169,183
2105,levle2_74.jpg,fore,,,0,2616,2114,2784,2259,168,145
2106,levle2_74.jpg,fore,,,0,2493,1547,2608,1684,115,137
2107,levle2_74.jpg,fore,,,0,2478,1156,2662,1370,184,214
2108,levle2_74.jpg,fore,,,0,2455,949,2685,1117,230,168
2109,levle2_74.jpg,fore,,,0,1696,658,1919,865,223,207
2110,levle2_74.jpg,fore,,,0,1512,658,1666,849,154,191
2111,levle2_74.jpg,fore,,,0,1535,520,1735,696,200,176
2112,levle2_74.jpg,fore,,,0,1168,458,1397,711,229,253
2113,levle2_74.jpg,fore,,,0,961,1271,1129,1455,168,184
2114,levle2_74.jpg,fore,,,0,1471,2798,1612,2912,141,114
2115,levle2_74.jpg,fore,,,0,905,470,1050,577,145,107
2116,levle2_74.jpg,fore,,,0,1226,915,1357,1050,131,135
2117,levle2_74.jpg,fore,,,0,1264,746,1426,860,162,114
2118,levle0_238.jpg,fore,Unspecified,0.0,0,2516,2650,2631,2819,115,169
2119,levle0_238.jpg,fore,Unspecified,0.0,0,409,941,578,1079,169,138
2120,levle0_238.jpg,fore,Unspecified,0.0,0,2662,2535,2746,2665,84,130
2121,levle1_188.jpg,fore,Unspecified,0.0,0,677,2504,838,2650,161,146
2122,levle1_188.jpg,fore,Unspecified,0.0,0,593,2627,723,2788,130,161
2123,levle1_188.jpg,fore,Unspecified,0.0,0,915,2780,999,2872,84,92
2124,levle1_188.jpg,fore,Unspecified,0.0,0,1007,2673,1137,2788,130,115
2125,levle1_188.jpg,fore,Unspecified,0.0,0,1175,2803,1298,2926,123,123
2126,levle1_188.jpg,fore,Unspecified,0.0,0,1566,3102,1696,3209,130,107
2127,levle1_188.jpg,fore,Unspecified,0.0,0,1451,3002,1566,3117,115,115
2128,levle1_188.jpg,fore,Unspecified,0.0,0,1451,3140,1551,3248,100,108
2129,levle1_188.jpg,fore,Unspecified,0.0,0,1122,3087,1260,3186,138,99
2130,levle1_188.jpg,fore,Unspecified,0.0,0,1007,2872,1129,3033,122,161
2131,levle0_364.jpg,fore,Unspecified,0.0,0,1183,2106,1275,2259,92,153
2132,levle0_364.jpg,fore,Unspecified,0.0,0,1459,2037,1551,2190,92,153
2133,levle0_364.jpg,fore,Unspecified,0.0,0,1896,3071,2026,3225,130,154
2134,levle1_177.jpg,fore,Unspecified,0.0,0,1535,903,1597,995,62,92
2135,levle1_177.jpg,fore,Unspecified,0.0,0,1612,734,1712,826,100,92
2136,levle1_177.jpg,fore,Unspecified,0.0,0,1819,2198,1919,2305,100,107
2137,levle1_177.jpg,fore,Unspecified,0.0,0,1957,2489,2072,2604,115,115
2138,levle1_177.jpg,fore,Unspecified,0.0,0,2570,2466,2685,2581,115,115
2139,levle1_177.jpg,fore,Unspecified,0.0,0,1436,3186,1520,3286,84,100
2140,levle1_611.jpg,fore,Unspecified,0.0,0,1597,918,1704,1048,107,130
2141,levle1_611.jpg,fore,Unspecified,0.0,0,815,2037,915,2106,100,69
2142,levle1_611.jpg,fore,Unspecified,0.0,0,738,2068,846,2221,108,153
2143,levle1_611.jpg,fore,Unspecified,0.0,0,1099,2144,1175,2221,76,77
2144,levle1_611.jpg,fore,Unspecified,0.0,0,1053,2236,1183,2405,130,169
2145,levle1_611.jpg,fore,Unspecified,0.0,0,1244,2336,1390,2458,146,122
2146,levle1_611.jpg,fore,Unspecified,0.0,0,1321,2474,1451,2604,130,130
2147,levle1_611.jpg,fore,Unspecified,0.0,0,1129,2619,1275,2750,146,131
2148,levle1_611.jpg,fore,Unspecified,0.0,0,1857,2857,2003,2949,146,92
2149,levle1_611.jpg,fore,Unspecified,0.0,0,1804,3079,1926,3133,122,54
2150,levle1_611.jpg,fore,Unspecified,0.0,0,1673,2880,1811,3018,138,138
2151,levle0_402.jpg,fore,Unspecified,0.0,0,1290,2987,1459,3087,169,100
2152,levle0_402.jpg,fore,Unspecified,0.0,0,1574,2934,1765,3056,191,122
2153,levle0_402.jpg,fore,Unspecified,0.0,0,1459,2474,1574,2627,115,153
2154,levle0_59.jpg,fore,Unspecified,0.0,0,1993,1842,2442,2191,449,349
2155,levle0_59.jpg,fore,Unspecified,0.0,0,2525,2856,2899,3255,374,399
2156,levle0_59.jpg,fore,Unspecified,0.0,0,1619,2516,1993,2865,374,349
2157,levle0_59.jpg,fore,Unspecified,0.0,0,2043,2915,2425,3239,382,324
2158,levle1_605.jpg,fore,Unspecified,0.0,0,432,1976,539,2083,107,107
2159,levle1_605.jpg,fore,Unspecified,0.0,0,547,2014,685,2114,138,100
2160,levle1_605.jpg,fore,Unspecified,0.0,0,777,2137,976,2320,199,183
2161,levle1_605.jpg,fore,Unspecified,0.0,0,731,2297,884,2420,153,123
2162,levle1_605.jpg,fore,Unspecified,0.0,0,478,2144,654,2290,176,146
2163,levle1_605.jpg,fore,Unspecified,0.0,0,340,2221,470,2351,130,130
2164,levle1_605.jpg,fore,Unspecified,0.0,0,539,2520,654,2658,115,138
2165,levle1_605.jpg,fore,Unspecified,0.0,0,761,2665,876,2780,115,115
2166,levle1_605.jpg,fore,Unspecified,0.0,0,907,2750,1030,2895,123,145
2167,levle1_605.jpg,fore,Unspecified,0.0,0,547,2750,723,2903,176,153
2168,levle1_605.jpg,fore,Unspecified,0.0,0,447,2865,547,2987,100,122
2169,levle1_605.jpg,fore,Unspecified,0.0,0,217,2673,340,2750,123,77
2170,levle1_605.jpg,fore,Unspecified,0.0,0,1788,1945,1888,2045,100,100
2171,levle1_605.jpg,fore,Unspecified,0.0,0,1175,2167,1267,2297,92,130
2172,levle1_605.jpg,fore,Unspecified,0.0,0,1750,3018,1888,3125,138,107
2173,levle0_416.jpg,fore,Unspecified,0.0,0,945,2412,1068,2512,123,100
2174,levle1_163.jpg,fore,Unspecified,0.0,0,1206,750,1329,880,123,130
2175,levle1_163.jpg,fore,Unspecified,0.0,0,1344,596,1474,696,130,100
2176,levle1_163.jpg,fore,Unspecified,0.0,0,708,2443,823,2550,115,107
2177,levle1_163.jpg,fore,Unspecified,0.0,0,1007,2366,1168,2512,161,146
2178,levle1_163.jpg,fore,Unspecified,0.0,0,1260,2098,1397,2213,137,115
2179,levle1_163.jpg,fore,Unspecified,0.0,0,1191,2573,1283,2711,92,138
2180,levle1_163.jpg,fore,Unspecified,0.0,0,1704,2527,1819,2704,115,177
2181,levle0_358.jpg,fore,Unspecified,0.0,0,1942,1968,2064,2075,122,107
2182,levle1_639.jpg,fore,Unspecified,0.0,0,57,58,66,71,9,13
2183,levle1_639.jpg,fore,Unspecified,0.0,0,55,79,72,96,17,17
2184,levle1_639.jpg,fore,Unspecified,0.0,0,36,96,47,105,11,9
2185,levle1_639.jpg,fore,Unspecified,0.0,0,59,120,69,130,10,10
2186,levle1_639.jpg,fore,Unspecified,0.0,0,83,136,92,147,9,11
2187,levle1_639.jpg,fore,Unspecified,0.0,0,49,144,63,161,14,17
2188,levle1_639.jpg,fore,Unspecified,0.0,0,72,151,88,165,16,14
2189,levle1_639.jpg,fore,Unspecified,0.0,0,89,158,108,181,19,23
2190,levle1_639.jpg,fore,Unspecified,0.0,0,82,186,99,196,17,10
2191,levle1_639.jpg,fore,Unspecified,0.0,0,83,209,98,224,15,15
2192,levle1_639.jpg,fore,Unspecified,0.0,0,134,45,151,59,17,14
2193,levle1_639.jpg,fore,Unspecified,0.0,0,142,171,157,182,15,11
2194,levle1_413.jpg,fore,Unspecified,0.0,0,1842,1071,1980,1163,138,92
2195,levle1_413.jpg,fore,Unspecified,0.0,0,547,2075,639,2213,92,138
2196,levle1_413.jpg,fore,Unspecified,0.0,0,1083,2681,1160,2765,77,84
2197,levle1_413.jpg,fore,Unspecified,0.0,0,1811,1232,1880,1286,69,54
2198,levle1_375.jpg,fore,Unspecified,0.0,0,700,665,807,834,107,169
2199,levle1_375.jpg,fore,Unspecified,0.0,0,64,2190,210,2328,146,138
2200,levle1_375.jpg,fore,Unspecified,0.0,0,33,1700,164,1815,131,115
2201,levle1_375.jpg,fore,Unspecified,0.0,0,179,2374,340,2520,161,146
2202,levle1_375.jpg,fore,Unspecified,0.0,0,210,2535,371,2650,161,115
2203,levle1_375.jpg,fore,Unspecified,0.0,0,18,2520,110,2642,92,122
2204,levle1_375.jpg,fore,Unspecified,0.0,0,876,2696,984,2796,108,100
2205,levle1_375.jpg,fore,Unspecified,0.0,0,1183,2926,1344,3064,161,138
2206,levle1_375.jpg,fore,Unspecified,0.0,0,769,3110,945,3248,176,138
2207,levle1_375.jpg,fore,Unspecified,0.0,0,784,2926,953,3064,169,138
2208,levle1_375.jpg,fore,Unspecified,0.0,0,547,3002,685,3179,138,177
2209,levle0_166.jpg,fore,Unspecified,0.0,0,853,2282,991,2428,138,146
2210,levle3_34.jpg,fore,,,0,299,284,320,309,21,25
2211,levle3_34.jpg,fore,,,0,255,319,278,336,23,17
2212,levle3_34.jpg,fore,,,0,271,284,296,311,25,27
2213,levle3_34.jpg,fore,,,0,259,259,294,289,35,30
2214,levle3_34.jpg,fore,,,0,211,380,232,405,21,25
2215,levle3_34.jpg,fore,,,0,327,309,359,336,32,27
2216,levle3_34.jpg,fore,,,0,266,352,278,376,12,24
2217,levle3_34.jpg,fore,,,0,284,346,301,362,17,16
2218,levle3_34.jpg,fore,,,0,311,331,339,361,28,30
2219,levle3_34.jpg,fore,,,0,384,365,409,398,25,33
2220,levle3_34.jpg,fore,,,0,389,418,401,427,12,9
2221,levle3_34.jpg,fore,,,0,372,397,388,431,16,34
2222,levle3_34.jpg,fore,,,0,395,469,420,502,25,33
2223,levle3_34.jpg,fore,,,0,322,483,353,516,31,33
2224,levle3_34.jpg,fore,,,0,327,449,354,475,27,26
2225,levle3_34.jpg,fore,,,0,299,397,317,419,18,22
2226,levle3_34.jpg,fore,,,0,311,364,342,391,31,27
2227,levle3_34.jpg,fore,,,0,318,400,347,418,29,18
2228,levle3_34.jpg,fore,,,0,273,392,290,411,17,19
2229,levle3_34.jpg,fore,,,0,245,389,277,408,32,19
2230,levle3_34.jpg,fore,,,0,294,453,326,482,32,29
2231,levle3_34.jpg,fore,,,0,336,196,353,224,17,28
2232,levle3_34.jpg,fore,,,0,303,210,331,226,28,16
2233,levle3_34.jpg,fore,,,0,398,160,422,181,24,21
2234,levle3_34.jpg,fore,,,0,370,313,389,335,19,22
2235,levle3_34.jpg,fore,,,0,345,345,372,368,27,23
2236,levle3_34.jpg,fore,,,0,328,279,348,291,20,12
2237,levle3_34.jpg,fore,,,0,285,235,311,258,26,23
2238,levle3_34.jpg,fore,,,0,246,433,276,458,30,25
2239,levle3_34.jpg,fore,,,0,278,422,299,440,21,18
2240,levle3_34.jpg,fore,,,0,316,419,340,435,24,16
2241,levle3_34.jpg,fore,,,0,322,439,345,456,23,17
2242,levle3_34.jpg,fore,,,0,339,428,366,445,27,17
2243,levle3_34.jpg,fore,,,0,349,414,373,433,24,19
2244,levle3_34.jpg,fore,,,0,361,440,388,452,27,12
2245,levle3_34.jpg,fore,,,0,360,458,376,480,16,22
2246,levle3_34.jpg,fore,,,0,373,453,398,477,25,24
2247,levle3_34.jpg,fore,,,0,442,383,463,407,21,24
2248,levle3_34.jpg,fore,,,0,366,495,385,509,19,14
2249,levle3_34.jpg,fore,,,0,357,505,370,520,13,15
2250,levle3_34.jpg,fore,,,0,233,303,248,323,15,20
2251,levle3_34.jpg,fore,,,0,206,340,222,356,16,16
2252,levle3_34.jpg,fore,,,0,355,279,372,296,17,17
2253,levle3_34.jpg,fore,,,0,310,257,326,269,16,12
2254,levle3_34.jpg,fore,,,0,292,261,310,278,18,17
2255,levle3_34.jpg,fore,,,0,252,306,272,318,20,12
2256,levle3_34.jpg,fore,,,0,233,280,253,299,20,19
2257,levle3_34.jpg,fore,,,0,378,221,400,239,22,18
2258,levle3_34.jpg,fore,,,0,289,363,308,389,19,26
2259,levle3_34.jpg,fore,,,0,250,336,272,355,22,19
2260,levle3_34.jpg,fore,,,0,283,311,310,340,27,29
2261,levle3_34.jpg,fore,,,0,322,264,338,283,16,19
2262,levle3_34.jpg,fore,,,0,314,227,331,244,17,17
2263,levle3_34.jpg,fore,,,0,387,200,406,217,19,17
2264,levle3_34.jpg,fore,,,0,356,174,372,192,16,18
2265,levle3_34.jpg,fore,,,0,395,339,407,353,12,14
2266,levle3_34.jpg,fore,,,0,403,333,419,352,16,19
2267,levle3_34.jpg,fore,,,0,386,308,404,326,18,18
2268,levle3_34.jpg,fore,,,0,390,324,406,338,16,14
2269,levle3_34.jpg,fore,,,0,359,394,372,412,13,18
2270,levle3_34.jpg,fore,,,0,351,385,366,400,15,15
2271,levle3_34.jpg,fore,,,0,250,366,270,387,20,21
2272,levle3_34.jpg,fore,,,0,409,351,430,372,21,21
2273,levle3_34.jpg,fore,,,0,483,313,504,339,21,26
2274,levle3_34.jpg,fore,,,0,447,330,485,353,38,23
2275,levle3_20.jpg,fore,Unspecified,0.0,0,2,219,25,245,23,26
2276,levle3_20.jpg,fore,Unspecified,0.0,0,64,224,95,253,31,29
2277,levle3_20.jpg,fore,Unspecified,0.0,0,95,194,118,226,23,32
2278,levle3_20.jpg,fore,Unspecified,0.0,0,144,338,182,376,38,38
2279,levle3_20.jpg,fore,Unspecified,0.0,0,91,148,125,179,34,31
2280,levle3_20.jpg,fore,Unspecified,0.0,0,133,133,157,162,24,29
2281,levle3_20.jpg,fore,Unspecified,0.0,0,149,152,177,177,28,25
2282,levle3_20.jpg,fore,Unspecified,0.0,0,154,202,181,234,27,32
2283,levle3_20.jpg,fore,Unspecified,0.0,0,184,182,205,203,21,21
2284,levle3_20.jpg,fore,Unspecified,0.0,0,194,205,221,243,27,38
2285,levle3_20.jpg,fore,Unspecified,0.0,0,184,242,205,264,21,22
2286,levle3_20.jpg,fore,Unspecified,0.0,0,197,264,230,288,33,24
2287,levle3_20.jpg,fore,Unspecified,0.0,0,190,296,210,323,20,27
2288,levle3_20.jpg,fore,Unspecified,0.0,0,264,283,300,308,36,25
2289,levle3_20.jpg,fore,Unspecified,0.0,0,299,294,321,321,22,27
2290,levle3_20.jpg,fore,Unspecified,0.0,0,323,277,352,310,29,33
2291,levle3_20.jpg,fore,Unspecified,0.0,0,265,318,296,347,31,29
2292,levle3_20.jpg,fore,Unspecified,0.0,0,309,332,341,357,32,25
2293,levle3_20.jpg,fore,Unspecified,0.0,0,374,300,402,337,28,37
2294,levle3_20.jpg,fore,Unspecified,0.0,0,443,335,471,365,28,30
2295,levle3_20.jpg,fore,Unspecified,0.0,0,416,365,442,387,26,22
2296,levle3_20.jpg,fore,Unspecified,0.0,0,453,372,478,402,25,30
2297,levle3_20.jpg,fore,Unspecified,0.0,0,361,402,397,440,36,38
2298,levle3_20.jpg,fore,Unspecified,0.0,0,344,400,366,432,22,32
2299,levle3_20.jpg,fore,Unspecified,0.0,0,311,362,339,396,28,34
2300,levle3_20.jpg,fore,Unspecified,0.0,0,387,161,398,187,11,26
2301,levle3_20.jpg,fore,Unspecified,0.0,0,391,170,414,190,23,20
2302,levle3_20.jpg,fore,Unspecified,0.0,0,427,139,453,173,26,34
2303,levle3_20.jpg,fore,Unspecified,0.0,0,475,187,503,219,28,32
2304,levle3_20.jpg,fore,Unspecified,0.0,0,441,217,471,248,30,31
2305,levle3_20.jpg,fore,Unspecified,0.0,0,573,180,594,210,21,30
2306,levle3_20.jpg,fore,Unspecified,0.0,0,553,94,583,122,30,28
2307,levle3_20.jpg,fore,Unspecified,0.0,0,548,66,585,101,37,35
2308,levle3_20.jpg,fore,Unspecified,0.0,0,533,281,564,316,31,35
2309,levle3_20.jpg,fore,Unspecified,0.0,0,403,105,410,118,7,13
2310,levle3_20.jpg,fore,Unspecified,0.0,0,386,87,407,119,21,32
2311,levle3_20.jpg,fore,Unspecified,0.0,0,273,130,298,154,25,24
2312,levle3_20.jpg,fore,Unspecified,0.0,0,317,174,350,202,33,28
2313,levle3_20.jpg,fore,Unspecified,0.0,0,315,138,331,161,16,23
2314,levle3_20.jpg,fore,Unspecified,0.0,0,332,227,365,249,33,22
2315,levle3_20.jpg,fore,Unspecified,0.0,0,162,71,192,112,30,41
2316,levle3_20.jpg,fore,Unspecified,0.0,0,266,79,296,106,30,27
2317,levle3_20.jpg,fore,Unspecified,0.0,0,472,30,483,47,11,17
2318,levle3_20.jpg,fore,Unspecified,0.0,0,463,77,483,115,20,38
2319,levle3_20.jpg,fore,Unspecified,0.0,0,172,418,210,447,38,29
2320,levle3_20.jpg,fore,Unspecified,0.0,0,238,383,270,413,32,30
2321,levle3_20.jpg,fore,Unspecified,0.0,0,59,129,93,165,34,36
2322,levle3_20.jpg,fore,Unspecified,0.0,0,127,225,166,271,39,46
2323,levle3_20.jpg,fore,Unspecified,0.0,0,212,107,247,144,35,37
2324,levle3_20.jpg,fore,Unspecified,0.0,0,130,66,159,106,29,40
2325,levle3_20.jpg,fore,Unspecified,0.0,0,276,3,336,36,60,33
2326,levle3_20.jpg,fore,Unspecified,0.0,0,315,39,348,72,33,33
2327,levle3_20.jpg,fore,Unspecified,0.0,0,360,2,397,36,37,34
2328,levle3_20.jpg,fore,Unspecified,0.0,0,333,89,363,126,30,37
2329,levle3_20.jpg,fore,Unspecified,0.0,0,362,172,377,200,15,28
2330,levle3_20.jpg,fore,Unspecified,0.0,0,476,151,513,178,37,27
2331,levle3_20.jpg,fore,Unspecified,0.0,0,408,218,427,242,19,24
2332,levle1_361.jpg,fore,Unspecified,0.0,0,1206,2926,1306,3064,100,138
2333,levle1_361.jpg,fore,Unspecified,0.0,0,1145,2750,1267,2849,122,99
2334,levle1_361.jpg,fore,Unspecified,0.0,0,1068,2934,1168,3018,100,84
2335,levle1_361.jpg,fore,Unspecified,0.0,0,1045,3010,1152,3156,107,146
2336,levle1_361.jpg,fore,Unspecified,0.0,0,1505,2941,1604,3064,99,123
2337,levle1_361.jpg,fore,Unspecified,0.0,0,1627,2972,1719,3079,92,107
2338,levle1_361.jpg,fore,Unspecified,0.0,0,1727,3056,1850,3202,123,146
2339,levle1_361.jpg,fore,Unspecified,0.0,0,1873,2780,1995,2888,122,108
2340,levle1_361.jpg,fore,Unspecified,0.0,0,2095,2796,2263,2918,168,122
2341,levle1_361.jpg,fore,Unspecified,0.0,0,2018,2903,2171,3041,153,138
2342,levle0_172.jpg,fore,Unspecified,0.0,0,2148,2267,2271,2420,123,153
2343,levle0_172.jpg,fore,Unspecified,0.0,0,2807,2144,2884,2297,77,153
2344,levle0_172.jpg,fore,Unspecified,0.0,0,1206,3163,1313,3286,107,123
2345,levle0_172.jpg,fore,Unspecified,0.0,0,1390,3225,1497,3301,107,76
2346,levle1_407.jpg,fore,Unspecified,0.0,0,1750,2183,1926,2313,176,130
2347,levle1_407.jpg,fore,Unspecified,0.0,0,1926,2106,2102,2251,176,145
2348,levle1_407.jpg,fore,Unspecified,0.0,0,2194,2106,2363,2236,169,130
2349,levle1_407.jpg,fore,Unspecified,0.0,0,2440,1807,2555,1922,115,115
2350,levle1_407.jpg,fore,Unspecified,0.0,0,2509,1930,2639,2060,130,130
2351,levle1_407.jpg,fore,Unspecified,0.0,0,2079,2282,2256,2428,177,146
2352,levle1_407.jpg,fore,Unspecified,0.0,0,1988,2596,2148,2727,160,131
2353,levle1_349.jpg,fore,Unspecified,0.0,0,1283,2236,1482,2451,199,215
2354,levle1_349.jpg,fore,Unspecified,0.0,0,1612,2244,1765,2443,153,199
2355,levle1_349.jpg,fore,Unspecified,0.0,0,1819,2129,1965,2259,146,130
2356,levle1_349.jpg,fore,Unspecified,0.0,0,1765,2282,1888,2397,123,115
2357,levle1_349.jpg,fore,Unspecified,0.0,0,1896,2343,2026,2543,130,200
2358,levle1_349.jpg,fore,Unspecified,0.0,0,1727,2412,1880,2612,153,200
2359,levle1_349.jpg,fore,Unspecified,0.0,0,1635,2612,1796,2773,161,161
2360,levle1_403.jpg,fore,,,0,654,1531,784,1692,130,161
2361,levle1_403.jpg,fore,,,0,792,2888,922,3048,130,160
2362,levle1_403.jpg,fore,,,0,662,2842,769,2972,107,130
2363,levle1_403.jpg,fore,,,0,524,2727,662,2872,138,145
2364,levle1_403.jpg,fore,,,0,561,1163,654,1253,93,90
2365,levle1_403.jpg,fore,,,0,1115,2725,1215,2812,100,87
2366,levle1_365.jpg,fore,,,0,731,2589,838,2719,107,130
2367,levle1_365.jpg,fore,,,0,991,2811,1068,2995,77,184
2368,levle1_365.jpg,fore,,,0,1436,3087,1612,3225,176,138
2369,levle1_365.jpg,fore,,,0,1658,2765,1842,2926,184,161
2370,levle1_365.jpg,fore,,,0,1587,3074,1705,3184,118,110
2371,levle1_365.jpg,fore,,,0,1167,2301,1277,2405,110,104
2372,levle0_176.jpg,fore,Unspecified,0.0,0,1382,2665,1566,2857,184,192
2373,levle3_24.jpg,fore,,,0,229,319,274,352,45,33
2374,levle3_24.jpg,fore,,,0,283,310,307,339,24,29
2375,levle3_24.jpg,fore,,,0,279,245,314,272,35,27
2376,levle3_24.jpg,fore,,,0,400,130,439,164,39,34
2377,levle3_24.jpg,fore,,,0,359,92,403,131,44,39
2378,levle3_24.jpg,fore,,,0,168,168,209,213,41,45
2379,levle3_24.jpg,fore,,,0,296,200,358,234,62,34
2380,levle3_24.jpg,fore,,,0,334,326,387,363,53,37
2381,levle3_24.jpg,fore,,,0,362,374,399,415,37,41
2382,levle3_24.jpg,fore,,,0,295,378,328,415,33,37
2383,levle3_24.jpg,fore,,,0,278,397,309,430,31,33
2384,levle3_24.jpg,fore,,,0,257,399,298,419,41,20
2385,levle3_24.jpg,fore,,,0,236,426,247,450,11,24
2386,levle3_24.jpg,fore,,,0,260,432,283,458,23,26
2387,levle3_24.jpg,fore,,,0,278,447,300,469,22,22
2388,levle3_24.jpg,fore,,,0,298,427,330,448,32,21
2389,levle3_24.jpg,fore,,,0,331,408,354,432,23,24
2390,levle3_24.jpg,fore,,,0,352,432,387,458,35,26
2391,levle3_24.jpg,fore,,,0,285,483,307,520,22,37
2392,levle3_24.jpg,fore,,,0,341,483,372,516,31,33
2393,levle3_24.jpg,fore,,,0,382,481,414,516,32,35
2394,levle3_24.jpg,fore,,,0,413,461,445,493,32,32
2395,levle3_24.jpg,fore,,,0,421,418,464,455,43,37
2396,levle3_24.jpg,fore,,,0,446,450,478,485,32,35
2397,levle3_24.jpg,fore,,,0,518,418,544,446,26,28
2398,levle3_24.jpg,fore,,,0,533,409,557,429,24,20
2399,levle3_24.jpg,fore,,,0,533,437,558,461,25,24
2400,levle3_24.jpg,fore,,,0,400,345,427,392,27,47
2401,levle3_24.jpg,fore,,,0,456,281,500,305,44,24
2402,levle3_24.jpg,fore,,,0,512,297,558,346,46,49
2403,levle3_24.jpg,fore,,,0,359,286,401,324,42,38
2404,levle3_24.jpg,fore,,,0,579,380,599,399,20,19
2405,levle3_24.jpg,fore,,,0,547,357,589,397,42,40
2406,levle3_24.jpg,fore,,,0,268,170,293,190,25,20
2407,levle3_24.jpg,fore,,,0,315,164,341,185,26,21
2408,levle3_24.jpg,fore,,,0,341,165,363,192,22,27
2409,levle3_24.jpg,fore,,,0,362,249,382,271,20,22
2410,levle3_24.jpg,fore,,,0,412,244,443,268,31,24
2411,levle3_24.jpg,fore,,,0,381,269,409,291,28,22
2412,levle3_24.jpg,fore,,,0,414,331,435,350,21,19
2413,levle3_24.jpg,fore,,,0,447,347,478,372,31,25
2414,levle3_24.jpg,fore,,,0,444,389,466,419,22,30
2415,levle3_24.jpg,fore,,,0,482,377,507,406,25,29
2416,levle3_24.jpg,fore,,,0,495,428,515,448,20,20
2417,levle3_24.jpg,fore,,,0,347,518,364,539,17,21
2418,levle3_24.jpg,fore,,,0,326,526,349,544,23,18
2419,levle3_24.jpg,fore,,,0,288,523,315,546,27,23
2420,levle3_24.jpg,fore,,,0,261,516,285,537,24,21
2421,levle3_24.jpg,fore,,,0,236,500,263,523,27,23
2422,levle3_24.jpg,fore,,,0,226,475,247,495,21,20
2423,levle3_24.jpg,fore,,,0,261,471,284,491,23,20
2424,levle3_24.jpg,fore,,,0,334,445,354,469,20,24
2425,levle3_30.jpg,fore,,,0,144,56,157,67,13,11
2426,levle3_30.jpg,fore,,,0,134,44,147,55,13,11
2427,levle3_30.jpg,fore,,,0,143,33,159,48,16,15
2428,levle3_30.jpg,fore,,,0,118,59,131,76,13,17
2429,levle3_30.jpg,fore,,,0,132,76,144,87,12,11
2430,levle3_30.jpg,fore,,,0,127,87,136,96,9,9
2431,levle3_30.jpg,fore,,,0,133,93,144,104,11,11
2432,levle3_30.jpg,fore,,,0,62,67,72,76,10,9
2433,levle3_30.jpg,fore,,,0,81,99,90,111,9,12
2434,levle3_30.jpg,fore,,,0,72,100,81,110,9,10
2435,levle3_30.jpg,fore,,,0,96,102,106,113,10,11
2436,levle3_30.jpg,fore,,,0,148,80,158,91,10,11
2437,levle3_30.jpg,fore,,,0,108,129,124,140,16,11
2438,levle3_30.jpg,fore,,,0,93,170,107,180,14,10
2439,levle3_30.jpg,fore,,,0,67,160,73,172,6,12
2440,levle3_30.jpg,fore,,,0,81,138,92,149,11,11
2441,levle3_30.jpg,fore,,,0,126,141,136,151,10,10
2442,levle3_30.jpg,fore,,,0,134,131,146,142,12,11
2443,levle3_30.jpg,fore,,,0,198,133,207,144,9,11
2444,levle3_30.jpg,fore,,,0,195,143,208,160,13,17
2445,levle3_30.jpg,fore,,,0,131,34,142,44,11,10
2446,levle3_30.jpg,fore,,,0,105,40,122,53,17,13
2447,levle3_30.jpg,fore,,,0,108,54,121,64,13,10
2448,levle3_30.jpg,fore,,,0,84,61,98,73,14,12
2449,levle3_30.jpg,fore,,,0,110,75,125,87,15,12
2450,levle3_30.jpg,fore,,,0,108,96,123,107,15,11
2451,levle3_30.jpg,fore,,,0,107,113,119,128,12,15
2452,levle3_30.jpg,fore,,,0,123,104,132,116,9,12
2453,levle3_30.jpg,fore,,,0,135,108,147,121,12,13
2454,levle3_30.jpg,fore,,,0,147,121,154,133,7,12
2455,levle3_30.jpg,fore,,,0,154,115,166,129,12,14
2456,levle3_30.jpg,fore,,,0,99,130,112,141,13,11
2457,levle3_30.jpg,fore,,,0,90,137,104,148,14,11
2458,levle3_30.jpg,fore,,,0,88,112,100,121,12,9
2459,levle3_30.jpg,fore,,,0,72,121,83,134,11,13
2460,levle3_30.jpg,fore,,,0,79,170,90,184,11,14
2461,levle3_30.jpg,fore,,,0,148,141,162,155,14,14
2462,levle3_30.jpg,fore,,,0,180,121,190,129,10,8
2463,levle3_30.jpg,fore,,,0,173,99,184,107,11,8
2464,levle3_30.jpg,fore,,,0,89,148,98,160,9,12
2465,levle3_30.jpg,fore,,,0,110,166,119,176,9,10
2466,levle3_30.jpg,fore,,,0,112,174,121,181,9,7
2467,levle3_30.jpg,fore,,,0,119,158,125,168,6,10
2468,levle3_30.jpg,fore,,,0,120,168,129,177,9,9
2469,levle3_30.jpg,fore,,,0,124,175,132,183,8,8
2470,levle3_30.jpg,fore,,,0,129,167,139,176,10,9
2471,levle3_30.jpg,fore,,,0,125,162,133,171,8,9
2472,levle3_30.jpg,fore,,,0,65,139,73,147,8,8
2473,levle3_30.jpg,fore,,,0,68,148,77,158,9,10
2474,levle3_30.jpg,fore,,,0,75,157,85,171,10,14
2475,levle3_30.jpg,fore,,,0,91,86,98,98,7,12
2476,levle3_30.jpg,fore,,,0,96,88,108,96,12,8
2477,levle3_30.jpg,fore,,,0,91,75,102,85,11,10
2478,levle3_30.jpg,fore,,,0,103,65,117,75,14,10
2479,levle1_371.jpg,fore,Unspecified,0.0,0,1911,872,2018,1010,107,138
2480,levle1_371.jpg,fore,Unspecified,0.0,0,1857,1125,2049,1255,192,130
2481,levle1_371.jpg,fore,Unspecified,0.0,0,1696,2221,1796,2305,100,84
2482,levle1_371.jpg,fore,Unspecified,0.0,0,1474,2382,1566,2489,92,107
2483,levle1_371.jpg,fore,Unspecified,0.0,0,601,2313,692,2435,91,122
2484,levle1_371.jpg,fore,Unspecified,0.0,0,1451,3301,1597,3432,146,131
2485,levle1_371.jpg,fore,Unspecified,0.0,0,1022,2642,1114,2788,92,146
2486,levle1_371.jpg,fore,Unspecified,0.0,0,1037,2397,1206,2481,169,84
2487,levle0_162.jpg,fore,Unspecified,0.0,0,1949,780,2072,887,123,107
2488,levle0_162.jpg,fore,Unspecified,0.0,0,1620,2589,1765,2719,145,130
2489,levle1_417.jpg,fore,,,0,2501,1462,2693,1654,192,192
2490,levle1_417.jpg,fore,,,0,1390,3133,1566,3271,176,138
2491,levle1_417.jpg,fore,,,0,1658,3240,1819,3393,161,153
2492,levle1_417.jpg,fore,,,0,2440,2826,2547,3048,107,222
2493,levle1_417.jpg,fore,,,0,2225,2834,2371,2995,146,161
2494,levle1_417.jpg,fore,,,0,1512,3339,1633,3446,121,107
2495,levle3_18.jpg,fore,,,0,164,473,195,490,31,17
2496,levle3_18.jpg,fore,,,0,185,479,215,514,30,35
2497,levle3_18.jpg,fore,,,0,148,512,177,543,29,31
2498,levle3_18.jpg,fore,,,0,136,530,175,569,39,39
2499,levle3_18.jpg,fore,,,0,175,551,205,575,30,24
2500,levle3_18.jpg,fore,,,0,185,585,213,612,28,27
2501,levle3_18.jpg,fore,,,0,111,583,148,614,37,31
2502,levle3_18.jpg,fore,,,0,148,594,179,626,31,32
2503,levle3_18.jpg,fore,,,0,128,626,158,657,30,31
2504,levle3_18.jpg,fore,,,0,166,634,189,683,23,49
2505,levle3_18.jpg,fore,,,0,226,449,260,488,34,39
2506,levle3_18.jpg,fore,,,0,395,504,424,551,29,47
2507,levle3_18.jpg,fore,,,0,436,475,460,508,24,33
2508,levle3_18.jpg,fore,,,0,315,506,342,551,27,45
2509,levle3_18.jpg,fore,,,0,324,553,362,598,38,45
2510,levle3_18.jpg,fore,,,0,350,587,383,624,33,37
2511,levle3_18.jpg,fore,,,0,385,587,413,622,28,35
2512,levle3_18.jpg,fore,,,0,428,581,460,616,32,35
2513,levle3_18.jpg,fore,,,0,324,661,358,689,34,28
2514,levle3_18.jpg,fore,,,0,358,661,391,710,33,49
2515,levle3_18.jpg,fore,,,0,387,671,432,718,45,47
2516,levle3_18.jpg,fore,,,0,415,634,468,681,53,47
2517,levle3_18.jpg,fore,,,0,458,636,505,685,47,49
2518,levle3_18.jpg,fore,,,0,483,602,517,634,34,32
2519,levle3_18.jpg,fore,,,0,475,555,515,590,40,35
2520,levle3_18.jpg,fore,,,0,493,492,519,520,26,28
2521,levle3_18.jpg,fore,,,0,521,524,556,571,35,47
2522,levle3_18.jpg,fore,,,0,574,512,617,561,43,49
2523,levle3_18.jpg,fore,,,0,572,439,611,496,39,57
2524,levle3_18.jpg,fore,,,0,495,402,523,443,28,41
2525,levle3_18.jpg,fore,,,0,613,420,664,449,51,29
2526,levle3_18.jpg,fore,,,0,224,530,260,592,36,62
2527,levle3_18.jpg,fore,,,0,268,528,311,575,43,47
2528,levle3_18.jpg,fore,,,0,277,563,330,612,53,49
2529,levle3_18.jpg,fore,,,0,405,439,452,488,47,49
2530,levle3_18.jpg,fore,,,0,568,577,601,614,33,37
2531,levle3_18.jpg,fore,,,0,515,606,574,649,59,43
2532,levle3_18.jpg,fore,,,0,611,465,650,506,39,41
2533,levle3_18.jpg,fore,,,0,564,373,646,432,82,59
2534,levle3_18.jpg,fore,,,0,297,388,342,437,45,49
2535,levle3_18.jpg,fore,,,0,355,499,396,536,41,37
2536,levle3_18.jpg,fore,,,0,133,472,165,515,32,43
2537,levle3_18.jpg,fore,,,0,111,513,139,543,28,30
2538,levle3_18.jpg,fore,,,0,249,593,281,632,32,39
2539,levle3_18.jpg,fore,,,0,103,647,138,672,35,25
2540,levle3_18.jpg,fore,,,0,127,677,166,718,39,41
2541,levle3_18.jpg,fore,,,0,206,655,242,693,36,38
2542,levle3_18.jpg,fore,,,0,201,618,236,655,35,37
2543,levle3_18.jpg,fore,,,0,273,666,307,703,34,37
2544,levle3_18.jpg,fore,,,0,245,678,279,714,34,36
2545,levle3_18.jpg,fore,,,0,238,636,274,677,36,41
2546,levle3_18.jpg,fore,,,0,305,606,341,643,36,37
2547,levle3_18.jpg,fore,,,0,317,428,361,462,44,34
2548,levle3_18.jpg,fore,,,0,536,651,578,689,42,38
2549,levle3_18.jpg,fore,,,0,485,692,539,729,54,37
2550,levle1_359.jpg,fore,Unspecified,0.0,0,2011,2757,2187,2872,176,115
2551,levle1_359.jpg,fore,Unspecified,0.0,0,2118,2581,2325,2704,207,123
2552,levle1_359.jpg,fore,Unspecified,0.0,0,1750,2872,1934,3025,184,153
2553,levle1_359.jpg,fore,Unspecified,0.0,0,1535,2849,1712,2972,177,123
2554,levle1_359.jpg,fore,Unspecified,0.0,0,1512,2704,1712,2849,200,145
2555,levle1_359.jpg,fore,Unspecified,0.0,0,1942,2911,2064,3002,122,91
2556,levle0_189.jpg,fore,Unspecified,0.0,0,2478,2160,2647,2366,169,206
2557,levle0_189.jpg,fore,Unspecified,0.0,0,2148,2474,2378,2688,230,214
2558,levle0_189.jpg,fore,Unspecified,0.0,0,1037,1853,1214,2083,177,230
2559,levle0_189.jpg,fore,Unspecified,0.0,0,800,251,953,443,153,192
2560,levle0_189.jpg,fore,Unspecified,0.0,0,991,221,1122,443,131,222
2561,levle0_374.jpg,fore,Unspecified,0.0,0,2524,2481,2662,2619,138,138
2562,levle1_167.jpg,fore,Unspecified,0.0,0,1214,420,1321,566,107,146
2563,levle1_167.jpg,fore,Unspecified,0.0,0,1214,681,1375,826,161,145
2564,levle1_167.jpg,fore,Unspecified,0.0,0,2455,1102,2639,1232,184,130
2565,levle1_167.jpg,fore,Unspecified,0.0,0,2478,1968,2677,2083,199,115
2566,levle1_167.jpg,fore,Unspecified,0.0,0,2470,2052,2662,2221,192,169
2567,levle1_167.jpg,fore,Unspecified,0.0,0,2478,2251,2631,2374,153,123
2568,levle1_167.jpg,fore,Unspecified,0.0,0,2340,2297,2501,2405,161,108
2569,levle0_49.jpg,fore,Unspecified,0.0,0,516,2198,616,2343,100,145
2570,levle0_49.jpg,fore,Unspecified,0.0,0,892,2780,999,2949,107,169
2571,levle0_49.jpg,fore,Unspecified,0.0,0,907,3048,1076,3255,169,207
2572,levle1_601.jpg,fore,Unspecified,0.0,0,56,979,233,1140,177,161
2573,levle1_601.jpg,fore,Unspecified,0.0,0,309,1286,371,1432,62,146
2574,levle1_601.jpg,fore,Unspecified,0.0,0,401,1884,532,2037,131,153
2575,levle1_601.jpg,fore,Unspecified,0.0,0,1099,3010,1191,3110,92,100
2576,levle1_601.jpg,fore,Unspecified,0.0,0,1612,2842,1773,2964,161,122
2577,levle1_601.jpg,fore,Unspecified,0.0,0,1451,1845,1658,2068,207,223
2578,levle1_601.jpg,fore,Unspecified,0.0,0,164,2696,332,2834,168,138
2579,levle0_412.jpg,fore,Unspecified,0.0,0,830,1960,976,2060,146,100
2580,levle1_615.jpg,fore,Unspecified,0.0,0,961,2236,1030,2351,69,115
2581,levle1_615.jpg,fore,Unspecified,0.0,0,930,2075,999,2144,69,69
2582,levle1_615.jpg,fore,Unspecified,0.0,0,1037,2190,1183,2412,146,222
2583,levle1_615.jpg,fore,Unspecified,0.0,0,838,2183,968,2351,130,168
2584,levle1_615.jpg,fore,Unspecified,0.0,0,585,2229,769,2412,184,183
2585,levle1_615.jpg,fore,Unspecified,0.0,0,647,2014,807,2144,160,130
2586,levle1_615.jpg,fore,Unspecified,0.0,0,317,1654,509,1891,192,237
2587,levle1_615.jpg,fore,Unspecified,0.0,0,1099,2527,1191,2581,92,54
2588,levle1_615.jpg,fore,Unspecified,0.0,0,915,2665,1045,2857,130,192
2589,levle1_615.jpg,fore,Unspecified,0.0,0,670,2627,869,2811,199,184
2590,levle0_406.jpg,fore,Unspecified,0.0,0,1888,3209,2110,3347,222,138
2591,levle0_406.jpg,fore,Unspecified,0.0,0,1704,857,1934,1010,230,153
2592,levle0_360.jpg,fore,Unspecified,0.0,0,2263,2673,2447,2811,184,138
2593,levle0_360.jpg,fore,Unspecified,0.0,0,2593,2083,2693,2213,100,130
2594,levle1_173.jpg,fore,Unspecified,0.0,0,1106,650,1198,773,92,123
2595,levle1_173.jpg,fore,Unspecified,0.0,0,1520,589,1673,734,153,145
2596,levle1_173.jpg,fore,Unspecified,0.0,0,1873,305,2011,382,138,77
2597,levle1_173.jpg,fore,Unspecified,0.0,0,823,2336,945,2466,122,130
2598,levle1_173.jpg,fore,Unspecified,0.0,0,700,2244,884,2343,184,99
2599,levle1_173.jpg,fore,Unspecified,0.0,0,1865,1347,1949,1485,84,138
2600,levle0_75.jpg,fore,Unspecified,0.0,0,2974,1884,3240,2092,266,208
2601,levle0_75.jpg,fore,Unspecified,0.0,0,3381,1502,3531,1701,150,199
2602,levle0_75.jpg,fore,Unspecified,0.0,0,655,1709,888,1967,233,258
2603,levle0_61.jpg,fore,Unspecified,0.0,0,3140,1277,3506,1493,366,216
2604,levle0_61.jpg,fore,Unspecified,0.0,0,3606,1194,3913,1568,307,374
2605,levle0_61.jpg,fore,Unspecified,0.0,0,1677,2973,2101,3239,424,266
2606,levle0_61.jpg,fore,Unspecified,0.0,0,1270,2308,1519,2640,249,332
2607,levle1_629.jpg,fore,Unspecified,0.0,0,2194,842,2325,987,131,145
2608,levle1_629.jpg,fore,Unspecified,0.0,0,1375,2504,1558,2650,183,146
2609,levle1_629.jpg,fore,Unspecified,0.0,0,1168,2297,1336,2420,168,123
2610,levle1_629.jpg,fore,Unspecified,0.0,0,945,2244,1106,2405,161,161
2611,levle1_629.jpg,fore,Unspecified,0.0,0,984,1761,1091,1815,107,54
2612,levle1_629.jpg,fore,Unspecified,0.0,0,999,1914,1160,2075,161,161
2613,levle1_629.jpg,fore,Unspecified,0.0,0,593,2658,715,2734,122,76
2614,levle1_629.jpg,fore,Unspecified,0.0,0,761,2604,876,2727,115,123
2615,levle1_629.jpg,fore,Unspecified,0.0,0,1022,2673,1168,2819,146,146
2616,levle1_629.jpg,fore,Unspecified,0.0,0,1007,2888,1129,3010,122,122
2617,levle1_198.jpg,fore,Unspecified,0.0,0,1160,3002,1283,3156,123,154
2618,levle0_214.jpg,fore,Unspecified,0.0,0,1260,2259,1459,2374,199,115
2619,levle0_214.jpg,fore,Unspecified,0.0,0,1237,2098,1397,2229,160,131
2620,levle2_58.jpg,fore,Unspecified,0.0,0,2517,695,2666,845,149,150
2621,levle2_58.jpg,fore,Unspecified,0.0,0,2550,513,2658,621,108,108
2622,levle2_58.jpg,fore,Unspecified,0.0,0,2999,479,3256,679,257,200
2623,levle2_58.jpg,fore,Unspecified,0.0,0,3099,621,3232,745,133,124
2624,levle2_58.jpg,fore,Unspecified,0.0,0,3207,670,3356,787,149,117
2625,levle2_58.jpg,fore,Unspecified,0.0,0,3190,837,3331,961,141,124
2626,levle2_58.jpg,fore,Unspecified,0.0,0,2841,562,2999,754,158,192
2627,levle2_58.jpg,fore,Unspecified,0.0,0,2858,313,2949,446,91,133
2628,levle2_58.jpg,fore,Unspecified,0.0,0,3373,1020,3564,1194,191,174
2629,levle2_58.jpg,fore,Unspecified,0.0,0,3273,1252,3406,1427,133,175
2630,levle2_58.jpg,fore,Unspecified,0.0,0,1993,1136,2093,1269,100,133
2631,levle2_58.jpg,fore,Unspecified,0.0,0,2035,1618,2159,1801,124,183
2632,levle2_58.jpg,fore,Unspecified,0.0,0,1827,2009,1993,2191,166,182
2633,levle2_58.jpg,fore,Unspecified,0.0,0,1868,2291,1968,2399,100,108
2634,levle2_58.jpg,fore,Unspecified,0.0,0,2351,2499,2484,2657,133,158
2635,levle2_58.jpg,fore,Unspecified,0.0,0,2442,2449,2641,2557,199,108
2636,levle2_58.jpg,fore,Unspecified,0.0,0,2309,2225,2558,2524,249,299
2637,levle2_58.jpg,fore,Unspecified,0.0,0,2060,2657,2151,2765,91,108
2638,levle2_58.jpg,fore,Unspecified,0.0,0,2442,2948,2625,3106,183,158
2639,levle2_58.jpg,fore,Unspecified,0.0,0,2616,3072,2741,3156,125,84
2640,levle2_58.jpg,fore,Unspecified,0.0,0,2700,2931,2841,3048,141,117
2641,levle2_70.jpg,fore,Unspecified,0.0,0,1597,704,1765,865,168,161
2642,levle2_70.jpg,fore,Unspecified,0.0,0,1390,972,1535,1033,145,61
2643,levle2_70.jpg,fore,Unspecified,0.0,0,1145,1010,1321,1117,176,107
2644,levle2_70.jpg,fore,Unspecified,0.0,0,1306,1309,1451,1485,145,176
2645,levle2_70.jpg,fore,Unspecified,0.0,0,1451,1370,1597,1508,146,138
2646,levle2_70.jpg,fore,Unspecified,0.0,0,2417,1255,2601,1401,184,146
2647,levle2_70.jpg,fore,Unspecified,0.0,0,2677,1355,2861,1516,184,161
2648,levle2_70.jpg,fore,Unspecified,0.0,0,2677,1799,2792,1899,115,100
2649,levle2_70.jpg,fore,Unspecified,0.0,0,2401,1792,2524,1945,123,153
2650,levle2_70.jpg,fore,Unspecified,0.0,0,2585,1945,2746,2106,161,161
2651,levle2_70.jpg,fore,Unspecified,0.0,0,2815,2045,2945,2198,130,153
2652,levle2_70.jpg,fore,Unspecified,0.0,0,2233,2029,2432,2121,199,92
2653,levle2_70.jpg,fore,Unspecified,0.0,0,2371,2144,2524,2221,153,77
2654,levle2_70.jpg,fore,Unspecified,0.0,0,2424,2251,2562,2412,138,161
2655,levle2_70.jpg,fore,Unspecified,0.0,0,2279,2374,2486,2535,207,161
2656,levle2_70.jpg,fore,Unspecified,0.0,0,2401,2612,2578,2765,177,153
2657,levle2_70.jpg,fore,Unspecified,0.0,0,2072,2290,2286,2435,214,145
2658,levle2_70.jpg,fore,Unspecified,0.0,0,1436,2972,1551,3125,115,153
2659,levle2_70.jpg,fore,Unspecified,0.0,0,1520,3179,1696,3347,176,168
2660,levle2_70.jpg,fore,Unspecified,0.0,0,1796,2895,1965,3102,169,207
2661,levle2_70.jpg,fore,Unspecified,0.0,0,1673,2918,1773,3087,100,169
2662,levle2_70.jpg,fore,Unspecified,0.0,0,1152,1669,1352,1884,200,215
2663,levle2_70.jpg,fore,Unspecified,0.0,0,1352,2045,1566,2251,214,206
2664,levle2_70.jpg,fore,Unspecified,0.0,0,1658,2144,1888,2389,230,245
2665,levle2_70.jpg,fore,Unspecified,0.0,0,1942,2443,2041,2573,99,130
2666,levle2_70.jpg,fore,Unspecified,0.0,0,2240,2803,2340,2872,100,69
2667,levle2_70.jpg,fore,Unspecified,0.0,0,2279,2995,2394,3087,115,92
2668,levle2_70.jpg,fore,Unspecified,0.0,0,2539,2167,2677,2305,138,138
2669,levle2_70.jpg,fore,Unspecified,0.0,0,2601,2366,2731,2527,130,161
2670,levle2_70.jpg,fore,Unspecified,0.0,0,2348,2834,2486,2941,138,107
2671,levle2_64.jpg,fore,Unspecified,0.0,0,3074,1344,3132,1443,58,99
2672,levle2_64.jpg,fore,Unspecified,0.0,0,2999,1410,3115,1518,116,108
2673,levle2_64.jpg,fore,Unspecified,0.0,0,2592,1510,2733,1610,141,100
2674,levle2_64.jpg,fore,Unspecified,0.0,0,2882,1518,3032,1635,150,117
2675,levle2_64.jpg,fore,Unspecified,0.0,0,2899,1618,3024,1726,125,108
2676,levle2_64.jpg,fore,Unspecified,0.0,0,2824,1759,2907,1851,83,92
2677,levle2_64.jpg,fore,Unspecified,0.0,0,2966,1743,3032,1834,66,91
2678,levle2_64.jpg,fore,Unspecified,0.0,0,2941,1851,3090,1942,149,91
2679,levle2_64.jpg,fore,Unspecified,0.0,0,3123,1709,3281,1842,158,133
2680,levle2_64.jpg,fore,Unspecified,0.0,0,3049,1543,3207,1693,158,150
2681,levle2_64.jpg,fore,Unspecified,0.0,0,3099,1427,3331,1560,232,133
2682,levle2_64.jpg,fore,Unspecified,0.0,0,3232,1942,3323,2058,91,116
2683,levle2_64.jpg,fore,Unspecified,0.0,0,2999,2083,3082,2158,83,75
2684,levle2_64.jpg,fore,Unspecified,0.0,0,2882,2100,2966,2216,84,116
2685,levle2_64.jpg,fore,Unspecified,0.0,0,2242,2632,2384,2748,142,116
2686,levle2_64.jpg,fore,Unspecified,0.0,0,2351,2823,2467,2956,116,133
2687,levle2_64.jpg,fore,Unspecified,0.0,0,2475,2823,2608,2956,133,133
2688,levle2_64.jpg,fore,Unspecified,0.0,0,2592,2790,2758,2948,166,158
2689,levle0_228.jpg,fore,Unspecified,0.0,0,631,2129,754,2313,123,184
2690,levle2_113.jpg,fore,Unspecified,0.0,0,325,2167,424,2320,99,153
2691,levle2_113.jpg,fore,Unspecified,0.0,0,118,2144,256,2274,138,130
2692,levle2_113.jpg,fore,Unspecified,0.0,0,202,2504,355,2665,153,161
2693,levle2_113.jpg,fore,Unspecified,0.0,0,33,2566,148,2681,115,115
2694,levle2_113.jpg,fore,Unspecified,0.0,0,10,2665,72,2803,62,138
2695,levle2_113.jpg,fore,Unspecified,0.0,0,133,2780,248,2911,115,131
2696,levle2_113.jpg,fore,Unspecified,0.0,0,409,2796,532,2911,123,115
2697,levle2_113.jpg,fore,Unspecified,0.0,0,263,3010,401,3140,138,130
2698,levle2_113.jpg,fore,Unspecified,0.0,0,769,3202,899,3317,130,115
2699,levle2_113.jpg,fore,Unspecified,0.0,0,807,2811,945,2956,138,145
2700,levle2_113.jpg,fore,Unspecified,0.0,0,815,3048,953,3163,138,115
2701,levle2_113.jpg,fore,Unspecified,0.0,0,470,3079,631,3255,161,176
2702,levle2_113.jpg,fore,Unspecified,0.0,0,761,2658,930,2765,169,107
2703,levle2_113.jpg,fore,Unspecified,0.0,0,501,2481,647,2688,146,207
2704,levle2_113.jpg,fore,Unspecified,0.0,0,715,2412,861,2612,146,200
2705,levle2_113.jpg,fore,Unspecified,0.0,0,547,1585,670,1684,123,99
2706,levle2_113.jpg,fore,Unspecified,0.0,0,715,1271,922,1462,207,191
2707,levle2_113.jpg,fore,Unspecified,0.0,0,677,972,830,1148,153,176
2708,levle2_113.jpg,fore,Unspecified,0.0,0,784,865,1007,1071,223,206
2709,levle2_113.jpg,fore,Unspecified,0.0,0,1221,397,1474,635,253,238
2710,levle2_113.jpg,fore,Unspecified,0.0,0,1597,121,1850,336,253,215
2711,levle2_113.jpg,fore,Unspecified,0.0,0,1896,290,1980,420,84,130
2712,levle1_2.jpg,fore,Unspecified,0.0,0,271,146,293,163,22,17
2713,levle1_2.jpg,fore,Unspecified,0.0,0,359,113,381,133,22,20
2714,levle1_2.jpg,fore,Unspecified,0.0,0,353,95,379,113,26,18
2715,levle1_2.jpg,fore,Unspecified,0.0,0,232,198,249,221,17,23
2716,levle1_2.jpg,fore,Unspecified,0.0,0,255,274,280,293,25,19
2717,levle1_2.jpg,fore,Unspecified,0.0,0,242,297,260,319,18,22
2718,levle1_2.jpg,fore,Unspecified,0.0,0,258,337,277,359,19,22
2719,levle1_2.jpg,fore,Unspecified,0.0,0,281,352,306,375,25,23
2720,levle1_2.jpg,fore,Unspecified,0.0,0,320,386,343,411,23,25
2721,levle1_2.jpg,fore,Unspecified,0.0,0,288,414,307,435,19,21
2722,levle1_2.jpg,fore,Unspecified,0.0,0,388,415,414,437,26,22
2723,levle1_2.jpg,fore,Unspecified,0.0,0,228,355,249,375,21,20
2724,levle1_2.jpg,fore,Unspecified,0.0,0,216,291,242,310,26,19
2725,levle2_107.jpg,fore,Unspecified,0.0,0,892,972,961,1094,69,122
2726,levle2_107.jpg,fore,Unspecified,0.0,0,884,742,1091,834,207,92
2727,levle2_107.jpg,fore,Unspecified,0.0,0,1175,1807,1283,1960,108,153
2728,levle2_107.jpg,fore,Unspecified,0.0,0,1283,1868,1413,2029,130,161
2729,levle2_107.jpg,fore,Unspecified,0.0,0,1099,1999,1221,2152,122,153
2730,levle2_107.jpg,fore,Unspecified,0.0,0,892,2106,976,2160,84,54
2731,levle2_107.jpg,fore,Unspecified,0.0,0,899,2229,999,2343,100,114
2732,levle2_107.jpg,fore,Unspecified,0.0,0,1796,2137,1942,2229,146,92
2733,levle2_107.jpg,fore,Unspecified,0.0,0,1850,2244,1949,2351,99,107
2734,levle2_107.jpg,fore,Unspecified,0.0,0,2026,1914,2125,2022,99,108
2735,levle2_107.jpg,fore,Unspecified,0.0,0,2570,2060,2670,2129,100,69
2736,levle2_107.jpg,fore,Unspecified,0.0,0,2578,2129,2677,2244,99,115
2737,levle2_107.jpg,fore,Unspecified,0.0,0,2447,2075,2524,2137,77,62
2738,levle2_107.jpg,fore,Unspecified,0.0,0,2440,2190,2509,2251,69,61
2739,levle2_107.jpg,fore,Unspecified,0.0,0,2532,2251,2654,2343,122,92
2740,levle2_107.jpg,fore,Unspecified,0.0,0,2470,2313,2547,2412,77,99
2741,levle2_107.jpg,fore,Unspecified,0.0,0,2555,2420,2624,2512,69,92
2742,levle2_107.jpg,fore,Unspecified,0.0,0,2432,2443,2509,2527,77,84
2743,levle2_107.jpg,fore,Unspecified,0.0,0,2348,2229,2432,2343,84,114
2744,levle2_107.jpg,fore,Unspecified,0.0,0,2240,2121,2325,2236,85,115
2745,levle2_107.jpg,fore,Unspecified,0.0,0,2294,2336,2386,2428,92,92
2746,levle2_107.jpg,fore,Unspecified,0.0,0,2233,2274,2302,2359,69,85
2747,levle2_107.jpg,fore,Unspecified,0.0,0,2110,2213,2248,2305,138,92
2748,levle2_107.jpg,fore,Unspecified,0.0,0,2141,2305,2225,2389,84,84
2749,levle2_107.jpg,fore,Unspecified,0.0,0,2072,2320,2118,2412,46,92
2750,levle2_107.jpg,fore,Unspecified,0.0,0,1957,2282,2064,2397,107,115
2751,levle2_107.jpg,fore,Unspecified,0.0,0,1965,2443,2064,2535,99,92
2752,levle2_107.jpg,fore,Unspecified,0.0,0,2072,2466,2164,2558,92,92
2753,levle2_107.jpg,fore,Unspecified,0.0,0,2202,2397,2286,2489,84,92
2754,levle2_107.jpg,fore,Unspecified,0.0,0,2340,2451,2432,2535,92,84
2755,levle2_107.jpg,fore,Unspecified,0.0,0,2355,2550,2486,2642,131,92
2756,levle2_107.jpg,fore,Unspecified,0.0,0,2240,2558,2348,2642,108,84
2757,levle2_107.jpg,fore,Unspecified,0.0,0,2102,2696,2187,2826,85,130
2758,levle2_107.jpg,fore,Unspecified,0.0,0,1903,2650,2026,2773,123,123
2759,levle2_107.jpg,fore,Unspecified,0.0,0,1934,2581,2072,2665,138,84
2760,levle2_107.jpg,fore,Unspecified,0.0,0,1765,2520,1903,2604,138,84
2761,levle2_107.jpg,fore,Unspecified,0.0,0,1750,2374,1911,2497,161,123
2762,levle2_107.jpg,fore,Unspecified,0.0,0,1827,2911,1919,3025,92,114
2763,levle2_107.jpg,fore,Unspecified,0.0,0,1627,3018,1696,3133,69,115
2764,levle2_107.jpg,fore,Unspecified,0.0,0,1735,3117,1842,3240,107,123
2765,levle2_107.jpg,fore,Unspecified,0.0,0,2363,2788,2524,2849,161,61
2766,levle1_21.jpg,fore,Unspecified,0.0,0,274,638,326,690,52,52
2767,levle1_21.jpg,fore,Unspecified,0.0,0,315,597,360,638,45,41
2768,levle1_21.jpg,fore,Unspecified,0.0,0,235,547,283,586,48,39
2769,levle1_21.jpg,fore,Unspecified,0.0,0,235,484,278,527,43,43
2770,levle1_21.jpg,fore,Unspecified,0.0,0,197,663,240,713,43,50
2771,levle1_21.jpg,fore,Unspecified,0.0,0,158,604,199,656,41,52
2772,levle1_21.jpg,fore,Unspecified,0.0,0,153,667,199,711,46,44
2773,levle1_21.jpg,fore,Unspecified,0.0,0,367,724,419,761,52,37
2774,levle1_21.jpg,fore,Unspecified,0.0,0,133,915,167,972,34,57
2775,levle1_577.jpg,fore,Unspecified,0.0,0,1781,2681,1903,2819,122,138
2776,levle1_577.jpg,fore,Unspecified,0.0,0,1612,2543,1750,2704,138,161
2777,levle1_577.jpg,fore,Unspecified,0.0,0,2187,2343,2317,2497,130,154
2778,levle1_577.jpg,fore,Unspecified,0.0,0,2325,2688,2447,2865,122,177
2779,levle1_577.jpg,fore,Unspecified,0.0,0,2194,2742,2279,2872,85,130
2780,levle1_577.jpg,fore,Unspecified,0.0,0,1375,1424,1512,1608,137,184
2781,levle1_577.jpg,fore,Unspecified,0.0,0,1344,1286,1459,1409,115,123
2782,levle1_577.jpg,fore,Unspecified,0.0,0,1482,1217,1574,1355,92,138
2783,levle1_577.jpg,fore,Unspecified,0.0,0,1719,1002,1827,1163,108,161
2784,levle1_577.jpg,fore,Unspecified,0.0,0,1466,757,1604,918,138,161
2785,levle1_577.jpg,fore,Unspecified,0.0,0,2792,1715,2907,1838,115,123
2786,levle1_211.jpg,fore,Unspecified,0.0,0,1260,2343,1382,2466,122,123
2787,levle1_211.jpg,fore,Unspecified,0.0,0,1237,2466,1390,2573,153,107
2788,levle1_211.jpg,fore,Unspecified,0.0,0,1306,2589,1436,2727,130,138
2789,levle1_211.jpg,fore,Unspecified,0.0,0,815,2650,876,2757,61,107
2790,levle1_211.jpg,fore,Unspecified,0.0,0,792,2949,884,3071,92,122
2791,levle1_211.jpg,fore,Unspecified,0.0,0,1045,3232,1229,3393,184,161
2792,levle1_205.jpg,fore,Unspecified,0.0,0,769,1669,876,1807,107,138
2793,levle1_205.jpg,fore,Unspecified,0.0,0,547,2527,700,2727,153,200
2794,levle1_205.jpg,fore,Unspecified,0.0,0,394,2788,493,2934,99,146
2795,levle1_205.jpg,fore,Unspecified,0.0,0,1175,2788,1306,2895,131,107
2796,levle1_205.jpg,fore,Unspecified,0.0,0,1298,3225,1375,3332,77,107
2797,levle1_205.jpg,fore,Unspecified,0.0,0,1443,3079,1566,3278,123,199
2798,levle1_205.jpg,fore,Unspecified,0.0,0,1466,3294,1551,3409,85,115
2799,levle1_35.jpg,fore,Unspecified,0.0,0,1229,2382,1443,2512,214,130
2800,levle1_35.jpg,fore,Unspecified,0.0,0,1520,2374,1650,2543,130,169
2801,levle1_35.jpg,fore,Unspecified,0.0,0,1581,2596,1758,2704,177,108
2802,levle1_35.jpg,fore,Unspecified,0.0,0,1650,2190,1804,2313,154,123
2803,levle1_35.jpg,fore,Unspecified,0.0,0,1827,2259,1911,2389,84,130
2804,levle1_35.jpg,fore,Unspecified,0.0,0,1919,2282,2064,2458,145,176
2805,levle1_35.jpg,fore,Unspecified,0.0,0,2011,1999,2148,2167,137,168
2806,levle1_35.jpg,fore,Unspecified,0.0,0,2156,2045,2286,2274,130,229
2807,levle1_35.jpg,fore,Unspecified,0.0,0,884,857,1099,1041,215,184
2808,levle1_35.jpg,fore,Unspecified,0.0,0,2202,1470,2317,1646,115,176
2809,levle1_563.jpg,fore,Unspecified,0.0,0,2225,1907,2455,2060,230,153
2810,levle1_563.jpg,fore,Unspecified,0.0,0,2141,2075,2325,2221,184,146
2811,levle1_563.jpg,fore,Unspecified,0.0,0,2164,2543,2294,2727,130,184
2812,levle1_563.jpg,fore,Unspecified,0.0,0,2470,2343,2654,2497,184,154
2813,levle1_563.jpg,fore,Unspecified,0.0,0,1727,2022,1842,2144,115,122
2814,levle1_563.jpg,fore,Unspecified,0.0,0,1612,2167,1765,2290,153,123
2815,levle1_563.jpg,fore,Unspecified,0.0,0,1643,2366,1712,2428,69,62
2816,levle1_563.jpg,fore,Unspecified,0.0,0,1520,2320,1666,2458,146,138
2817,levle1_563.jpg,fore,Unspecified,0.0,0,1283,2114,1405,2175,122,61
2818,levle1_563.jpg,fore,Unspecified,0.0,0,1880,2206,1995,2359,115,153
2819,levle1_563.jpg,fore,Unspecified,0.0,0,1704,2512,1873,2642,169,130
2820,levle1_239.jpg,fore,Unspecified,0.0,0,892,941,984,1041,92,100
2821,levle1_239.jpg,fore,Unspecified,0.0,0,1252,397,1397,474,145,77
2822,levle1_239.jpg,fore,Unspecified,0.0,0,1850,711,1965,811,115,100
2823,levle1_239.jpg,fore,Unspecified,0.0,0,1045,1968,1175,2060,130,92
2824,levle1_239.jpg,fore,Unspecified,0.0,0,1099,2083,1206,2190,107,107
2825,levle1_239.jpg,fore,Unspecified,0.0,0,1037,2267,1175,2428,138,161
2826,levle1_239.jpg,fore,Unspecified,0.0,0,846,1592,938,1730,92,138
2827,levle1_239.jpg,fore,Unspecified,0.0,0,1275,2412,1443,2504,168,92
2828,levle3_102.jpg,fore,,,0,219,508,254,552,35,44
2829,levle3_102.jpg,fore,,,0,256,625,277,650,21,25
2830,levle3_102.jpg,fore,,,0,286,665,300,678,14,13
2831,levle3_102.jpg,fore,,,0,300,646,332,676,32,30
2832,levle3_102.jpg,fore,,,0,242,568,267,604,25,36
2833,levle3_102.jpg,fore,,,0,267,554,288,584,21,30
2834,levle3_102.jpg,fore,,,0,319,584,351,620,32,36
2835,levle3_102.jpg,fore,,,0,302,544,335,579,33,35
2836,levle3_102.jpg,fore,,,0,415,584,470,621,55,37
2837,levle3_102.jpg,fore,,,0,381,637,436,685,55,48
2838,levle3_102.jpg,fore,,,0,314,671,379,708,65,37
2839,levle3_102.jpg,fore,,,0,344,710,372,738,28,28
2840,levle3_102.jpg,fore,,,0,371,717,388,741,17,24
2841,levle3_102.jpg,fore,,,0,388,718,424,766,36,48
2842,levle3_102.jpg,fore,,,0,432,697,484,738,52,41
2843,levle3_102.jpg,fore,,,0,327,517,353,538,26,21
2844,levle3_102.jpg,fore,,,0,351,522,387,563,36,41
2845,levle3_102.jpg,fore,,,0,268,482,332,521,64,39
2846,levle3_102.jpg,fore,,,0,215,455,245,484,30,29
2847,levle3_102.jpg,fore,,,0,226,484,254,508,28,24
2848,levle3_102.jpg,fore,,,0,187,475,226,512,39,37
2849,levle3_102.jpg,fore,,,0,150,455,201,494,51,39
2850,levle3_102.jpg,fore,,,0,127,432,177,464,50,32
2851,levle3_102.jpg,fore,,,0,118,410,145,432,27,22
2852,levle3_102.jpg,fore,,,0,99,330,136,371,37,41
2853,levle3_102.jpg,fore,,,0,127,260,166,318,39,58
2854,levle3_102.jpg,fore,,,0,182,298,221,348,39,50
2855,levle3_102.jpg,fore,,,0,219,318,247,344,28,26
2856,levle3_102.jpg,fore,,,0,222,270,259,311,37,41
2857,levle3_102.jpg,fore,,,0,244,247,282,284,38,37
2858,levle3_102.jpg,fore,,,0,254,284,291,307,37,23
2859,levle3_102.jpg,fore,,,0,259,311,302,346,43,35
2860,levle3_102.jpg,fore,,,0,139,362,210,406,71,44
2861,levle3_102.jpg,fore,,,0,171,401,217,431,46,30
2862,levle3_102.jpg,fore,,,0,222,397,252,438,30,41
2863,levle3_102.jpg,fore,,,0,219,367,252,404,33,37
2864,levle3_102.jpg,fore,,,0,319,432,365,480,46,48
2865,levle3_102.jpg,fore,,,0,298,335,342,380,44,45
2866,levle3_102.jpg,fore,,,0,244,346,289,394,45,48
2867,levle3_102.jpg,fore,,,0,249,436,291,470,42,34
2868,levle3_102.jpg,fore,,,0,394,295,438,321,44,26
2869,levle3_102.jpg,fore,,,0,198,35,245,71,47,36
2870,levle3_102.jpg,fore,,,0,182,221,231,272,49,51
2871,levle3_102.jpg,fore,,,0,351,201,418,247,67,46
2872,levle3_102.jpg,fore,,,0,392,154,429,189,37,35
2873,levle3_102.jpg,fore,,,0,330,300,397,346,67,46
2874,levle3_102.jpg,fore,,,0,379,325,422,357,43,32
2875,levle3_102.jpg,fore,,,0,328,376,367,424,39,48
2876,levle3_102.jpg,fore,,,0,284,387,323,415,39,28
2877,levle3_102.jpg,fore,,,0,462,415,490,443,28,28
2878,levle3_102.jpg,fore,,,0,463,386,496,412,33,26
2879,levle3_102.jpg,fore,,,0,490,415,510,445,20,30
2880,levle3_102.jpg,fore,,,0,216,107,254,142,38,35
2881,levle3_102.jpg,fore,,,0,457,753,489,781,32,28
2882,levle3_102.jpg,fore,,,0,244,394,282,433,38,39
2883,levle3_102.jpg,fore,,,0,213,188,245,211,32,23
2884,levle3_102.jpg,fore,,,0,337,147,363,175,26,28
2885,levle3_102.jpg,fore,,,0,166,119,196,138,30,19
2886,levle3_102.jpg,fore,,,0,262,184,288,205,26,21
2887,levle3_102.jpg,fore,,,0,288,224,314,246,26,22
2888,levle3_102.jpg,fore,,,0,274,46,309,71,35,25
2889,levle3_102.jpg,fore,,,0,437,258,475,304,38,46
2890,levle3_102.jpg,fore,,,0,440,313,477,340,37,27
2891,levle3_102.jpg,fore,,,0,314,117,344,146,30,29
2892,levle3_102.jpg,fore,,,0,256,82,294,115,38,33
2893,levle3_116.jpg,fore,,,0,2148,435,2286,627,138,192
2894,levle3_116.jpg,fore,,,0,1367,612,1528,826,161,214
2895,levle3_116.jpg,fore,,,0,1290,1102,1459,1301,169,199
2896,levle3_116.jpg,fore,,,0,1152,1301,1229,1439,77,138
2897,levle3_116.jpg,fore,,,0,1252,1332,1405,1493,153,161
2898,levle3_116.jpg,fore,,,0,1482,1340,1574,1447,92,107
2899,levle3_116.jpg,fore,,,0,1129,1447,1183,1585,54,138
2900,levle3_116.jpg,fore,,,0,1106,1592,1237,1707,131,115
2901,levle3_116.jpg,fore,,,0,1260,1562,1382,1646,122,84
2902,levle3_116.jpg,fore,,,0,1275,1669,1359,1769,84,100
2903,levle3_116.jpg,fore,,,0,1466,1501,1589,1600,123,99
2904,levle3_116.jpg,fore,,,0,1574,1531,1696,1638,122,107
2905,levle3_116.jpg,fore,,,0,1466,1623,1597,1792,131,169
2906,levle3_116.jpg,fore,,,0,1428,1792,1574,1930,146,138
2907,levle3_116.jpg,fore,,,0,1635,1684,1735,1807,100,123
2908,levle3_116.jpg,fore,,,0,1643,1838,1765,1930,122,92
2909,levle3_116.jpg,fore,,,0,1650,1937,1804,2114,154,177
2910,levle3_116.jpg,fore,,,0,1466,1968,1612,2114,146,146
2911,levle3_116.jpg,fore,,,0,1352,2351,1459,2535,107,184
2912,levle3_116.jpg,fore,,,0,1604,2221,1704,2320,100,99
2913,levle3_116.jpg,fore,,,0,1543,2305,1627,2443,84,138
2914,levle3_116.jpg,fore,,,0,1919,1838,1965,1960,46,122
2915,levle3_116.jpg,fore,,,0,1827,2006,2003,2167,176,161
2916,levle3_116.jpg,fore,,,0,1988,1592,2133,1822,145,230
2917,levle3_116.jpg,fore,,,0,1284,757,1388,850,104,93
2918,levle3_116.jpg,fore,,,0,1415,843,1529,943,114,100
2919,levle3_116.jpg,fore,,,0,1805,522,1929,625,124,103
2920,levle3_116.jpg,fore,,,0,1229,901,1350,1001,121,100
2921,levle3_116.jpg,fore,,,0,1171,1722,1264,1801,93,79
2922,levle3_116.jpg,fore,,,0,1867,1591,1967,1677,100,86
2923,levle3_116.jpg,fore,,,0,1774,1560,1881,1681,107,121
2924,levle3_116.jpg,fore,,,0,2015,2353,2119,2453,104,100
2925,levle3_116.jpg,fore,,,0,2022,2467,2129,2570,107,103
2926,levle3_116.jpg,fore,,,0,1777,2191,1871,2277,94,86
2927,levle3_116.jpg,fore,,,0,1436,2374,1564,2515,128,141
2928,levle3_116.jpg,fore,,,0,1529,2491,1640,2608,111,117
2929,levle3_116.jpg,fore,,,0,1498,2581,1636,2694,138,113
2930,levle3_116.jpg,fore,,,0,1788,2539,1912,2646,124,107
2931,levle3_116.jpg,fore,,,0,1457,2301,1560,2384,103,83
2932,levle3_116.jpg,fore,,,0,1405,2253,1512,2325,107,72
2933,levle3_116.jpg,fore,,,0,1657,2091,1771,2198,114,107
2934,levle3_116.jpg,fore,,,0,1940,2174,2046,2270,106,96
2935,levle3_116.jpg,fore,,,0,2129,2129,2243,2229,114,100
2936,levle3_116.jpg,fore,,,0,2015,2091,2136,2194,121,103
2937,levle3_116.jpg,fore,,,0,2174,2012,2291,2125,117,113
2938,levle3_116.jpg,fore,,,0,2077,1991,2188,2105,111,114
2939,levle3_116.jpg,fore,,,0,1826,1894,1926,1988,100,94
2940,levle3_116.jpg,fore,,,0,1919,1936,2043,2012,124,76
2941,levle3_116.jpg,fore,,,0,1598,298,1695,398,97,100
2942,levle3_116.jpg,fore,,,0,1660,232,1753,322,93,90
2943,levle3_116.jpg,fore,,,0,1350,1681,1477,1784,127,103
2944,levle3_116.jpg,fore,,,0,1757,1774,1888,1874,131,100
2945,levle3_116.jpg,fore,,,0,2095,1788,2226,1888,131,100
2946,levle3_116.jpg,fore,,,0,2160,1891,2257,1995,97,104
2947,levle3_116.jpg,fore,,,0,1450,2084,1560,2198,110,114
2948,levle3_116.jpg,fore,,,0,1971,1832,2088,1936,117,104
2949,levle3_116.jpg,fore,,,0,1405,1074,1508,1191,103,117
2950,levle3_116.jpg,fore,,,0,1577,1467,1698,1567,121,100
2951,levle3_116.jpg,fore,,,0,1343,1529,1450,1639,107,110
2952,levle3_116.jpg,fore,,,0,1546,1781,1657,1912,111,131
2953,levle3_116.jpg,fore,,,0,1640,2298,1736,2401,96,103
2954,levle3_116.jpg,fore,,,0,1891,2370,2022,2501,131,131
2955,levle3_116.jpg,fore,,,0,1736,2325,1877,2477,141,152
2956,levle3_0.jpg,fore,Unspecified,0.0,0,134,60,142,69,8,9
2957,levle3_0.jpg,fore,Unspecified,0.0,0,125,53,136,62,11,9
2958,levle3_0.jpg,fore,Unspecified,0.0,0,120,63,126,72,6,9
2959,levle3_0.jpg,fore,Unspecified,0.0,0,122,68,131,81,9,13
2960,levle3_0.jpg,fore,Unspecified,0.0,0,104,67,120,77,16,10
2961,levle3_0.jpg,fore,Unspecified,0.0,0,104,71,109,81,5,10
2962,levle3_0.jpg,fore,Unspecified,0.0,0,144,122,158,135,14,13
2963,levle3_0.jpg,fore,Unspecified,0.0,0,86,113,96,124,10,11
2964,levle3_0.jpg,fore,Unspecified,0.0,0,103,122,111,131,8,9
2965,levle3_0.jpg,fore,Unspecified,0.0,0,114,119,119,127,5,8
2966,levle3_0.jpg,fore,Unspecified,0.0,0,120,126,128,132,8,6
2967,levle3_0.jpg,fore,Unspecified,0.0,0,128,115,135,126,7,11
2968,levle3_0.jpg,fore,Unspecified,0.0,0,94,108,111,121,17,13
2969,levle3_0.jpg,fore,Unspecified,0.0,0,88,142,94,149,6,7
2970,levle3_0.jpg,fore,Unspecified,0.0,0,60,144,70,151,10,7
2971,levle3_0.jpg,fore,Unspecified,0.0,0,59,150,67,158,8,8
2972,levle3_0.jpg,fore,Unspecified,0.0,0,66,157,76,167,10,10
2973,levle3_0.jpg,fore,Unspecified,0.0,0,68,167,78,178,10,11
2974,levle3_0.jpg,fore,Unspecified,0.0,0,77,153,83,161,6,8
2975,levle3_0.jpg,fore,Unspecified,0.0,0,83,152,91,160,8,8
2976,levle3_0.jpg,fore,Unspecified,0.0,0,69,144,77,153,8,9
2977,levle3_0.jpg,fore,Unspecified,0.0,0,78,146,86,153,8,7
2978,levle3_0.jpg,fore,Unspecified,0.0,0,98,136,110,150,12,14
2979,levle3_0.jpg,fore,Unspecified,0.0,0,114,146,122,156,8,10
2980,levle3_0.jpg,fore,Unspecified,0.0,0,100,156,112,168,12,12
2981,levle3_0.jpg,fore,Unspecified,0.0,0,143,145,152,158,9,13
2982,levle3_0.jpg,fore,Unspecified,0.0,0,138,164,149,175,11,11
2983,levle3_0.jpg,fore,Unspecified,0.0,0,137,172,146,184,9,12
2984,levle3_0.jpg,fore,Unspecified,0.0,0,129,170,139,180,10,10
2985,levle3_0.jpg,fore,Unspecified,0.0,0,83,175,87,183,4,8
2986,levle3_0.jpg,fore,Unspecified,0.0,0,81,164,90,172,9,8
2987,levle3_0.jpg,fore,Unspecified,0.0,0,64,178,75,191,11,13
2988,levle3_0.jpg,fore,Unspecified,0.0,0,68,191,81,205,13,14
2989,levle3_0.jpg,fore,Unspecified,0.0,0,55,184,63,192,8,8
2990,levle3_0.jpg,fore,Unspecified,0.0,0,46,178,53,186,7,8
2991,levle3_0.jpg,fore,Unspecified,0.0,0,130,194,142,203,12,9
2992,levle3_0.jpg,fore,Unspecified,0.0,0,132,184,140,193,8,9
2993,levle3_0.jpg,fore,Unspecified,0.0,0,84,198,92,206,8,8
2994,levle3_0.jpg,fore,Unspecified,0.0,0,104,220,114,232,10,12
2995,levle3_0.jpg,fore,Unspecified,0.0,0,115,218,128,234,13,16
2996,levle3_0.jpg,fore,Unspecified,0.0,0,131,223,143,235,12,12
2997,levle3_0.jpg,fore,Unspecified,0.0,0,162,215,170,225,8,10
2998,levle3_0.jpg,fore,Unspecified,0.0,0,154,198,162,212,8,14
2999,levle3_0.jpg,fore,Unspecified,0.0,0,131,240,143,250,12,10
3000,levle3_0.jpg,fore,Unspecified,0.0,0,140,247,151,259,11,12
3001,levle3_0.jpg,fore,Unspecified,0.0,0,151,242,160,252,9,10
3002,levle3_0.jpg,fore,Unspecified,0.0,0,151,232,163,246,12,14
3003,levle3_0.jpg,fore,Unspecified,0.0,0,92,231,100,240,8,9
3004,levle3_0.jpg,fore,Unspecified,0.0,0,89,216,101,227,12,11
3005,levle3_0.jpg,fore,Unspecified,0.0,0,73,208,80,218,7,10
3006,levle3_0.jpg,fore,Unspecified,0.0,0,106,88,116,98,10,10
3007,levle3_0.jpg,fore,Unspecified,0.0,0,111,75,118,87,7,12
3008,levle3_0.jpg,fore,Unspecified,0.0,0,114,100,129,114,15,14
3009,levle3_0.jpg,fore,Unspecified,0.0,0,72,122,86,132,14,10
3010,levle3_0.jpg,fore,Unspecified,0.0,0,72,133,87,143,15,10
3011,levle3_0.jpg,fore,Unspecified,0.0,0,58,161,66,169,8,8
3012,levle3_0.jpg,fore,Unspecified,0.0,0,90,178,101,194,11,16
3013,levle3_0.jpg,fore,Unspecified,0.0,0,97,169,116,185,19,16
3014,levle3_0.jpg,fore,Unspecified,0.0,0,117,155,132,169,15,14
3015,levle3_0.jpg,fore,Unspecified,0.0,0,127,159,140,167,13,8
3016,levle3_0.jpg,fore,Unspecified,0.0,0,94,195,105,209,11,14
3017,levle3_0.jpg,fore,Unspecified,0.0,0,101,202,112,210,11,8
3018,levle3_0.jpg,fore,Unspecified,0.0,0,109,195,128,208,19,13
3019,levle3_0.jpg,fore,Unspecified,0.0,0,108,211,115,219,7,8
3020,levle1_588.jpg,fore,Unspecified,0.0,0,899,857,1030,956,131,99
3021,levle1_588.jpg,fore,Unspecified,0.0,0,1099,880,1252,1018,153,138
3022,levle1_588.jpg,fore,Unspecified,0.0,0,1283,857,1359,956,76,99
3023,levle1_588.jpg,fore,Unspecified,0.0,0,761,1271,892,1370,131,99
3024,levle1_588.jpg,fore,Unspecified,0.0,0,463,2137,585,2229,122,92
3025,levle1_588.jpg,fore,Unspecified,0.0,0,440,2313,608,2397,168,84
3026,levle1_588.jpg,fore,Unspecified,0.0,0,1237,3156,1375,3301,138,145
3027,levle1_588.jpg,fore,Unspecified,0.0,0,1306,2979,1451,3148,145,169
3028,levle1_588.jpg,fore,Unspecified,0.0,0,1420,3209,1482,3332,62,123
3029,levle1_588.jpg,fore,Unspecified,0.0,0,1597,3263,1719,3386,122,123
3030,levle1_588.jpg,fore,Unspecified,0.0,0,1850,3087,2034,3240,184,153
3031,levle1_588.jpg,fore,Unspecified,0.0,0,1742,842,1857,1018,115,176
3032,levle1_589.jpg,fore,Unspecified,0.0,0,478,2022,654,2190,176,168
3033,levle1_589.jpg,fore,Unspecified,0.0,0,516,1861,578,1945,62,84
3034,levle1_589.jpg,fore,Unspecified,0.0,0,639,1087,777,1263,138,176
3035,levle1_589.jpg,fore,Unspecified,0.0,0,800,1071,930,1171,130,100
3036,levle1_589.jpg,fore,Unspecified,0.0,0,938,704,1114,834,176,130
3037,levle1_589.jpg,fore,Unspecified,0.0,0,1152,635,1336,849,184,214
3038,levle1_589.jpg,fore,Unspecified,0.0,0,1336,688,1436,788,100,100
3039,levle1_589.jpg,fore,Unspecified,0.0,0,1443,2688,1535,2803,92,115
3040,levle1_589.jpg,fore,Unspecified,0.0,0,1267,2788,1390,2872,123,84
3041,levle1_589.jpg,fore,Unspecified,0.0,0,1214,2918,1329,3025,115,107
3042,levle1_589.jpg,fore,Unspecified,0.0,0,1420,2979,1543,3079,123,100
3043,levle1_589.jpg,fore,Unspecified,0.0,0,1535,3056,1681,3194,146,138
3044,levle3_117.jpg,fore,,,0,339,318,398,383,59,65
3045,levle3_117.jpg,fore,,,0,180,369,253,434,73,65
3046,levle3_117.jpg,fore,,,0,225,298,290,352,65,54
3047,levle3_117.jpg,fore,,,0,520,397,600,448,80,51
3048,levle3_117.jpg,fore,,,0,165,582,228,624,63,42
3049,levle3_117.jpg,fore,,,0,378,800,429,843,51,43
3050,levle3_117.jpg,fore,,,0,390,848,444,928,54,80
3051,levle3_117.jpg,fore,,,0,344,797,378,837,34,40
3052,levle3_117.jpg,fore,,,0,384,936,429,982,45,46
3053,levle3_117.jpg,fore,,,0,350,1010,398,1073,48,63
3054,levle3_117.jpg,fore,,,0,398,962,469,996,71,34
3055,levle3_117.jpg,fore,,,0,478,931,574,1004,96,73
3056,levle3_117.jpg,fore,,,0,426,289,523,349,97,60
3057,levle3_117.jpg,fore,,,0,424,374,492,451,68,77
3058,levle3_117.jpg,fore,,,0,265,340,330,423,65,83
3059,levle3_117.jpg,fore,,,0,390,477,441,545,51,68
3060,levle3_117.jpg,fore,,,0,463,465,523,511,60,46
3061,levle3_117.jpg,fore,,,0,466,508,537,550,71,42
3062,levle3_117.jpg,fore,,,0,441,533,489,587,48,54
3063,levle3_117.jpg,fore,,,0,469,565,523,610,54,45
3064,levle3_117.jpg,fore,,,0,531,582,591,627,60,45
3065,levle3_117.jpg,fore,,,0,367,596,390,619,23,23
3066,levle3_117.jpg,fore,,,0,273,531,339,601,66,70
3067,levle3_117.jpg,fore,,,0,157,653,222,726,65,73
3068,levle3_117.jpg,fore,,,0,251,650,296,689,45,39
3069,levle3_117.jpg,fore,,,0,307,678,353,729,46,51
3070,levle3_117.jpg,fore,,,0,330,689,395,752,65,63
3071,levle3_117.jpg,fore,,,0,256,783,324,846,68,63
3072,levle3_117.jpg,fore,,,0,177,814,251,880,74,66
3073,levle3_117.jpg,fore,,,0,262,848,333,911,71,63
3074,levle3_117.jpg,fore,,,0,549,814,611,871,62,57
3075,levle3_117.jpg,fore,,,0,444,1016,486,1078,42,62
3076,levle3_117.jpg,fore,,,0,528,1034,575,1075,47,41
3077,levle3_117.jpg,fore,,,0,132,747,168,784,36,37
3078,levle3_117.jpg,fore,,,0,470,629,511,676,41,47
3079,levle3_117.jpg,fore,,,0,520,725,562,758,42,33
3080,levle3_117.jpg,fore,,,0,603,465,646,509,43,44
3081,levle3_117.jpg,fore,,,0,670,457,720,511,50,54
3082,levle3_117.jpg,fore,,,0,608,522,661,576,53,54
3083,levle3_117.jpg,fore,,,0,325,459,389,500,64,41
3084,levle3_117.jpg,fore,,,0,379,557,429,592,50,35
3085,levle3_117.jpg,fore,,,0,214,766,258,811,44,45
3086,levle3_117.jpg,fore,,,0,384,720,439,781,55,61
3087,levle3_117.jpg,fore,,,0,527,467,584,515,57,48
3088,levle3_117.jpg,fore,,,0,507,848,561,893,54,45
3089,levle3_117.jpg,fore,,,0,452,879,496,918,44,39
3090,levle3_117.jpg,fore,,,0,376,652,412,690,36,38
3091,levle3_117.jpg,fore,,,0,314,611,368,663,54,52
3092,levle3_117.jpg,fore,,,0,446,817,492,871,46,54
3093,levle3_117.jpg,fore,,,0,185,888,227,931,42,43
3094,levle3_117.jpg,fore,,,0,254,907,304,943,50,36
3095,levle3_1.jpg,fore,Unspecified,0.0,0,401,131,415,151,14,20
3096,levle3_1.jpg,fore,Unspecified,0.0,0,383,151,411,174,28,23
3097,levle3_1.jpg,fore,Unspecified,0.0,0,408,169,427,179,19,10
3098,levle3_1.jpg,fore,Unspecified,0.0,0,426,186,442,197,16,11
3099,levle3_1.jpg,fore,Unspecified,0.0,0,321,131,362,158,41,27
3100,levle3_1.jpg,fore,Unspecified,0.0,0,372,522,390,539,18,17
3101,levle3_1.jpg,fore,Unspecified,0.0,0,291,527,325,571,34,44
3102,levle3_1.jpg,fore,Unspecified,0.0,0,168,548,195,568,27,20
3103,levle3_1.jpg,fore,Unspecified,0.0,0,227,543,250,571,23,28
3104,levle3_1.jpg,fore,Unspecified,0.0,0,266,452,307,491,41,39
3105,levle3_1.jpg,fore,Unspecified,0.0,0,152,444,186,477,34,33
3106,levle3_1.jpg,fore,Unspecified,0.0,0,184,468,207,483,23,15
3107,levle3_1.jpg,fore,Unspecified,0.0,0,158,502,186,527,28,25
3108,levle3_1.jpg,fore,Unspecified,0.0,0,229,385,261,410,32,25
3109,levle3_1.jpg,fore,Unspecified,0.0,0,230,403,266,431,36,28
3110,levle3_1.jpg,fore,Unspecified,0.0,0,117,323,149,337,32,14
3111,levle3_1.jpg,fore,Unspecified,0.0,0,291,147,317,167,26,20
3112,levle3_1.jpg,fore,Unspecified,0.0,0,340,161,364,177,24,16
3113,levle3_1.jpg,fore,Unspecified,0.0,0,323,192,355,215,32,23
3114,levle3_1.jpg,fore,Unspecified,0.0,0,330,222,351,254,21,32
3115,levle3_1.jpg,fore,Unspecified,0.0,0,362,209,387,243,25,34
3116,levle3_1.jpg,fore,Unspecified,0.0,0,236,190,259,213,23,23
3117,levle3_1.jpg,fore,Unspecified,0.0,0,264,161,303,188,39,27
3118,levle3_1.jpg,fore,Unspecified,0.0,0,298,197,316,213,18,16
3119,levle3_1.jpg,fore,Unspecified,0.0,0,246,222,291,250,45,28
3120,levle3_1.jpg,fore,Unspecified,0.0,0,285,293,321,334,36,41
3121,levle3_1.jpg,fore,Unspecified,0.0,0,289,252,337,270,48,18
3122,levle3_1.jpg,fore,Unspecified,0.0,0,225,250,254,282,29,32
3123,levle3_1.jpg,fore,Unspecified,0.0,0,248,287,273,318,25,31
3124,levle3_1.jpg,fore,Unspecified,0.0,0,257,259,293,282,36,23
3125,levle3_1.jpg,fore,Unspecified,0.0,0,163,257,186,287,23,30
3126,levle3_1.jpg,fore,Unspecified,0.0,0,179,291,215,335,36,44
3127,levle3_1.jpg,fore,Unspecified,0.0,0,195,275,239,303,44,28
3128,levle3_1.jpg,fore,Unspecified,0.0,0,195,337,225,367,30,30
3129,levle3_1.jpg,fore,Unspecified,0.0,0,172,367,215,394,43,27
3130,levle3_1.jpg,fore,Unspecified,0.0,0,129,323,181,371,52,48
3131,levle3_1.jpg,fore,Unspecified,0.0,0,94,374,135,420,41,46
3132,levle3_1.jpg,fore,Unspecified,0.0,0,55,440,97,468,42,28
3133,levle3_1.jpg,fore,Unspecified,0.0,0,275,404,314,440,39,36
3134,levle3_1.jpg,fore,Unspecified,0.0,0,234,444,268,484,34,40
3135,levle3_1.jpg,fore,Unspecified,0.0,0,188,509,213,539,25,30
3136,levle3_1.jpg,fore,Unspecified,0.0,0,81,474,126,518,45,44
3137,levle3_1.jpg,fore,Unspecified,0.0,0,113,484,154,522,41,38
3138,levle3_1.jpg,fore,Unspecified,0.0,0,55,495,101,552,46,57
3139,levle3_1.jpg,fore,Unspecified,0.0,0,5,484,46,511,41,27
3140,levle3_1.jpg,fore,Unspecified,0.0,0,14,520,42,557,28,37
3141,levle3_1.jpg,fore,Unspecified,0.0,0,23,564,53,587,30,23
3142,levle3_1.jpg,fore,Unspecified,0.0,0,39,527,66,552,27,25
3143,levle3_1.jpg,fore,Unspecified,0.0,0,92,541,128,575,36,34
3144,levle3_1.jpg,fore,Unspecified,0.0,0,126,543,165,578,39,35
3145,levle3_1.jpg,fore,Unspecified,0.0,0,83,566,117,593,34,27
3146,levle3_1.jpg,fore,Unspecified,0.0,0,147,656,181,688,34,32
3147,levle3_1.jpg,fore,Unspecified,0.0,0,176,653,199,681,23,28
3148,levle3_1.jpg,fore,Unspecified,0.0,0,190,626,232,658,42,32
3149,levle3_1.jpg,fore,Unspecified,0.0,0,232,656,273,697,41,41
3150,levle3_1.jpg,fore,Unspecified,0.0,0,206,692,257,724,51,32
3151,levle3_1.jpg,fore,Unspecified,0.0,0,172,706,227,747,55,41
3152,levle3_1.jpg,fore,Unspecified,0.0,0,273,718,323,766,50,48
3153,levle3_1.jpg,fore,Unspecified,0.0,0,275,621,316,648,41,27
3154,levle3_1.jpg,fore,Unspecified,0.0,0,305,639,353,674,48,35
3155,levle3_103.jpg,fore,,,0,231,197,272,223,41,26
3156,levle3_103.jpg,fore,,,0,281,238,317,261,36,23
3157,levle3_103.jpg,fore,,,0,394,225,428,269,34,44
3158,levle3_103.jpg,fore,,,0,192,297,221,339,29,42
3159,levle3_103.jpg,fore,,,0,252,295,282,334,30,39
3160,levle3_103.jpg,fore,,,0,286,300,327,327,41,27
3161,levle3_103.jpg,fore,,,0,216,358,253,393,37,35
3162,levle3_103.jpg,fore,,,0,142,475,168,501,26,26
3163,levle3_103.jpg,fore,,,0,224,396,255,434,31,38
3164,levle3_103.jpg,fore,,,0,301,382,342,425,41,43
3165,levle3_103.jpg,fore,,,0,342,348,366,384,24,36
3166,levle3_103.jpg,fore,,,0,483,405,509,437,26,32
3167,levle3_103.jpg,fore,,,0,503,441,526,473,23,32
3168,levle3_103.jpg,fore,,,0,514,499,543,528,29,29
3169,levle3_103.jpg,fore,,,0,479,497,503,528,24,31
3170,levle3_103.jpg,fore,,,0,452,514,481,545,29,31
3171,levle3_103.jpg,fore,,,0,368,345,395,386,27,41
3172,levle3_103.jpg,fore,,,0,108,101,147,137,39,36
3173,levle3_103.jpg,fore,,,0,80,110,130,147,50,37
3174,levle3_103.jpg,fore,,,0,99,166,140,206,41,40
3175,levle3_103.jpg,fore,,,0,137,322,190,367,53,45
3176,levle3_103.jpg,fore,,,0,322,456,365,483,43,27
3177,levle3_103.jpg,fore,,,0,262,598,318,648,56,50
3178,levle3_103.jpg,fore,,,0,65,158,113,199,48,41
3179,levle3_103.jpg,fore,,,0,142,139,195,178,53,39
3180,levle3_103.jpg,fore,,,0,209,429,246,468,37,39
3181,levle3_103.jpg,fore,,,0,185,497,224,528,39,31
3182,levle3_103.jpg,fore,,,0,169,525,210,564,41,39
3183,levle3_103.jpg,fore,,,0,164,631,224,672,60,41
3184,levle3_103.jpg,fore,,,0,180,698,222,729,42,31
3185,levle3_103.jpg,fore,,,0,281,543,308,564,27,21
3186,levle3_103.jpg,fore,,,0,279,677,315,720,36,43
3187,levle3_103.jpg,fore,,,0,332,530,353,574,21,44
3188,levle3_103.jpg,fore,,,0,361,506,394,549,33,43
3189,levle3_103.jpg,fore,,,0,246,501,284,540,38,39
3190,levle3_103.jpg,fore,,,0,181,382,216,406,35,24
3191,levle3_103.jpg,fore,,,0,476,537,509,578,33,41
3192,levle3_103.jpg,fore,,,0,251,565,281,589,30,24
3193,levle3_103.jpg,fore,,,0,281,565,312,594,31,29
3194,levle3_103.jpg,fore,,,0,121,417,161,448,40,31
3195,levle3_103.jpg,fore,,,0,150,116,187,141,37,25
3196,levle3_103.jpg,fore,,,0,325,194,350,221,25,27
3197,levle3_103.jpg,fore,,,0,95,551,135,577,40,26
3198,levle3_103.jpg,fore,,,0,404,694,428,717,24,23
3199,levle3_103.jpg,fore,,,0,351,677,396,733,45,56
3200,levle3_103.jpg,fore,,,0,398,424,426,448,28,24
3201,levle3_103.jpg,fore,,,0,333,252,381,291,48,39
3202,levle3_103.jpg,fore,,,0,235,682,262,710,27,28
3203,levle3_103.jpg,fore,,,0,256,696,285,724,29,28
3204,levle3_103.jpg,fore,,,0,399,345,438,381,39,36
3205,levle3_103.jpg,fore,,,0,141,371,165,394,24,23
3206,levle3_103.jpg,fore,,,0,163,370,187,406,24,36
3207,levle3_103.jpg,fore,,,0,166,398,189,431,23,33
3208,levle3_103.jpg,fore,,,0,259,466,288,501,29,35
3209,levle3_103.jpg,fore,,,0,284,462,311,497,27,35
3210,levle3_103.jpg,fore,,,0,284,337,317,367,33,30
3211,levle3_103.jpg,fore,,,0,275,195,312,229,37,34
3212,levle3_103.jpg,fore,,,0,440,397,471,431,31,34
3213,levle1_238.jpg,fore,Unspecified,0.0,0,2087,2045,2279,2206,192,161
3214,levle1_238.jpg,fore,Unspecified,0.0,0,1919,1914,2087,2083,168,169
3215,levle1_238.jpg,fore,Unspecified,0.0,0,2003,1746,2118,1868,115,122
3216,levle1_238.jpg,fore,Unspecified,0.0,0,1405,2037,1543,2152,138,115
3217,levle1_238.jpg,fore,Unspecified,0.0,0,2125,1370,2217,1501,92,131
3218,levle1_238.jpg,fore,Unspecified,0.0,0,1949,1087,2110,1232,161,145
3219,levle1_204.jpg,fore,,,0,1505,2619,1597,2757,92,138
3220,levle1_204.jpg,fore,,,0,1804,2780,1949,2956,145,176
3221,levle1_204.jpg,fore,,,0,2585,2895,2693,3018,108,123
3222,levle1_204.jpg,fore,,,0,1802,3201,1895,3301,93,100
3223,levle1_204.jpg,fore,,,0,1829,1260,1929,1339,100,79
3224,levle1_204.jpg,fore,,,0,2115,3308,2219,3398,104,90
3225,levle1_562.jpg,fore,Unspecified,0.0,0,1244,2267,1405,2405,161,138
3226,levle1_562.jpg,fore,Unspecified,0.0,0,1704,2236,1804,2328,100,92
3227,levle1_562.jpg,fore,Unspecified,0.0,0,1850,2474,1980,2589,130,115
3228,levle1_562.jpg,fore,Unspecified,0.0,0,2011,2152,2164,2305,153,153
3229,levle1_562.jpg,fore,Unspecified,0.0,0,1827,2014,1934,2121,107,107
3230,levle1_562.jpg,fore,Unspecified,0.0,0,2417,1891,2509,2068,92,177
3231,levle1_562.jpg,fore,Unspecified,0.0,0,2478,2060,2562,2152,84,92
3232,levle1_562.jpg,fore,Unspecified,0.0,0,1267,1148,1390,1301,123,153
3233,levle1_562.jpg,fore,Unspecified,0.0,0,1083,995,1191,1102,108,107
3234,levle1_562.jpg,fore,Unspecified,0.0,0,1903,2773,2018,2911,115,138
3235,levle1_562.jpg,fore,Unspecified,0.0,0,2072,2688,2179,2842,107,154
3236,levle1_34.jpg,fore,Unspecified,0.0,0,1152,1117,1321,1240,169,123
3237,levle1_34.jpg,fore,Unspecified,0.0,0,1306,979,1413,1110,107,131
3238,levle1_34.jpg,fore,Unspecified,0.0,0,1704,819,1896,964,192,145
3239,levle1_34.jpg,fore,Unspecified,0.0,0,1781,558,1896,704,115,146
3240,levle1_34.jpg,fore,Unspecified,0.0,0,1643,681,1781,780,138,99
3241,levle1_34.jpg,fore,Unspecified,0.0,0,1988,1569,2079,1723,91,154
3242,levle1_34.jpg,fore,Unspecified,0.0,0,2034,1416,2156,1554,122,138
3243,levle1_34.jpg,fore,Unspecified,0.0,0,777,2688,976,2803,199,115
3244,levle1_34.jpg,fore,Unspecified,0.0,0,823,2834,961,2956,138,122
3245,levle1_34.jpg,fore,Unspecified,0.0,0,823,2558,899,2650,76,92
3246,levle1_34.jpg,fore,Unspecified,0.0,0,945,2512,1076,2635,131,123
3247,levle1_34.jpg,fore,Unspecified,0.0,0,1091,2742,1168,2872,77,130
3248,levle1_34.jpg,fore,Unspecified,0.0,0,1083,3133,1229,3301,146,168
3249,levle1_34.jpg,fore,Unspecified,0.0,0,1214,2911,1321,3002,107,91
3250,levle1_34.jpg,fore,Unspecified,0.0,0,1244,2681,1459,2865,215,184
3251,levle1_34.jpg,fore,Unspecified,0.0,0,1397,2527,1520,2642,123,115
3252,levle1_34.jpg,fore,Unspecified,0.0,0,692,2451,853,2573,161,122
3253,levle1_576.jpg,fore,Unspecified,0.0,0,1352,1401,1489,1516,137,115
3254,levle1_576.jpg,fore,Unspecified,0.0,0,1528,972,1673,1140,145,168
3255,levle1_576.jpg,fore,Unspecified,0.0,0,1627,887,1742,995,115,108
3256,levle1_576.jpg,fore,Unspecified,0.0,0,1796,1033,1896,1110,100,77
3257,levle1_576.jpg,fore,Unspecified,0.0,0,1512,796,1627,903,115,107
3258,levle1_576.jpg,fore,Unspecified,0.0,0,1888,910,2011,1041,123,131
3259,levle1_576.jpg,fore,Unspecified,0.0,0,1903,2543,1995,2681,92,138
3260,levle1_576.jpg,fore,Unspecified,0.0,0,2570,2497,2784,2650,214,153
3261,levle1_576.jpg,fore,Unspecified,0.0,0,2409,2979,2524,3079,115,100
3262,levle1_20.jpg,fore,Unspecified,0.0,0,1773,1983,1857,2114,84,131
3263,levle1_20.jpg,fore,Unspecified,0.0,0,1934,1991,2041,2129,107,138
3264,levle1_20.jpg,fore,Unspecified,0.0,0,1206,2274,1283,2420,77,146
3265,levle1_20.jpg,fore,Unspecified,0.0,0,1788,2167,1919,2274,131,107
3266,levle1_20.jpg,fore,Unspecified,0.0,0,2064,1891,2187,2060,123,169
3267,levle1_20.jpg,fore,Unspecified,0.0,0,1574,2405,1689,2527,115,122
3268,levle1_20.jpg,fore,Unspecified,0.0,0,1520,2160,1719,2305,199,145
3269,levle1_20.jpg,fore,Unspecified,0.0,0,1719,2849,1873,3010,154,161
3270,levle1_210.jpg,fore,Unspecified,0.0,0,440,2435,493,2520,53,85
3271,levle1_210.jpg,fore,Unspecified,0.0,0,532,2550,639,2650,107,100
3272,levle1_210.jpg,fore,Unspecified,0.0,0,616,2489,708,2619,92,130
3273,levle1_210.jpg,fore,Unspecified,0.0,0,807,2497,953,2650,146,153
3274,levle1_210.jpg,fore,Unspecified,0.0,0,670,2627,784,2750,114,123
3275,levle1_210.jpg,fore,Unspecified,0.0,0,930,2811,1037,2872,107,61
3276,levle1_210.jpg,fore,Unspecified,0.0,0,938,2880,1060,2987,122,107
3277,levle1_210.jpg,fore,Unspecified,0.0,0,777,3025,853,3148,76,123
3278,levle1_210.jpg,fore,Unspecified,0.0,0,1007,3025,1099,3148,92,123
3279,levle1_210.jpg,fore,Unspecified,0.0,0,892,2320,1045,2497,153,177
3280,levle1_3.jpg,fore,Unspecified,0.0,0,255,397,276,420,21,23
3281,levle1_3.jpg,fore,Unspecified,0.0,0,280,420,306,449,26,29
3282,levle1_3.jpg,fore,Unspecified,0.0,0,337,390,358,422,21,32
3283,levle1_3.jpg,fore,Unspecified,0.0,0,331,356,358,383,27,27
3284,levle1_3.jpg,fore,Unspecified,0.0,0,318,488,342,517,24,29
3285,levle1_3.jpg,fore,Unspecified,0.0,0,255,513,292,557,37,44
3286,levle1_3.jpg,fore,Unspecified,0.0,0,213,349,233,380,20,31
3287,levle1_3.jpg,fore,Unspecified,0.0,0,182,323,209,353,27,30
3288,levle1_3.jpg,fore,Unspecified,0.0,0,220,329,234,347,14,18
3289,levle1_3.jpg,fore,Unspecified,0.0,0,266,153,292,184,26,31
3290,levle1_3.jpg,fore,Unspecified,0.0,0,362,83,391,121,29,38
3291,levle1_3.jpg,fore,Unspecified,0.0,0,383,121,405,139,22,18
3292,levle1_3.jpg,fore,Unspecified,0.0,0,131,346,157,384,26,38
3293,levle2_106.jpg,fore,Unspecified,0.0,0,1620,864,1727,987,107,123
3294,levle2_106.jpg,fore,Unspecified,0.0,0,1865,864,1972,979,107,115
3295,levle2_106.jpg,fore,Unspecified,0.0,0,2064,887,2164,956,100,69
3296,levle2_106.jpg,fore,Unspecified,0.0,0,2057,972,2133,1094,76,122
3297,levle2_106.jpg,fore,Unspecified,0.0,0,1957,1041,2072,1202,115,161
3298,levle2_106.jpg,fore,Unspecified,0.0,0,1750,1156,1850,1255,100,99
3299,levle2_106.jpg,fore,Unspecified,0.0,0,1742,995,1942,1087,200,92
3300,levle2_106.jpg,fore,Unspecified,0.0,0,1804,619,1911,750,107,131
3301,levle2_106.jpg,fore,Unspecified,0.0,0,1612,2083,1719,2213,107,130
3302,levle2_106.jpg,fore,Unspecified,0.0,0,1597,2305,1742,2458,145,153
3303,levle2_106.jpg,fore,Unspecified,0.0,0,1229,2458,1329,2566,100,108
3304,levle2_106.jpg,fore,Unspecified,0.0,0,1321,2504,1420,2650,99,146
3305,levle2_106.jpg,fore,Unspecified,0.0,0,1482,2612,1620,2734,138,122
3306,levle2_106.jpg,fore,Unspecified,0.0,0,1528,2481,1689,2566,161,85
3307,levle2_106.jpg,fore,Unspecified,0.0,0,1290,2780,1443,2880,153,100
3308,levle2_106.jpg,fore,Unspecified,0.0,0,953,2297,1076,2397,123,100
3309,levle2_106.jpg,fore,Unspecified,0.0,0,769,2566,907,2734,138,168
3310,levle2_112.jpg,fore,Unspecified,0.0,0,562,320,692,428,130,108
3311,levle2_112.jpg,fore,Unspecified,0.0,0,1627,949,1727,1087,100,138
3312,levle2_112.jpg,fore,Unspecified,0.0,0,1888,842,2064,995,176,153
3313,levle2_112.jpg,fore,Unspecified,0.0,0,1214,228,1344,366,130,138
3314,levle2_112.jpg,fore,Unspecified,0.0,0,1558,6,1773,137,215,131
3315,levle2_112.jpg,fore,Unspecified,0.0,0,1819,45,1988,244,169,199
3316,levle2_112.jpg,fore,Unspecified,0.0,0,524,612,631,704,107,92
3317,levle2_112.jpg,fore,Unspecified,0.0,0,830,880,976,1018,146,138
3318,levle2_112.jpg,fore,Unspecified,0.0,0,685,757,838,895,153,138
3319,levle2_112.jpg,fore,Unspecified,0.0,0,608,1294,754,1478,146,184
3320,levle2_112.jpg,fore,Unspecified,0.0,0,1037,1684,1175,1830,138,146
3321,levle2_112.jpg,fore,Unspecified,0.0,0,715,2083,953,2343,238,260
3322,levle2_112.jpg,fore,Unspecified,0.0,0,417,2068,509,2206,92,138
3323,levle2_112.jpg,fore,Unspecified,0.0,0,141,1976,279,2083,138,107
3324,levle2_112.jpg,fore,Unspecified,0.0,0,294,2106,378,2190,84,84
3325,levle2_112.jpg,fore,Unspecified,0.0,0,624,2535,792,2719,168,184
3326,levle2_112.jpg,fore,Unspecified,0.0,0,240,2512,371,2642,131,130
3327,levle2_112.jpg,fore,Unspecified,0.0,0,394,2619,509,2773,115,154
3328,levle2_112.jpg,fore,Unspecified,0.0,0,256,2704,355,2826,99,122
3329,levle2_112.jpg,fore,Unspecified,0.0,0,95,2428,233,2573,138,145
3330,levle2_112.jpg,fore,Unspecified,0.0,0,72,2596,202,2750,130,154
3331,levle2_112.jpg,fore,Unspecified,0.0,0,332,2880,478,3025,146,145
3332,levle2_112.jpg,fore,Unspecified,0.0,0,624,3156,800,3317,176,161
3333,levle2_112.jpg,fore,Unspecified,0.0,0,968,3064,1030,3240,62,176
3334,levle2_112.jpg,fore,Unspecified,0.0,0,570,2995,731,3094,161,99
3335,levle0_229.jpg,fore,Unspecified,0.0,0,700,2474,846,2627,146,153
3336,levle0_229.jpg,fore,Unspecified,0.0,0,654,2650,838,2765,184,115
3337,levle0_229.jpg,fore,Unspecified,0.0,0,654,2788,777,2895,123,107
3338,levle0_229.jpg,fore,Unspecified,0.0,0,915,2803,1053,2941,138,138
3339,levle2_65.jpg,fore,Unspecified,0.0,0,1760,1784,1885,1892,125,108
3340,levle2_65.jpg,fore,Unspecified,0.0,0,1569,1950,1727,2067,158,117
3341,levle2_65.jpg,fore,Unspecified,0.0,0,1760,1901,1927,2067,167,166
3342,levle2_65.jpg,fore,Unspecified,0.0,0,1694,2100,1877,2191,183,91
3343,levle2_65.jpg,fore,Unspecified,0.0,0,1802,2150,1927,2316,125,166
3344,levle2_65.jpg,fore,Unspecified,0.0,0,2035,1851,2151,1917,116,66
3345,levle2_65.jpg,fore,Unspecified,0.0,0,2134,1942,2242,2034,108,92
3346,levle2_65.jpg,fore,Unspecified,0.0,0,2159,2200,2326,2291,167,91
3347,levle2_65.jpg,fore,Unspecified,0.0,0,1868,2316,2068,2499,200,183
3348,levle2_65.jpg,fore,Unspecified,0.0,0,2159,2732,2351,2915,192,183
3349,levle2_65.jpg,fore,Unspecified,0.0,0,2309,2624,2475,2790,166,166
3350,levle2_65.jpg,fore,Unspecified,0.0,0,1902,862,2018,1028,116,166
3351,levle2_65.jpg,fore,Unspecified,0.0,0,2916,371,2999,521,83,150
3352,levle2_65.jpg,fore,Unspecified,0.0,0,2833,521,2999,646,166,125
3353,levle2_65.jpg,fore,Unspecified,0.0,0,2758,629,2899,762,141,133
3354,levle2_65.jpg,fore,Unspecified,0.0,0,2583,654,2733,812,150,158
3355,levle2_65.jpg,fore,Unspecified,0.0,0,2841,1227,2982,1377,141,150
3356,levle2_65.jpg,fore,Unspecified,0.0,0,2317,2108,2567,2308,250,200
3357,levle2_65.jpg,fore,Unspecified,0.0,0,1977,2075,2043,2208,66,133
3358,levle2_65.jpg,fore,Unspecified,0.0,0,2043,2083,2193,2225,150,142
3359,levle2_65.jpg,fore,Unspecified,0.0,0,1927,1934,2110,2083,183,149
3360,levle2_65.jpg,fore,Unspecified,0.0,0,1445,1784,1669,1934,224,150
3361,levle2_71.jpg,fore,Unspecified,0.0,0,1382,1110,1528,1232,146,122
3362,levle2_71.jpg,fore,Unspecified,0.0,0,1382,956,1497,1102,115,146
3363,levle2_71.jpg,fore,Unspecified,0.0,0,1290,527,1405,711,115,184
3364,levle2_71.jpg,fore,Unspecified,0.0,0,1382,435,1543,558,161,123
3365,levle2_71.jpg,fore,Unspecified,0.0,0,1581,366,1788,543,207,177
3366,levle2_71.jpg,fore,Unspecified,0.0,0,1796,412,1957,543,161,131
3367,levle2_71.jpg,fore,Unspecified,0.0,0,1788,573,1949,773,161,200
3368,levle2_71.jpg,fore,Unspecified,0.0,0,2233,412,2470,566,237,154
3369,levle2_71.jpg,fore,Unspecified,0.0,0,2547,1033,2693,1202,146,169
3370,levle2_71.jpg,fore,Unspecified,0.0,0,2723,1071,2869,1186,146,115
3371,levle2_71.jpg,fore,Unspecified,0.0,0,2830,1286,3007,1447,177,161
3372,levle2_71.jpg,fore,Unspecified,0.0,0,2746,1700,2945,1830,199,130
3373,levle2_71.jpg,fore,Unspecified,0.0,0,2846,1807,3083,2006,237,199
3374,levle2_71.jpg,fore,Unspecified,0.0,0,2754,1930,2922,2083,168,153
3375,levle2_71.jpg,fore,Unspecified,0.0,0,2654,2037,2838,2183,184,146
3376,levle2_71.jpg,fore,Unspecified,0.0,0,2830,2098,2976,2259,146,161
3377,levle2_71.jpg,fore,Unspecified,0.0,0,2639,2183,2807,2328,168,145
3378,levle2_71.jpg,fore,Unspecified,0.0,0,2263,2213,2417,2389,154,176
3379,levle2_71.jpg,fore,Unspecified,0.0,0,2509,2343,2700,2527,191,184
3380,levle2_71.jpg,fore,Unspecified,0.0,0,2670,2428,2861,2497,191,69
3381,levle2_71.jpg,fore,Unspecified,0.0,0,2685,2497,2784,2635,99,138
3382,levle2_71.jpg,fore,Unspecified,0.0,0,2800,2474,2968,2612,168,138
3383,levle2_71.jpg,fore,Unspecified,0.0,0,2869,2313,3007,2466,138,153
3384,levle2_71.jpg,fore,Unspecified,0.0,0,2976,2359,3076,2466,100,107
3385,levle2_71.jpg,fore,Unspecified,0.0,0,2317,2466,2486,2619,169,153
3386,levle2_71.jpg,fore,Unspecified,0.0,0,1957,2328,2141,2512,184,184
3387,levle2_59.jpg,fore,,,0,2475,1576,2625,1718,150,142
3388,levle2_59.jpg,fore,,,0,1711,1917,1777,2025,66,108
3389,levle2_59.jpg,fore,,,0,2342,2333,2508,2424,166,91
3390,levle2_59.jpg,fore,,,0,2375,2441,2475,2516,100,75
3391,levle2_59.jpg,fore,,,0,2417,2507,2500,2590,83,83
3392,levle2_59.jpg,fore,,,0,1860,2582,1952,2665,92,83
3393,levle2_59.jpg,fore,,,0,2184,2391,2284,2565,100,174
3394,levle2_59.jpg,fore,,,0,2159,2574,2309,2698,150,124
3395,levle2_59.jpg,fore,,,0,2866,2275,2957,2449,91,174
3396,levle2_59.jpg,fore,,,0,2957,2216,3074,2341,117,125
3397,levle2_59.jpg,fore,,,0,3281,2108,3356,2191,75,83
3398,levle2_59.jpg,fore,,,0,3356,2200,3439,2316,83,116
3399,levle2_59.jpg,fore,,,0,3340,2333,3431,2457,91,124
3400,levle2_59.jpg,fore,,,0,3115,2391,3298,2565,183,174
3401,levle2_59.jpg,fore,,,0,2941,2524,3065,2649,124,125
3402,levle2_59.jpg,fore,,,0,2484,1959,2700,2175,216,216
3403,levle2_59.jpg,fore,,,0,2068,2424,2168,2557,100,133
3404,levle2_59.jpg,fore,,,0,1943,2399,2060,2524,117,125
3405,levle2_59.jpg,fore,,,0,1993,2615,2118,2790,125,175
3406,levle2_59.jpg,fore,,,0,1878,1974,1974,2094,96,120
3407,levle2_59.jpg,fore,,,0,2074,2190,2242,2310,168,120
3408,levle0_215.jpg,fore,Unspecified,0.0,0,1198,1907,1329,2022,131,115
3409,levle0_215.jpg,fore,Unspecified,0.0,0,1160,2022,1375,2267,215,245
3410,levle1_199.jpg,fore,,,0,1344,2297,1451,2443,107,146
3411,levle1_199.jpg,fore,,,0,1336,2911,1459,3041,123,130
3412,levle1_199.jpg,fore,,,0,1536,3112,1629,3208,93,96
3413,levle1_199.jpg,fore,,,0,1370,2137,1480,2237,110,100
3414,levle1_199.jpg,fore,,,0,1091,2998,1184,3098,93,100
3415,levle1_199.jpg,fore,,,0,1443,1970,1567,2112,124,142
3416,levle1_628.jpg,fore,Unspecified,0.0,0,746,1891,907,2052,161,161
3417,levle1_628.jpg,fore,Unspecified,0.0,0,570,1822,761,1999,191,177
3418,levle1_628.jpg,fore,Unspecified,0.0,0,294,1845,470,1983,176,138
3419,levle1_628.jpg,fore,Unspecified,0.0,0,945,2091,1083,2213,138,122
3420,levle1_628.jpg,fore,Unspecified,0.0,0,670,2627,800,2719,130,92
3421,levle1_628.jpg,fore,Unspecified,0.0,0,547,2681,662,2834,115,153
3422,levle1_628.jpg,fore,Unspecified,0.0,0,907,2673,1114,2903,207,230
3423,levle0_60.jpg,fore,Unspecified,0.0,0,2475,1352,2766,1668,291,316
3424,levle0_349.jpg,fore,Unspecified,0.0,0,2133,2573,2286,2711,153,138
3425,levle0_74.jpg,fore,Unspecified,0.0,0,3414,1610,3614,1784,200,174
3426,levle0_74.jpg,fore,Unspecified,0.0,0,1320,870,1528,1053,208,183
3427,levle0_74.jpg,fore,Unspecified,0.0,0,1885,1817,2143,2108,258,291
3428,levle0_407.jpg,fore,Unspecified,0.0,0,2317,2297,2424,2481,107,184
3429,levle1_614.jpg,fore,Unspecified,0.0,0,1811,2405,1942,2535,131,130
3430,levle1_614.jpg,fore,Unspecified,0.0,0,2394,1807,2532,1960,138,153
3431,levle1_614.jpg,fore,Unspecified,0.0,0,1045,1439,1160,1547,115,108
3432,levle1_614.jpg,fore,Unspecified,0.0,0,999,1286,1091,1386,92,100
3433,levle1_614.jpg,fore,Unspecified,0.0,0,1076,1094,1244,1186,168,92
3434,levle1_614.jpg,fore,Unspecified,0.0,0,892,1002,1030,1171,138,169
3435,levle1_614.jpg,fore,Unspecified,0.0,0,1014,933,1175,1064,161,131
3436,levle1_172.jpg,fore,Unspecified,0.0,0,1512,198,1643,297,131,99
3437,levle1_172.jpg,fore,Unspecified,0.0,0,1988,228,2118,359,130,131
3438,levle1_172.jpg,fore,Unspecified,0.0,0,2363,443,2440,596,77,153
3439,levle1_172.jpg,fore,Unspecified,0.0,0,938,2144,1045,2290,107,146
3440,levle1_172.jpg,fore,Unspecified,0.0,0,516,1914,631,2022,115,108
3441,levle1_172.jpg,fore,Unspecified,0.0,0,624,2121,700,2229,76,108
3442,levle1_172.jpg,fore,Unspecified,0.0,0,1773,1914,1873,2045,100,131
3443,levle0_361.jpg,fore,Unspecified,0.0,0,2746,2190,2922,2297,176,107
3444,levle0_361.jpg,fore,Unspecified,0.0,0,1589,1838,1704,1968,115,130
3445,levle1_166.jpg,fore,Unspecified,0.0,0,2102,2259,2210,2428,108,169
3446,levle1_166.jpg,fore,Unspecified,0.0,0,1643,2313,1796,2520,153,207
3447,levle1_166.jpg,fore,Unspecified,0.0,0,1926,2596,2011,2673,85,77
3448,levle1_166.jpg,fore,Unspecified,0.0,0,2057,2558,2118,2665,61,107
3449,levle1_166.jpg,fore,Unspecified,0.0,0,1919,2826,2018,2964,99,138
3450,levle1_166.jpg,fore,Unspecified,0.0,0,1627,3156,1742,3255,115,99
3451,levle1_166.jpg,fore,Unspecified,0.0,0,1896,3171,2018,3301,122,130
3452,levle0_375.jpg,fore,Unspecified,0.0,0,1382,1033,1482,1163,100,130
3453,levle0_375.jpg,fore,Unspecified,0.0,0,1336,1186,1436,1324,100,138
3454,levle0_375.jpg,fore,Unspecified,0.0,0,1244,1102,1329,1248,85,146
3455,levle0_375.jpg,fore,Unspecified,0.0,0,2486,2229,2639,2412,153,183
3456,levle0_375.jpg,fore,Unspecified,0.0,0,2624,2091,2746,2305,122,214
3457,levle0_413.jpg,fore,Unspecified,0.0,0,991,2190,1099,2320,108,130
3458,levle0_413.jpg,fore,Unspecified,0.0,0,1750,2903,1850,3033,100,130
3459,levle1_600.jpg,fore,Unspecified,0.0,0,524,2543,585,2665,61,122
3460,levle1_600.jpg,fore,Unspecified,0.0,0,417,2773,562,2934,145,161
3461,levle1_600.jpg,fore,Unspecified,0.0,0,708,2190,869,2374,161,184
3462,levle1_600.jpg,fore,Unspecified,0.0,0,486,1983,692,2175,206,192
3463,levle1_600.jpg,fore,Unspecified,0.0,0,332,2091,516,2236,184,145
3464,levle1_600.jpg,fore,Unspecified,0.0,0,968,550,1091,665,123,115
3465,levle1_600.jpg,fore,Unspecified,0.0,0,692,2489,846,2627,154,138
3466,levle0_48.jpg,fore,Unspecified,0.0,0,1750,3079,1934,3255,184,176
3467,levle0_48.jpg,fore,Unspecified,0.0,0,2440,2198,2601,2313,161,115
3468,levle0_48.jpg,fore,Unspecified,0.0,0,2363,2091,2463,2190,100,99
3469,levle0_48.jpg,fore,Unspecified,0.0,0,2179,2075,2286,2206,107,131
3470,levle0_188.jpg,fore,Unspecified,0.0,0,2271,2819,2417,2979,146,160
3471,levle0_188.jpg,fore,Unspecified,0.0,0,2555,2152,2731,2389,176,237
3472,levle1_358.jpg,fore,Unspecified,0.0,0,493,2213,631,2297,138,84
3473,levle1_358.jpg,fore,Unspecified,0.0,0,509,2313,601,2435,92,122
3474,levle1_358.jpg,fore,Unspecified,0.0,0,846,2320,999,2489,153,169
3475,levle1_358.jpg,fore,Unspecified,0.0,0,984,2221,1106,2366,122,145
3476,levle1_358.jpg,fore,Unspecified,0.0,0,907,2543,1007,2704,100,161
3477,levle1_358.jpg,fore,Unspecified,0.0,0,708,2474,846,2619,138,145
3478,levle3_19.jpg,fore,,,0,437,168,464,189,27,21
3479,levle3_19.jpg,fore,,,0,435,132,447,159,12,27
3480,levle3_19.jpg,fore,,,0,371,94,395,117,24,23
3481,levle3_19.jpg,fore,,,0,405,89,425,113,20,24
3482,levle3_19.jpg,fore,,,0,425,73,443,93,18,20
3483,levle3_19.jpg,fore,,,0,378,61,396,90,18,29
3484,levle3_19.jpg,fore,,,0,350,52,371,73,21,21
3485,levle3_19.jpg,fore,,,0,356,71,375,94,19,23
3486,levle3_19.jpg,fore,,,0,376,17,399,41,23,24
3487,levle3_19.jpg,fore,,,0,353,21,375,47,22,26
3488,levle3_19.jpg,fore,,,0,331,26,350,38,19,12
3489,levle3_19.jpg,fore,,,0,327,42,336,68,9,26
3490,levle3_19.jpg,fore,,,0,357,169,376,196,19,27
3491,levle3_19.jpg,fore,,,0,357,206,382,233,25,27
3492,levle3_19.jpg,fore,,,0,383,223,404,250,21,27
3493,levle3_19.jpg,fore,,,0,384,245,405,268,21,23
3494,levle3_19.jpg,fore,,,0,348,241,364,258,16,17
3495,levle3_19.jpg,fore,,,0,363,254,376,279,13,25
3496,levle3_19.jpg,fore,,,0,336,218,357,239,21,21
3497,levle3_19.jpg,fore,,,0,327,196,350,231,23,35
3498,levle3_19.jpg,fore,,,0,339,178,357,206,18,28
3499,levle3_19.jpg,fore,,,0,328,168,346,195,18,27
3500,levle3_19.jpg,fore,,,0,310,182,331,208,21,26
3501,levle3_19.jpg,fore,,,0,306,160,325,182,19,22
3502,levle3_19.jpg,fore,,,0,303,114,341,138,38,24
3503,levle3_19.jpg,fore,,,0,292,180,315,198,23,18
3504,levle3_19.jpg,fore,,,0,294,209,301,239,7,30
3505,levle3_19.jpg,fore,,,0,304,202,326,223,22,21
3506,levle3_19.jpg,fore,,,0,308,237,338,260,30,23
3507,levle3_19.jpg,fore,,,0,382,127,407,149,25,22
3508,levle3_19.jpg,fore,,,0,397,187,417,212,20,25
3509,levle3_19.jpg,fore,,,0,437,190,463,215,26,25
3510,levle3_19.jpg,fore,,,0,294,126,303,146,9,20
3511,levle3_19.jpg,fore,,,0,466,140,489,164,23,24
3512,levle3_19.jpg,fore,,,0,462,116,485,139,23,23
3513,levle3_19.jpg,fore,,,0,356,119,376,135,20,16
3514,levle3_19.jpg,fore,,,0,344,106,361,122,17,16
3515,levle3_19.jpg,fore,,,0,357,100,373,115,16,15
3516,levle3_19.jpg,fore,,,0,328,141,348,157,20,16
3517,levle3_19.jpg,fore,,,0,419,204,437,227,18,23
3518,levle3_19.jpg,fore,,,0,434,216,452,234,18,18
3519,levle3_19.jpg,fore,,,0,405,238,425,257,20,19
3520,levle3_19.jpg,fore,,,0,398,296,418,311,20,15
3521,levle3_19.jpg,fore,,,0,425,298,443,312,18,14
3522,levle3_19.jpg,fore,,,0,416,251,448,269,32,18
3523,levle3_19.jpg,fore,,,0,380,192,398,211,18,19
3524,levle3_19.jpg,fore,,,0,418,313,437,332,19,19
3525,levle3_19.jpg,fore,,,0,415,48,439,72,24,24
3526,levle3_19.jpg,fore,,,0,397,55,415,81,18,26
3527,levle3_19.jpg,fore,,,0,277,141,298,158,21,17
3528,levle3_19.jpg,fore,,,0,354,296,376,322,22,26
3529,levle3_19.jpg,fore,,,0,378,286,400,316,22,30
3530,levle3_19.jpg,fore,,,0,363,283,383,304,20,21
3531,levle3_19.jpg,fore,,,0,384,150,406,171,22,21
3532,levle3_19.jpg,fore,,,0,400,32,422,50,22,18
3533,levle3_19.jpg,fore,,,0,466,193,486,217,20,24
3534,levle0_163.jpg,fore,Unspecified,0.0,0,1397,2811,1551,2956,154,145
3535,levle0_163.jpg,fore,Unspecified,0.0,0,1405,2190,1528,2336,123,146
3536,levle1_370.jpg,fore,Unspecified,0.0,0,1666,466,1781,627,115,161
3537,levle1_370.jpg,fore,Unspecified,0.0,0,1505,895,1604,995,99,100
3538,levle1_370.jpg,fore,Unspecified,0.0,0,2217,3056,2271,3133,54,77
3539,levle1_370.jpg,fore,Unspecified,0.0,0,2440,3010,2532,3140,92,130
3540,levle1_370.jpg,fore,Unspecified,0.0,0,2340,3117,2409,3217,69,100
3541,levle1_370.jpg,fore,Unspecified,0.0,0,1627,2788,1704,2865,77,77
3542,levle3_31.jpg,fore,,,0,148,59,170,74,22,15
3543,levle3_31.jpg,fore,,,0,155,37,176,48,21,11
3544,levle3_31.jpg,fore,,,0,146,0,164,22,18,22
3545,levle3_31.jpg,fore,,,0,159,12,184,36,25,24
3546,levle3_31.jpg,fore,,,0,201,40,231,57,30,17
3547,levle3_31.jpg,fore,,,0,190,63,216,79,26,16
3548,levle3_31.jpg,fore,,,0,185,77,203,90,18,13
3549,levle3_31.jpg,fore,,,0,213,68,237,91,24,23
3550,levle3_31.jpg,fore,,,0,218,91,240,115,22,24
3551,levle3_31.jpg,fore,,,0,201,89,220,108,19,19
3552,levle3_31.jpg,fore,,,0,172,88,191,113,19,25
3553,levle3_31.jpg,fore,,,0,155,111,174,125,19,14
3554,levle3_31.jpg,fore,,,0,161,126,176,148,15,22
3555,levle3_31.jpg,fore,,,0,190,120,206,142,16,22
3556,levle3_31.jpg,fore,,,0,135,72,146,91,11,19
3557,levle3_31.jpg,fore,,,0,229,165,248,187,19,22
3558,levle3_31.jpg,fore,,,0,144,171,167,187,23,16
3559,levle3_31.jpg,fore,,,0,93,219,107,236,14,17
3560,levle3_31.jpg,fore,,,0,66,216,87,239,21,23
3561,levle3_31.jpg,fore,,,0,166,194,192,218,26,24
3562,levle3_31.jpg,fore,,,0,206,185,223,203,17,18
3563,levle3_31.jpg,fore,,,0,222,209,242,233,20,24
3564,levle3_31.jpg,fore,,,0,182,214,203,239,21,25
3565,levle3_31.jpg,fore,,,0,185,251,206,272,21,21
3566,levle3_31.jpg,fore,,,0,145,225,167,243,22,18
3567,levle3_31.jpg,fore,,,0,142,198,161,215,19,17
3568,levle3_31.jpg,fore,,,0,123,222,135,231,12,9
3569,levle3_31.jpg,fore,,,0,132,234,150,257,18,23
3570,levle3_31.jpg,fore,,,0,130,253,148,273,18,20
3571,levle3_31.jpg,fore,,,0,105,276,126,296,21,20
3572,levle3_31.jpg,fore,,,0,107,287,125,311,18,24
3573,levle3_31.jpg,fore,,,0,143,273,165,294,22,21
3574,levle3_31.jpg,fore,,,0,154,257,178,276,24,19
3575,levle3_31.jpg,fore,,,0,145,299,167,319,22,20
3576,levle3_31.jpg,fore,,,0,170,309,186,324,16,15
3577,levle3_31.jpg,fore,,,0,191,304,215,323,24,19
3578,levle3_31.jpg,fore,,,0,108,334,132,347,24,13
3579,levle3_31.jpg,fore,,,0,84,340,108,366,24,26
3580,levle3_31.jpg,fore,,,0,104,191,134,218,30,27
3581,levle3_31.jpg,fore,,,0,165,164,187,189,22,25
3582,levle3_31.jpg,fore,,,0,190,154,213,171,23,17
3583,levle3_31.jpg,fore,,,0,213,242,237,277,24,35
3584,levle3_31.jpg,fore,,,0,183,278,211,306,28,28
3585,levle3_31.jpg,fore,,,0,89,314,117,340,28,26
3586,levle3_31.jpg,fore,,,0,83,276,102,294,19,18
3587,levle3_31.jpg,fore,,,0,71,385,86,400,15,15
3588,levle3_31.jpg,fore,,,0,131,336,148,359,17,23
3589,levle3_31.jpg,fore,,,0,122,317,141,336,19,19
3590,levle3_31.jpg,fore,,,0,159,319,171,335,12,16
3591,levle3_31.jpg,fore,,,0,160,338,174,352,14,14
3592,levle3_31.jpg,fore,,,0,157,355,175,371,18,16
3593,levle3_31.jpg,fore,,,0,43,289,59,308,16,19
3594,levle3_31.jpg,fore,,,0,202,219,220,244,18,25
3595,levle1_416.jpg,fore,Unspecified,0.0,0,930,1018,1122,1217,192,199
3596,levle1_416.jpg,fore,Unspecified,0.0,0,2394,1501,2562,1669,168,168
3597,levle1_416.jpg,fore,Unspecified,0.0,0,2401,1769,2631,1899,230,130
3598,levle1_416.jpg,fore,Unspecified,0.0,0,2394,2251,2509,2451,115,200
3599,levle1_416.jpg,fore,Unspecified,0.0,0,2041,3071,2271,3179,230,108
3600,levle1_416.jpg,fore,Unspecified,0.0,0,1145,3209,1290,3332,145,123
3601,levle1_402.jpg,fore,Unspecified,0.0,0,1221,696,1459,834,238,138
3602,levle1_402.jpg,fore,Unspecified,0.0,0,2570,2129,2746,2313,176,184
3603,levle3_25.jpg,fore,Unspecified,0.0,0,165,46,184,67,19,21
3604,levle3_25.jpg,fore,Unspecified,0.0,0,143,45,164,60,21,15
3605,levle3_25.jpg,fore,Unspecified,0.0,0,96,57,113,77,17,20
3606,levle3_25.jpg,fore,Unspecified,0.0,0,140,68,158,88,18,20
3607,levle3_25.jpg,fore,Unspecified,0.0,0,121,69,139,95,18,26
3608,levle3_25.jpg,fore,Unspecified,0.0,0,129,41,150,64,21,23
3609,levle3_25.jpg,fore,Unspecified,0.0,0,104,89,120,103,16,14
3610,levle3_25.jpg,fore,Unspecified,0.0,0,97,111,119,130,22,19
3611,levle3_25.jpg,fore,Unspecified,0.0,0,77,108,90,117,13,9
3612,levle3_25.jpg,fore,Unspecified,0.0,0,77,121,90,137,13,16
3613,levle3_25.jpg,fore,Unspecified,0.0,0,97,133,120,156,23,23
3614,levle3_25.jpg,fore,Unspecified,0.0,0,56,134,76,152,20,18
3615,levle3_25.jpg,fore,Unspecified,0.0,0,84,152,97,167,13,15
3616,levle3_25.jpg,fore,Unspecified,0.0,0,47,150,65,165,18,15
3617,levle3_25.jpg,fore,Unspecified,0.0,0,29,167,46,184,17,17
3618,levle3_25.jpg,fore,Unspecified,0.0,0,30,191,50,210,20,19
3619,levle3_25.jpg,fore,Unspecified,0.0,0,20,200,43,221,23,21
3620,levle3_25.jpg,fore,Unspecified,0.0,0,109,161,137,182,28,21
3621,levle3_25.jpg,fore,Unspecified,0.0,0,33,236,59,259,26,23
3622,levle3_25.jpg,fore,Unspecified,0.0,0,152,193,171,213,19,20
3623,levle3_25.jpg,fore,Unspecified,0.0,0,53,269,78,289,25,20
3624,levle3_25.jpg,fore,Unspecified,0.0,0,11,281,31,304,20,23
3625,levle3_25.jpg,fore,Unspecified,0.0,0,44,319,58,333,14,14
3626,levle3_25.jpg,fore,Unspecified,0.0,0,185,306,199,326,14,20
3627,levle3_25.jpg,fore,Unspecified,0.0,0,226,312,258,327,32,15
3628,levle3_25.jpg,fore,Unspecified,0.0,0,225,290,243,309,18,19
3629,levle3_25.jpg,fore,Unspecified,0.0,0,211,260,237,282,26,22
3630,levle3_25.jpg,fore,Unspecified,0.0,0,181,261,202,283,21,22
3631,levle3_25.jpg,fore,Unspecified,0.0,0,212,203,235,225,23,22
3632,levle3_25.jpg,fore,Unspecified,0.0,0,232,230,256,252,24,22
3633,levle3_25.jpg,fore,Unspecified,0.0,0,266,317,289,333,23,16
3634,levle3_25.jpg,fore,Unspecified,0.0,0,243,337,258,353,15,16
3635,levle3_25.jpg,fore,Unspecified,0.0,0,236,366,268,382,32,16
3636,levle3_25.jpg,fore,Unspecified,0.0,0,242,382,269,398,27,16
3637,levle3_25.jpg,fore,Unspecified,0.0,0,200,334,227,356,27,22
3638,levle3_25.jpg,fore,Unspecified,0.0,0,135,267,161,286,26,19
3639,levle3_25.jpg,fore,Unspecified,0.0,0,115,291,144,308,29,17
3640,levle3_25.jpg,fore,Unspecified,0.0,0,133,310,144,329,11,19
3641,levle3_25.jpg,fore,Unspecified,0.0,0,181,222,202,240,21,18
3642,levle3_25.jpg,fore,Unspecified,0.0,0,155,327,177,349,22,22
3643,levle3_25.jpg,fore,Unspecified,0.0,0,178,347,196,371,18,24
3644,levle3_25.jpg,fore,Unspecified,0.0,0,212,364,237,392,25,28
3645,levle3_25.jpg,fore,Unspecified,0.0,0,128,328,156,352,28,24
3646,levle3_25.jpg,fore,Unspecified,0.0,0,85,294,121,310,36,16
3647,levle3_25.jpg,fore,Unspecified,0.0,0,89,261,117,287,28,26
3648,levle3_25.jpg,fore,Unspecified,0.0,0,67,242,86,262,19,20
3649,levle3_25.jpg,fore,Unspecified,0.0,0,93,226,122,252,29,26
3650,levle3_25.jpg,fore,Unspecified,0.0,0,109,206,134,230,25,24
3651,levle3_25.jpg,fore,Unspecified,0.0,0,104,194,119,213,15,19
3652,levle3_25.jpg,fore,Unspecified,0.0,0,71,211,85,224,14,13
3653,levle3_25.jpg,fore,Unspecified,0.0,0,50,211,70,232,20,21
3654,levle3_25.jpg,fore,Unspecified,0.0,0,80,180,102,189,22,9
3655,levle3_25.jpg,fore,Unspecified,0.0,0,59,170,80,203,21,33
3656,levle0_177.jpg,fore,Unspecified,0.0,0,601,1608,700,1746,99,138
3657,levle1_364.jpg,fore,Unspecified,0.0,0,1597,2964,1658,3079,61,115
3658,levle1_364.jpg,fore,Unspecified,0.0,0,1658,3048,1750,3140,92,92
3659,levle1_364.jpg,fore,Unspecified,0.0,0,1466,2911,1551,3048,85,137
3660,levle1_364.jpg,fore,Unspecified,0.0,0,1796,2757,1911,2865,115,108
3661,levle1_364.jpg,fore,Unspecified,0.0,0,1719,2880,1819,2964,100,84
3662,levle1_364.jpg,fore,Unspecified,0.0,0,1750,2949,1865,3064,115,115
3663,levle1_364.jpg,fore,Unspecified,0.0,0,1949,2880,2057,3010,108,130
3664,levle1_364.jpg,fore,Unspecified,0.0,0,2026,2773,2233,2895,207,122
3665,levle1_364.jpg,fore,Unspecified,0.0,0,1260,2780,1375,2918,115,138
3666,levle1_364.jpg,fore,Unspecified,0.0,0,1390,2780,1528,2934,138,154
3667,levle1_364.jpg,fore,Unspecified,0.0,0,1053,2765,1244,2918,191,153
3668,levle1_364.jpg,fore,Unspecified,0.0,0,984,3048,1129,3156,145,108
3669,levle1_364.jpg,fore,Unspecified,0.0,0,1014,2934,1083,3025,69,91
3670,levle1_364.jpg,fore,Unspecified,0.0,0,1114,2926,1252,3079,138,153
3671,levle1_414.jpg,fore,Unspecified,0.0,0,570,1485,654,1585,84,100
3672,levle1_414.jpg,fore,Unspecified,0.0,0,1068,2267,1237,2389,169,122
3673,levle1_414.jpg,fore,Unspecified,0.0,0,3,2650,102,2788,99,138
3674,levle1_414.jpg,fore,Unspecified,0.0,0,294,2903,371,3025,77,122
3675,levle1_414.jpg,fore,Unspecified,0.0,0,440,2949,570,3117,130,168
3676,levle1_414.jpg,fore,Unspecified,0.0,0,953,3033,1068,3140,115,107
3677,levle3_33.jpg,fore,,,0,91,1,115,9,24,8
3678,levle3_33.jpg,fore,,,0,93,15,108,27,15,12
3679,levle3_33.jpg,fore,,,0,85,44,102,61,17,17
3680,levle3_33.jpg,fore,,,0,63,10,81,28,18,18
3681,levle3_33.jpg,fore,,,0,61,80,75,92,14,12
3682,levle3_33.jpg,fore,,,0,52,139,67,155,15,16
3683,levle3_33.jpg,fore,,,0,77,157,87,177,10,20
3684,levle3_33.jpg,fore,,,0,96,157,111,174,15,17
3685,levle3_33.jpg,fore,,,0,89,170,106,192,17,22
3686,levle3_33.jpg,fore,,,0,70,192,87,210,17,18
3687,levle3_33.jpg,fore,,,0,106,185,119,199,13,14
3688,levle3_33.jpg,fore,,,0,144,165,159,186,15,21
3689,levle3_33.jpg,fore,,,0,83,219,97,232,14,13
3690,levle3_33.jpg,fore,,,0,178,272,200,288,22,16
3691,levle3_33.jpg,fore,,,0,198,180,218,194,20,14
3692,levle3_33.jpg,fore,,,0,123,3,141,26,18,23
3693,levle3_33.jpg,fore,,,0,48,88,60,109,12,21
3694,levle3_33.jpg,fore,,,0,43,111,61,127,18,16
3695,levle3_33.jpg,fore,,,0,23,135,39,164,16,29
3696,levle3_33.jpg,fore,,,0,145,198,166,214,21,16
3697,levle3_33.jpg,fore,,,0,120,212,136,230,16,18
3698,levle3_33.jpg,fore,,,0,124,225,145,251,21,26
3699,levle3_33.jpg,fore,,,0,142,240,169,268,27,28
3700,levle3_33.jpg,fore,,,0,163,277,180,301,17,24
3701,levle3_33.jpg,fore,,,0,146,282,161,304,15,22
3702,levle3_33.jpg,fore,,,0,83,237,105,250,22,13
3703,levle3_33.jpg,fore,,,0,79,253,102,274,23,21
3704,levle3_33.jpg,fore,,,0,105,247,133,265,28,18
3705,levle3_33.jpg,fore,,,0,93,272,110,292,17,20
3706,levle3_33.jpg,fore,,,0,103,270,129,291,26,21
3707,levle3_33.jpg,fore,,,0,120,280,137,300,17,20
3708,levle3_33.jpg,fore,,,0,53,192,69,206,16,14
3709,levle3_33.jpg,fore,,,0,57,160,71,188,14,28
3710,levle3_33.jpg,fore,,,0,114,165,130,179,16,14
3711,levle3_33.jpg,fore,,,0,68,136,83,147,15,11
3712,levle3_33.jpg,fore,,,0,77,145,92,156,15,11
3713,levle3_33.jpg,fore,,,0,95,135,106,146,11,11
3714,levle3_33.jpg,fore,,,0,94,145,111,154,17,9
3715,levle3_33.jpg,fore,,,0,92,120,103,131,11,11
3716,levle3_33.jpg,fore,,,0,103,120,114,131,11,11
3717,levle3_33.jpg,fore,,,0,65,109,79,122,14,13
3718,levle3_33.jpg,fore,,,0,26,117,45,132,19,15
3719,levle3_33.jpg,fore,,,0,24,101,41,119,17,18
3720,levle3_33.jpg,fore,,,0,39,78,53,91,14,13
3721,levle3_33.jpg,fore,,,0,41,167,59,186,18,19
3722,levle3_33.jpg,fore,,,0,36,140,51,157,15,17
3723,levle3_33.jpg,fore,,,0,46,203,61,218,15,15
3724,levle3_33.jpg,fore,,,0,54,215,68,228,14,13
3725,levle3_33.jpg,fore,,,0,65,214,80,233,15,19
3726,levle3_33.jpg,fore,,,0,5,180,24,197,19,17
3727,levle3_33.jpg,fore,,,0,172,161,194,187,22,26
3728,levle3_33.jpg,fore,,,0,156,146,177,170,21,24
3729,levle3_33.jpg,fore,,,0,179,245,192,258,13,13
3730,levle3_33.jpg,fore,,,0,91,199,119,233,28,34
3731,levle3_33.jpg,fore,,,0,170,239,183,251,13,12
3732,levle3_33.jpg,fore,,,0,27,207,52,254,25,47
3733,levle1_372.jpg,fore,Unspecified,0.0,0,938,2106,1152,2328,214,222
3734,levle1_372.jpg,fore,Unspecified,0.0,0,838,2619,976,2750,138,131
3735,levle1_372.jpg,fore,Unspecified,0.0,0,976,2627,1122,2826,146,199
3736,levle1_372.jpg,fore,Unspecified,0.0,0,807,2811,953,2972,146,161
3737,levle1_372.jpg,fore,Unspecified,0.0,0,1712,2934,1827,3056,115,122
3738,levle1_372.jpg,fore,Unspecified,0.0,0,1413,803,1535,933,122,130
3739,levle1_372.jpg,fore,Unspecified,0.0,0,1796,865,1934,1056,138,191
3740,levle0_161.jpg,fore,Unspecified,0.0,0,2509,2397,2631,2497,122,100
3741,levle0_161.jpg,fore,Unspecified,0.0,0,2148,2842,2317,2972,169,130
3742,levle0_161.jpg,fore,Unspecified,0.0,0,1926,2865,2087,3033,161,168
3743,levle1_366.jpg,fore,Unspecified,0.0,0,1428,2688,1589,2819,161,131
3744,levle1_366.jpg,fore,Unspecified,0.0,0,1543,2826,1681,2972,138,146
3745,levle1_366.jpg,fore,Unspecified,0.0,0,915,2788,1076,2949,161,161
3746,levle1_366.jpg,fore,Unspecified,0.0,0,1099,2811,1244,2949,145,138
3747,levle1_366.jpg,fore,Unspecified,0.0,0,1290,2796,1397,2949,107,153
3748,levle1_366.jpg,fore,Unspecified,0.0,0,1459,3018,1627,3194,168,176
3749,levle1_366.jpg,fore,Unspecified,0.0,0,1857,2949,1965,3087,108,138
3750,levle1_366.jpg,fore,Unspecified,0.0,0,884,1209,976,1355,92,146
3751,levle0_175.jpg,fore,Unspecified,0.0,0,700,1363,823,1524,123,161
3752,levle0_175.jpg,fore,Unspecified,0.0,0,639,1669,769,1845,130,176
3753,levle3_27.jpg,fore,Unspecified,0.0,0,173,1,192,14,19,13
3754,levle3_27.jpg,fore,Unspecified,0.0,0,196,50,210,69,14,19
3755,levle3_27.jpg,fore,Unspecified,0.0,0,80,7,90,27,10,20
3756,levle3_27.jpg,fore,Unspecified,0.0,0,56,3,77,27,21,24
3757,levle3_27.jpg,fore,Unspecified,0.0,0,4,11,18,27,14,16
3758,levle3_27.jpg,fore,Unspecified,0.0,0,27,40,42,54,15,14
3759,levle3_27.jpg,fore,Unspecified,0.0,0,51,57,64,72,13,15
3760,levle3_27.jpg,fore,Unspecified,0.0,0,68,49,81,67,13,18
3761,levle3_27.jpg,fore,Unspecified,0.0,0,114,41,138,56,24,15
3762,levle3_27.jpg,fore,Unspecified,0.0,0,94,16,107,32,13,16
3763,levle3_27.jpg,fore,Unspecified,0.0,0,132,62,144,77,12,15
3764,levle3_27.jpg,fore,Unspecified,0.0,0,105,68,119,81,14,13
3765,levle3_27.jpg,fore,Unspecified,0.0,0,156,64,170,84,14,20
3766,levle3_27.jpg,fore,Unspecified,0.0,0,152,99,167,122,15,23
3767,levle3_27.jpg,fore,Unspecified,0.0,0,146,136,163,156,17,20
3768,levle3_27.jpg,fore,Unspecified,0.0,0,82,135,107,159,25,24
3769,levle3_27.jpg,fore,Unspecified,0.0,0,46,121,57,134,11,13
3770,levle3_27.jpg,fore,Unspecified,0.0,0,13,121,33,136,20,15
3771,levle3_27.jpg,fore,Unspecified,0.0,0,12,141,24,155,12,14
3772,levle3_27.jpg,fore,Unspecified,0.0,0,27,160,41,180,14,20
3773,levle3_27.jpg,fore,Unspecified,0.0,0,54,169,69,187,15,18
3774,levle3_27.jpg,fore,Unspecified,0.0,0,77,167,90,179,13,12
3775,levle3_27.jpg,fore,Unspecified,0.0,0,81,179,94,194,13,15
3776,levle3_27.jpg,fore,Unspecified,0.0,0,20,196,33,211,13,15
3777,levle3_27.jpg,fore,Unspecified,0.0,0,7,170,18,184,11,14
3778,levle3_27.jpg,fore,Unspecified,0.0,0,102,169,119,189,17,20
3779,levle3_27.jpg,fore,Unspecified,0.0,0,96,186,119,210,23,24
3780,levle3_27.jpg,fore,Unspecified,0.0,0,110,201,132,218,22,17
3781,levle3_27.jpg,fore,Unspecified,0.0,0,126,189,142,203,16,14
3782,levle3_27.jpg,fore,Unspecified,0.0,0,139,184,156,201,17,17
3783,levle3_27.jpg,fore,Unspecified,0.0,0,238,170,249,185,11,15
3784,levle3_27.jpg,fore,Unspecified,0.0,0,222,157,236,175,14,18
3785,levle3_27.jpg,fore,Unspecified,0.0,0,188,167,208,182,20,15
3786,levle3_27.jpg,fore,Unspecified,0.0,0,183,184,192,194,9,10
3787,levle3_27.jpg,fore,Unspecified,0.0,0,162,178,180,195,18,17
3788,levle3_27.jpg,fore,Unspecified,0.0,0,168,155,181,174,13,19
3789,levle3_27.jpg,fore,Unspecified,0.0,0,183,200,195,217,12,17
3790,levle3_27.jpg,fore,Unspecified,0.0,0,195,195,211,216,16,21
3791,levle3_27.jpg,fore,Unspecified,0.0,0,204,228,230,249,26,21
3792,levle3_27.jpg,fore,Unspecified,0.0,0,180,126,194,138,14,12
3793,levle3_27.jpg,fore,Unspecified,0.0,0,188,108,202,122,14,14
3794,levle3_27.jpg,fore,Unspecified,0.0,0,207,108,217,117,10,9
3795,levle3_27.jpg,fore,Unspecified,0.0,0,208,123,224,139,16,16
3796,levle3_27.jpg,fore,Unspecified,0.0,0,123,100,139,119,16,19
3797,levle3_27.jpg,fore,Unspecified,0.0,0,132,137,147,154,15,17
3798,levle3_27.jpg,fore,Unspecified,0.0,0,55,95,80,118,25,23
3799,levle3_27.jpg,fore,Unspecified,0.0,0,38,141,61,159,23,18
3800,levle3_27.jpg,fore,Unspecified,0.0,0,103,84,116,101,13,17
3801,levle3_27.jpg,fore,Unspecified,0.0,0,128,80,149,96,21,16
3802,levle3_27.jpg,fore,Unspecified,0.0,0,175,72,183,90,8,18
3803,levle3_27.jpg,fore,Unspecified,0.0,0,151,84,165,99,14,15
3804,levle3_27.jpg,fore,Unspecified,0.0,0,87,43,105,62,18,19
3805,levle3_27.jpg,fore,Unspecified,0.0,0,39,63,47,79,8,16
3806,levle3_27.jpg,fore,Unspecified,0.0,0,106,2,134,19,28,17
3807,levle3_27.jpg,fore,Unspecified,0.0,0,110,24,128,39,18,15
3808,levle3_27.jpg,fore,Unspecified,0.0,0,133,32,151,46,18,14
3809,levle3_27.jpg,fore,Unspecified,0.0,0,147,41,166,55,19,14
3810,levle3_27.jpg,fore,Unspecified,0.0,0,212,51,229,66,17,15
3811,levle1_400.jpg,fore,Unspecified,0.0,0,162,96,184,120,22,24
3812,levle1_400.jpg,fore,Unspecified,0.0,0,304,309,345,335,41,26
3813,levle1_400.jpg,fore,Unspecified,0.0,0,256,467,288,511,32,44
3814,levle1_400.jpg,fore,Unspecified,0.0,0,141,480,174,523,33,43
3815,levle1_400.jpg,fore,Unspecified,0.0,0,179,506,201,525,22,19
3816,levle1_400.jpg,fore,Unspecified,0.0,0,134,521,167,564,33,43
3817,levle1_400.jpg,fore,Unspecified,0.0,0,210,549,240,576,30,27
3818,levle1_400.jpg,fore,Unspecified,0.0,0,251,188,290,224,39,36
3819,levle1_428.jpg,fore,,,0,378,1416,524,1562,146,146
3820,levle1_428.jpg,fore,,,0,317,1547,386,1692,69,145
3821,levle1_428.jpg,fore,,,0,424,1746,547,1822,123,76
3822,levle1_428.jpg,fore,,,0,409,1838,516,1914,107,76
3823,levle1_428.jpg,fore,,,0,677,2539,798,2646,121,107
3824,levle1_428.jpg,fore,,,0,453,1619,571,1722,118,103
3825,levle0_149.jpg,fore,Unspecified,0.0,0,1106,1547,1267,1692,161,145
3826,levle1_399.jpg,fore,Unspecified,0.0,0,470,1815,547,1968,77,153
3827,levle1_399.jpg,fore,Unspecified,0.0,0,302,2091,486,2267,184,176
3828,levle1_399.jpg,fore,Unspecified,0.0,0,202,1937,355,2106,153,169
3829,levle1_399.jpg,fore,Unspecified,0.0,0,463,2129,493,2144,30,15
3830,levle1_399.jpg,fore,Unspecified,0.0,0,800,2075,991,2244,191,169
3831,levle1_399.jpg,fore,Unspecified,0.0,0,784,2251,938,2374,154,123
3832,levle1_399.jpg,fore,Unspecified,0.0,0,861,2474,1007,2589,146,115
3833,levle1_399.jpg,fore,Unspecified,0.0,0,1443,3102,1551,3225,108,123
3834,levle1_399.jpg,fore,Unspecified,0.0,0,1528,2857,1696,3010,168,153
3835,levle0_363.jpg,fore,Unspecified,0.0,0,2194,1769,2302,1983,108,214
3836,levle0_363.jpg,fore,Unspecified,0.0,0,2348,1792,2501,1930,153,138
3837,levle1_170.jpg,fore,Unspecified,0.0,0,1520,2466,1589,2566,69,100
3838,levle1_170.jpg,fore,Unspecified,0.0,0,1689,2320,1758,2443,69,123
3839,levle1_170.jpg,fore,Unspecified,0.0,0,1842,2397,1934,2489,92,92
3840,levle1_170.jpg,fore,Unspecified,0.0,0,1873,2612,1942,2727,69,115
3841,levle1_170.jpg,fore,Unspecified,0.0,0,1819,573,1911,719,92,146
3842,levle1_170.jpg,fore,Unspecified,0.0,0,1957,2466,2026,2581,69,115
3843,levle1_616.jpg,fore,Unspecified,0.0,0,1290,2366,1420,2466,130,100
3844,levle1_616.jpg,fore,Unspecified,0.0,0,279,2236,417,2405,138,169
3845,levle1_616.jpg,fore,Unspecified,0.0,0,217,1876,317,2022,100,146
3846,levle1_616.jpg,fore,Unspecified,0.0,0,455,2014,616,2167,161,153
3847,levle1_616.jpg,fore,Unspecified,0.0,0,539,2650,662,2788,123,138
3848,levle1_616.jpg,fore,Unspecified,0.0,0,210,2458,332,2627,122,169
3849,levle0_405.jpg,fore,Unspecified,0.0,0,731,1654,884,1776,153,122
3850,levle0_405.jpg,fore,Unspecified,0.0,0,1451,1094,1589,1186,138,92
3851,levle0_405.jpg,fore,Unspecified,0.0,0,715,2405,838,2573,123,168
3852,levle0_411.jpg,fore,Unspecified,0.0,0,1413,2045,1520,2152,107,107
3853,levle0_377.jpg,fore,Unspecified,0.0,0,1589,1439,1742,1592,153,153
3854,levle0_377.jpg,fore,Unspecified,0.0,0,1727,1309,1880,1416,153,107
3855,levle0_377.jpg,fore,Unspecified,0.0,0,1076,2274,1191,2420,115,146
3856,levle1_164.jpg,fore,Unspecified,0.0,0,2355,2006,2478,2114,123,108
3857,levle1_164.jpg,fore,Unspecified,0.0,0,1842,2359,1957,2512,115,153
3858,levle1_164.jpg,fore,Unspecified,0.0,0,1949,2213,2079,2351,130,138
3859,levle1_164.jpg,fore,Unspecified,0.0,0,1781,2083,1880,2229,99,146
3860,levle1_164.jpg,fore,Unspecified,0.0,0,1482,2926,1620,3041,138,115
3861,levle1_164.jpg,fore,Unspecified,0.0,0,2026,2803,2102,2911,76,108
3862,levle1_164.jpg,fore,Unspecified,0.0,0,2141,3002,2202,3125,61,123
3863,levle0_62.jpg,fore,Unspecified,0.0,0,2774,928,2999,1211,225,283
3864,levle0_62.jpg,fore,Unspecified,0.0,0,2400,1227,2625,1601,225,374
3865,levle0_62.jpg,fore,Unspecified,0.0,0,1195,1684,1411,1834,216,150
3866,levle0_62.jpg,fore,Unspecified,0.0,0,1262,828,1661,1136,399,308
3867,levle0_62.jpg,fore,Unspecified,0.0,0,1877,1701,2168,2017,291,316
3868,levle0_439.jpg,fore,Unspecified,0.0,0,2057,2052,2248,2229,191,177
3869,levle0_439.jpg,fore,Unspecified,0.0,0,1145,320,1275,458,130,138
3870,levle0_76.jpg,fore,Unspecified,0.0,0,2991,1751,3115,1909,124,158
3871,levle0_76.jpg,fore,Unspecified,0.0,0,1860,928,1977,1020,117,92
3872,levle0_76.jpg,fore,Unspecified,0.0,0,2700,554,2874,795,174,241
3873,levle1_158.jpg,fore,Unspecified,0.0,0,807,412,945,589,138,177
3874,levle1_158.jpg,fore,Unspecified,0.0,0,1650,642,1781,811,131,169
3875,levle1_158.jpg,fore,Unspecified,0.0,0,1949,451,2041,619,92,168
3876,levle1_158.jpg,fore,Unspecified,0.0,0,968,1999,1122,2137,154,138
3877,levle1_158.jpg,fore,Unspecified,0.0,0,1191,1899,1375,2068,184,169
3878,levle1_158.jpg,fore,Unspecified,0.0,0,1712,2412,1911,2535,199,123
3879,levle1_158.jpg,fore,Unspecified,0.0,0,585,2520,731,2658,146,138
3880,levle1_158.jpg,fore,Unspecified,0.0,0,723,2152,830,2313,107,161
3881,levle1_158.jpg,fore,Unspecified,0.0,0,899,2282,1014,2428,115,146
3882,levle1_158.jpg,fore,Unspecified,0.0,0,899,2443,1076,2543,177,100
3883,levle1_158.jpg,fore,Unspecified,0.0,0,432,2045,524,2183,92,138
3884,levle0_89.jpg,fore,Unspecified,0.0,0,968,596,1076,734,108,138
3885,levle0_388.jpg,fore,Unspecified,0.0,0,1336,2995,1413,3148,77,153
3886,levle0_388.jpg,fore,Unspecified,0.0,0,1758,2704,1911,2865,153,161
3887,levle0_217.jpg,fore,Unspecified,0.0,0,1696,3125,1788,3324,92,199
3888,levle0_217.jpg,fore,Unspecified,0.0,0,1888,3087,2072,3209,184,122
3889,levle0_203.jpg,fore,Unspecified,0.0,0,1704,2251,1865,2397,161,146
3890,levle0_203.jpg,fore,Unspecified,0.0,0,1260,1041,1382,1179,122,138
3891,levle0_203.jpg,fore,Unspecified,0.0,0,1390,2972,1551,3140,161,168
3892,levle2_67.jpg,fore,,,0,1719,878,1844,1061,125,183
3893,levle2_67.jpg,fore,,,0,1337,1128,1519,1319,182,191
3894,levle2_67.jpg,fore,,,0,1270,1261,1411,1435,141,174
3895,levle2_67.jpg,fore,,,0,1561,1485,1777,1676,216,191
3896,levle2_67.jpg,fore,,,0,1711,1942,1893,2117,182,175
3897,levle2_67.jpg,fore,,,0,1229,1975,1370,2133,141,158
3898,levle2_67.jpg,fore,,,0,1794,2624,1985,2798,191,174
3899,levle2_67.jpg,fore,,,0,2060,2557,2184,2649,124,92
3900,levle2_67.jpg,fore,,,0,2284,2607,2492,2732,208,125
3901,levle2_67.jpg,fore,,,0,2392,2374,2500,2532,108,158
3902,levle2_67.jpg,fore,,,0,2459,2208,2616,2358,157,150
3903,levle2_67.jpg,fore,,,0,2184,2840,2359,3048,175,208
3904,levle2_67.jpg,fore,,,0,2334,2890,2492,3064,158,174
3905,levle2_67.jpg,fore,,,0,2492,2848,2683,2973,191,125
3906,levle2_67.jpg,fore,,,0,1677,637,1918,812,241,175
3907,levle2_67.jpg,fore,,,0,1893,529,2068,795,175,266
3908,levle2_67.jpg,fore,,,0,1328,272,1494,413,166,141
3909,levle2_67.jpg,fore,,,0,1461,562,1603,762,142,200
3910,levle2_67.jpg,fore,,,0,2159,438,2301,596,142,158
3911,levle2_67.jpg,fore,,,0,1410,1066,1538,1170,128,104
3912,levle2_67.jpg,fore,,,0,1602,2238,1742,2362,140,124
3913,levle2_73.jpg,fore,,,0,1114,389,1313,512,199,123
3914,levle2_73.jpg,fore,,,0,1275,336,1443,458,168,122
3915,levle2_73.jpg,fore,,,0,1168,497,1352,604,184,107
3916,levle2_73.jpg,fore,,,0,1137,642,1313,788,176,146
3917,levle2_73.jpg,fore,,,0,907,696,1076,895,169,199
3918,levle2_73.jpg,fore,,,0,1313,550,1466,696,153,146
3919,levle2_73.jpg,fore,,,0,1589,535,1681,704,92,169
3920,levle2_73.jpg,fore,,,0,1727,504,1911,642,184,138
3921,levle2_73.jpg,fore,,,0,2432,1064,2570,1255,138,191
3922,levle2_73.jpg,fore,,,0,2386,1378,2539,1569,153,191
3923,levle2_73.jpg,fore,,,0,2463,1960,2593,2083,130,123
3924,levle2_73.jpg,fore,,,0,2455,2114,2593,2244,138,130
3925,levle2_73.jpg,fore,,,0,2424,2259,2578,2420,154,161
3926,levle2_73.jpg,fore,,,0,2256,2259,2394,2435,138,176
3927,levle2_73.jpg,fore,,,0,2049,2060,2225,2221,176,161
3928,levle2_73.jpg,fore,,,0,1995,2198,2187,2435,192,237
3929,levle2_73.jpg,fore,,,0,1834,2129,2003,2313,169,184
3930,levle2_73.jpg,fore,,,0,1574,2144,1773,2343,199,199
3931,levle2_73.jpg,fore,,,0,1719,2382,1888,2520,169,138
3932,levle2_73.jpg,fore,,,0,1758,2573,1972,2750,214,177
3933,levle2_73.jpg,fore,,,0,1888,708,2067,857,179,149
3934,levle2_98.jpg,fore,,,0,1045,1562,1175,1700,130,138
3935,levle2_98.jpg,fore,,,0,999,1263,1122,1416,123,153
3936,levle2_98.jpg,fore,,,0,930,979,1068,1171,138,192
3937,levle2_98.jpg,fore,,,0,2049,2052,2256,2213,207,161
3938,levle2_98.jpg,fore,,,0,1382,2221,1543,2359,161,138
3939,levle2_98.jpg,fore,,,0,1696,2351,1811,2489,115,138
3940,levle2_98.jpg,fore,,,0,1635,2466,1804,2612,169,146
3941,levle2_98.jpg,fore,,,0,1850,2251,1995,2458,145,207
3942,levle2_98.jpg,fore,,,0,2279,2336,2432,2497,153,161
3943,levle2_98.jpg,fore,,,0,2148,2420,2256,2520,108,100
3944,levle2_98.jpg,fore,,,0,2286,2481,2424,2596,138,115
3945,levle2_98.jpg,fore,,,0,1819,2527,1972,2642,153,115
3946,levle2_98.jpg,fore,,,0,1857,2635,1965,2788,108,153
3947,levle2_98.jpg,fore,,,0,1880,2750,2018,2903,138,153
3948,levle2_98.jpg,fore,,,0,2041,2811,2217,2941,176,130
3949,levle2_98.jpg,fore,,,0,2003,2604,2164,2750,161,146
3950,levle2_98.jpg,fore,,,0,2011,2443,2171,2619,160,176
3951,levle2_98.jpg,fore,,,0,1489,3278,1612,3409,123,131
3952,levle2_98.jpg,fore,,,0,2455,2106,2685,2382,230,276
3953,levle2_98.jpg,fore,,,0,1926,2601,2057,2719,131,118
3954,levle2_98.jpg,fore,,,0,2129,2598,2271,2722,142,124
3955,levle1_1.jpg,fore,Unspecified,0.0,0,213,374,237,398,24,24
3956,levle1_1.jpg,fore,Unspecified,0.0,0,251,351,273,368,22,17
3957,levle1_1.jpg,fore,Unspecified,0.0,0,280,382,299,402,19,20
3958,levle1_1.jpg,fore,Unspecified,0.0,0,295,358,324,387,29,29
3959,levle1_1.jpg,fore,Unspecified,0.0,0,185,461,211,485,26,24
3960,levle1_1.jpg,fore,Unspecified,0.0,0,115,563,141,585,26,22
3961,levle1_1.jpg,fore,Unspecified,0.0,0,282,265,310,291,28,26
3962,levle2_110.jpg,fore,Unspecified,0.0,0,2079,1148,2248,1309,169,161
3963,levle2_110.jpg,fore,Unspecified,0.0,0,1865,857,1995,972,130,115
3964,levle2_110.jpg,fore,Unspecified,0.0,0,2118,972,2271,1071,153,99
3965,levle2_110.jpg,fore,Unspecified,0.0,0,1558,68,1712,221,154,153
3966,levle2_110.jpg,fore,Unspecified,0.0,0,1405,152,1658,313,253,161
3967,levle2_110.jpg,fore,Unspecified,0.0,0,1306,244,1428,374,122,130
3968,levle2_110.jpg,fore,Unspecified,0.0,0,1014,91,1114,244,100,153
3969,levle2_110.jpg,fore,Unspecified,0.0,0,769,160,930,274,161,114
3970,levle2_110.jpg,fore,Unspecified,0.0,0,892,842,953,964,61,122
3971,levle2_110.jpg,fore,Unspecified,0.0,0,999,780,1152,926,153,146
3972,levle2_110.jpg,fore,Unspecified,0.0,0,1696,213,1796,412,100,199
3973,levle2_110.jpg,fore,Unspecified,0.0,0,1765,290,1865,389,100,99
3974,levle2_110.jpg,fore,Unspecified,0.0,0,1850,175,2079,382,229,207
3975,levle2_110.jpg,fore,Unspecified,0.0,0,2547,1838,2693,1991,146,153
3976,levle2_110.jpg,fore,Unspecified,0.0,0,2432,1930,2547,2106,115,176
3977,levle2_110.jpg,fore,Unspecified,0.0,0,2593,2052,2754,2236,161,184
3978,levle2_110.jpg,fore,Unspecified,0.0,0,2945,2075,3022,2175,77,100
3979,levle2_110.jpg,fore,Unspecified,0.0,0,2861,2167,3007,2305,146,138
3980,levle2_110.jpg,fore,Unspecified,0.0,0,2624,2405,2723,2512,99,107
3981,levle2_110.jpg,fore,Unspecified,0.0,0,2585,2543,2708,2658,123,115
3982,levle2_110.jpg,fore,Unspecified,0.0,0,2739,2627,2907,2765,168,138
3983,levle2_110.jpg,fore,Unspecified,0.0,0,1773,2121,2049,2336,276,215
3984,levle2_110.jpg,fore,Unspecified,0.0,0,2049,2681,2164,2811,115,130
3985,levle2_110.jpg,fore,Unspecified,0.0,0,1972,2596,2041,2650,69,54
3986,levle2_110.jpg,fore,Unspecified,0.0,0,2141,2826,2294,2903,153,77
3987,levle2_110.jpg,fore,Unspecified,0.0,0,1719,3025,1880,3179,161,154
3988,levle2_110.jpg,fore,Unspecified,0.0,0,1949,2895,2133,3025,184,130
3989,levle2_110.jpg,fore,Unspecified,0.0,0,2148,3064,2325,3163,177,99
3990,levle2_110.jpg,fore,Unspecified,0.0,0,2570,2819,2746,2941,176,122
3991,levle2_138.jpg,fore,Unspecified,0.0,0,2263,1730,2340,1830,77,100
3992,levle2_138.jpg,fore,Unspecified,0.0,0,2624,1600,2754,1684,130,84
3993,levle2_138.jpg,fore,Unspecified,0.0,0,2716,1707,2807,1792,91,85
3994,levle2_138.jpg,fore,Unspecified,0.0,0,2861,1723,3007,1845,146,122
3995,levle2_138.jpg,fore,Unspecified,0.0,0,2593,1707,2700,1830,107,123
3996,levle2_138.jpg,fore,Unspecified,0.0,0,1949,1983,2041,2075,92,92
3997,levle2_138.jpg,fore,Unspecified,0.0,0,1919,2098,2018,2198,99,100
3998,levle2_138.jpg,fore,Unspecified,0.0,0,2470,1807,2585,1945,115,138
3999,levle2_138.jpg,fore,Unspecified,0.0,0,2677,1922,2792,2029,115,107
4000,levle2_138.jpg,fore,Unspecified,0.0,0,2386,2190,2539,2336,153,146
4001,levle2_138.jpg,fore,Unspecified,0.0,0,2447,2389,2570,2520,123,131
4002,levle2_138.jpg,fore,Unspecified,0.0,0,2355,2566,2463,2658,108,92
4003,levle2_138.jpg,fore,Unspecified,0.0,0,2248,2650,2378,2765,130,115
4004,levle2_138.jpg,fore,Unspecified,0.0,0,2133,2596,2225,2719,92,123
4005,levle2_138.jpg,fore,Unspecified,0.0,0,2378,2780,2555,2888,177,108
4006,levle2_138.jpg,fore,Unspecified,0.0,0,2225,2788,2340,2888,115,100
4007,levle2_138.jpg,fore,Unspecified,0.0,0,2202,2911,2294,3056,92,145
4008,levle2_138.jpg,fore,Unspecified,0.0,0,2348,2979,2539,3094,191,115
4009,levle2_138.jpg,fore,Unspecified,0.0,0,2616,2604,2716,2711,100,107
4010,levle2_138.jpg,fore,Unspecified,0.0,0,2470,2642,2555,2780,85,138
4011,levle2_138.jpg,fore,Unspecified,0.0,0,2807,2635,2907,2773,100,138
4012,levle2_138.jpg,fore,Unspecified,0.0,0,2777,2412,2853,2527,76,115
4013,levle2_138.jpg,fore,Unspecified,0.0,0,2861,2290,3007,2451,146,161
4014,levle2_138.jpg,fore,Unspecified,0.0,0,2999,2351,3091,2451,92,100
4015,levle2_138.jpg,fore,Unspecified,0.0,0,2807,1232,2907,1355,100,123
4016,levle1_560.jpg,fore,Unspecified,0.0,0,1681,443,1765,589,84,146
4017,levle1_560.jpg,fore,Unspecified,0.0,0,409,1378,562,1531,153,153
4018,levle1_560.jpg,fore,Unspecified,0.0,0,593,2206,715,2374,122,168
4019,levle1_560.jpg,fore,Unspecified,0.0,0,570,2382,639,2481,69,99
4020,levle1_560.jpg,fore,Unspecified,0.0,0,692,2451,853,2566,161,115
4021,levle1_560.jpg,fore,Unspecified,0.0,0,348,2397,455,2520,107,123
4022,levle1_560.jpg,fore,Unspecified,0.0,0,118,2343,279,2512,161,169
4023,levle1_36.jpg,fore,Unspecified,0.0,0,1283,2351,1397,2466,114,115
4024,levle1_36.jpg,fore,Unspecified,0.0,0,1497,2313,1612,2535,115,222
4025,levle1_36.jpg,fore,Unspecified,0.0,0,1627,2589,1804,2773,177,184
4026,levle1_36.jpg,fore,Unspecified,0.0,0,1788,2175,1903,2328,115,153
4027,levle1_36.jpg,fore,Unspecified,0.0,0,1957,2251,2064,2428,107,177
4028,levle1_36.jpg,fore,Unspecified,0.0,0,2133,2037,2271,2221,138,184
4029,levle1_36.jpg,fore,Unspecified,0.0,0,1988,1899,2110,2083,122,184
4030,levle1_36.jpg,fore,Unspecified,0.0,0,692,1087,899,1263,207,176
4031,levle1_206.jpg,fore,Unspecified,0.0,0,1505,2458,1620,2520,115,62
4032,levle1_206.jpg,fore,Unspecified,0.0,0,1712,2428,1827,2512,115,84
4033,levle1_206.jpg,fore,Unspecified,0.0,0,2125,2213,2256,2374,131,161
4034,levle1_206.jpg,fore,Unspecified,0.0,0,2057,2681,2225,2796,168,115
4035,levle1_206.jpg,fore,Unspecified,0.0,0,1635,2727,1712,2811,77,84
4036,levle1_206.jpg,fore,Unspecified,0.0,0,1880,2780,2011,2849,131,69
4037,levle1_212.jpg,fore,Unspecified,0.0,0,363,2144,501,2313,138,169
4038,levle1_212.jpg,fore,Unspecified,0.0,0,639,2236,861,2420,222,184
4039,levle1_212.jpg,fore,Unspecified,0.0,0,87,2612,263,2796,176,184
4040,levle1_212.jpg,fore,Unspecified,0.0,0,823,2803,892,2972,69,169
4041,levle1_212.jpg,fore,Unspecified,0.0,0,1037,2872,1183,3018,146,146
4042,levle1_212.jpg,fore,Unspecified,0.0,0,1198,2742,1329,2849,131,107
4043,levle1_212.jpg,fore,Unspecified,0.0,0,1558,2435,1696,2566,138,131
4044,levle1_212.jpg,fore,Unspecified,0.0,0,1175,2926,1321,3041,146,115
4045,levle1_212.jpg,fore,Unspecified,0.0,0,930,3125,1068,3286,138,161
4046,levle1_212.jpg,fore,Unspecified,0.0,0,1329,3286,1482,3432,153,146
4047,levle1_574.jpg,fore,Unspecified,0.0,0,1313,1539,1436,1677,123,138
4048,levle1_574.jpg,fore,Unspecified,0.0,0,1505,1278,1681,1424,176,146
4049,levle1_574.jpg,fore,Unspecified,0.0,0,1168,1447,1336,1592,168,145
4050,levle1_574.jpg,fore,Unspecified,0.0,0,1037,1554,1298,1769,261,215
4051,levle1_574.jpg,fore,Unspecified,0.0,0,685,1700,838,1876,153,176
4052,levle1_574.jpg,fore,Unspecified,0.0,0,999,2022,1129,2206,130,184
4053,levle1_574.jpg,fore,Unspecified,0.0,0,386,2765,509,2895,123,130
4054,levle1_22.jpg,fore,Unspecified,0.0,0,846,1968,930,2098,84,130
4055,levle1_22.jpg,fore,Unspecified,0.0,0,984,1945,1099,2037,115,92
4056,levle1_22.jpg,fore,Unspecified,0.0,0,1206,2098,1344,2213,138,115
4057,levle1_22.jpg,fore,Unspecified,0.0,0,1566,2504,1681,2589,115,85
4058,levle1_22.jpg,fore,Unspecified,0.0,0,1696,2374,1804,2466,108,92
4059,levle1_22.jpg,fore,Unspecified,0.0,0,1811,2206,1965,2313,154,107
4060,levle1_22.jpg,fore,Unspecified,0.0,0,1321,2489,1489,2665,168,176
4061,levle1_548.jpg,fore,Unspecified,0.0,0,685,1010,792,1133,107,123
4062,levle1_548.jpg,fore,Unspecified,0.0,0,869,1217,999,1332,130,115
4063,levle1_548.jpg,fore,Unspecified,0.0,0,608,1163,792,1286,184,123
4064,levle1_548.jpg,fore,Unspecified,0.0,0,1229,1922,1336,2068,107,146
4065,levle1_548.jpg,fore,Unspecified,0.0,0,1482,1968,1558,2075,76,107
4066,levle1_548.jpg,fore,Unspecified,0.0,0,1543,1868,1696,1999,153,131
4067,levle1_548.jpg,fore,Unspecified,0.0,0,1942,1838,2079,1991,137,153
4068,levle1_548.jpg,fore,Unspecified,0.0,0,1451,1677,1574,1822,123,145
4069,levle3_3.jpg,fore,,,0,268,63,330,112,62,49
4070,levle3_3.jpg,fore,,,0,309,279,358,317,49,38
4071,levle3_3.jpg,fore,,,0,344,321,379,366,35,45
4072,levle3_3.jpg,fore,,,0,421,219,459,260,38,41
4073,levle3_3.jpg,fore,,,0,290,496,332,545,42,49
4074,levle3_3.jpg,fore,,,0,186,575,216,600,30,25
4075,levle3_3.jpg,fore,,,0,157,549,190,580,33,31
4076,levle3_3.jpg,fore,,,0,179,84,231,124,52,40
4077,levle3_3.jpg,fore,,,0,226,175,269,205,43,30
4078,levle3_3.jpg,fore,,,0,153,242,186,269,33,27
4079,levle3_3.jpg,fore,,,0,180,260,222,298,42,38
4080,levle3_3.jpg,fore,,,0,216,265,263,300,47,35
4081,levle3_3.jpg,fore,,,0,271,219,310,263,39,44
4082,levle3_3.jpg,fore,,,0,376,199,410,246,34,47
4083,levle3_3.jpg,fore,,,0,232,297,268,326,36,29
4084,levle3_3.jpg,fore,,,0,217,318,255,357,38,39
4085,levle3_3.jpg,fore,,,0,246,329,294,364,48,35
4086,levle3_3.jpg,fore,,,0,141,321,173,343,32,22
4087,levle3_3.jpg,fore,,,0,228,358,268,390,40,32
4088,levle3_3.jpg,fore,,,0,269,381,309,416,40,35
4089,levle3_3.jpg,fore,,,0,254,416,289,445,35,29
4090,levle3_3.jpg,fore,,,0,269,441,309,474,40,33
4091,levle3_3.jpg,fore,,,0,323,366,365,410,42,44
4092,levle3_3.jpg,fore,,,0,298,341,335,366,37,25
4093,levle3_3.jpg,fore,,,0,396,294,424,323,28,29
4094,levle3_3.jpg,fore,,,0,387,324,428,355,41,31
4095,levle3_3.jpg,fore,,,0,372,367,401,402,29,35
4096,levle3_3.jpg,fore,,,0,395,352,417,384,22,32
4097,levle3_3.jpg,fore,,,0,417,279,453,308,36,29
4098,levle3_3.jpg,fore,,,0,445,324,480,372,35,48
4099,levle3_3.jpg,fore,,,0,388,418,463,474,75,56
4100,levle3_3.jpg,fore,,,0,175,431,207,462,32,31
4101,levle3_3.jpg,fore,,,0,130,439,155,466,25,27
4102,levle3_3.jpg,fore,,,0,131,408,155,435,24,27
4103,levle3_3.jpg,fore,,,0,165,489,194,513,29,24
4104,levle3_3.jpg,fore,,,0,121,558,155,585,34,27
4105,levle3_3.jpg,fore,,,0,268,480,292,503,24,23
4106,levle3_3.jpg,fore,,,0,251,496,277,522,26,26
4107,levle3_3.jpg,fore,,,0,272,509,294,536,22,27
4108,levle3_3.jpg,fore,,,0,341,470,368,495,27,25
4109,levle3_3.jpg,fore,,,0,326,440,368,470,42,30
4110,levle3_3.jpg,fore,,,0,343,410,375,449,32,39
4111,levle3_3.jpg,fore,,,0,321,411,351,438,30,27
4112,levle3_3.jpg,fore,,,0,230,403,260,432,30,29
4113,levle3_3.jpg,fore,,,0,201,356,223,377,22,21
4114,levle3_3.jpg,fore,,,0,280,167,308,192,28,25
4115,levle3_3.jpg,fore,,,0,414,476,442,507,28,31
4116,levle3_3.jpg,fore,,,0,327,500,355,531,28,31
4117,levle3_3.jpg,fore,,,0,347,516,375,541,28,25
4118,levle3_3.jpg,fore,,,0,174,347,198,369,24,22
4119,levle3_3.jpg,fore,,,0,332,239,360,271,28,32
4120,levle3_3.jpg,fore,,,0,422,253,450,277,28,24
4121,levle3_3.jpg,fore,,,0,317,208,342,234,25,26
4122,levle3_3.jpg,fore,,,0,355,279,380,313,25,34
4123,levle3_3.jpg,fore,,,0,247,460,270,487,23,27
4124,levle3_3.jpg,fore,,,0,219,489,241,506,22,17
4125,levle3_3.jpg,fore,,,0,431,371,468,392,37,21
4126,levle3_3.jpg,fore,,,0,421,385,448,410,27,25
4127,levle3_115.jpg,fore,,,0,1566,1117,1658,1217,92,100
4128,levle3_115.jpg,fore,,,0,1696,1186,1819,1347,123,161
4129,levle3_115.jpg,fore,,,0,1627,1248,1742,1386,115,138
4130,levle3_115.jpg,fore,,,0,1658,1355,1735,1493,77,138
4131,levle3_115.jpg,fore,,,0,1804,1378,1880,1501,76,123
4132,levle3_115.jpg,fore,,,0,1972,1286,2087,1439,115,153
4133,levle3_115.jpg,fore,,,0,1880,1478,1949,1577,69,99
4134,levle3_115.jpg,fore,,,0,1390,1562,1474,1654,84,92
4135,levle3_115.jpg,fore,,,0,1535,1669,1627,1753,92,84
4136,levle3_115.jpg,fore,,,0,1405,1700,1489,1807,84,107
4137,levle3_115.jpg,fore,,,0,1466,1784,1597,1930,131,146
4138,levle3_115.jpg,fore,,,0,1244,1753,1405,1930,161,177
4139,levle3_115.jpg,fore,,,0,1007,1669,1175,1853,168,184
4140,levle3_115.jpg,fore,,,0,945,1677,1068,1830,123,153
4141,levle3_115.jpg,fore,,,0,1129,1968,1237,2068,108,100
4142,levle3_115.jpg,fore,,,0,1252,1960,1390,2114,138,154
4143,levle3_115.jpg,fore,,,0,1413,1968,1566,2106,153,138
4144,levle3_115.jpg,fore,,,0,1397,2121,1489,2244,92,123
4145,levle3_115.jpg,fore,,,0,1168,2160,1283,2244,115,84
4146,levle3_115.jpg,fore,,,0,1030,2075,1183,2213,153,138
4147,levle3_115.jpg,fore,,,0,1597,1861,1712,1968,115,107
4148,levle3_115.jpg,fore,,,0,1650,1914,1765,2083,115,169
4149,levle3_115.jpg,fore,,,0,1796,1899,1919,2068,123,169
4150,levle3_115.jpg,fore,,,0,1528,2083,1627,2198,99,115
4151,levle3_115.jpg,fore,,,0,1612,2175,1696,2313,84,138
4152,levle3_115.jpg,fore,,,0,1520,2320,1650,2489,130,169
4153,levle3_115.jpg,fore,,,0,1397,2359,1528,2504,131,145
4154,levle3_115.jpg,fore,,,0,1306,2366,1436,2527,130,161
4155,levle3_115.jpg,fore,,,0,1160,2267,1298,2466,138,199
4156,levle3_115.jpg,fore,,,0,1344,2566,1466,2773,122,207
4157,levle3_115.jpg,fore,,,0,1505,2497,1643,2665,138,168
4158,levle3_115.jpg,fore,,,0,1604,2619,1712,2780,108,161
4159,levle3_115.jpg,fore,,,0,1643,2508,1750,2598,107,90
4160,levle3_115.jpg,fore,,,0,1057,2567,1157,2657,100,90
4161,levle3_115.jpg,fore,,,0,1022,2832,1112,2908,90,76
4162,levle3_115.jpg,fore,,,0,1164,2884,1288,2977,124,93
4163,levle3_115.jpg,fore,,,0,1208,2574,1329,2667,121,93
4164,levle3_115.jpg,fore,,,0,1243,2453,1326,2553,83,100
4165,levle3_115.jpg,fore,,,0,1029,2239,1143,2350,114,111
4166,levle3_115.jpg,fore,,,0,967,2143,1074,2253,107,110
4167,levle3_115.jpg,fore,,,0,984,1974,1102,2088,118,114
4168,levle3_115.jpg,fore,,,0,1740,1736,1850,1846,110,110
4169,levle3_115.jpg,fore,,,0,1798,1250,1933,1381,135,131
4170,levle3_115.jpg,fore,,,0,971,1822,1091,1953,120,131
4171,levle3_115.jpg,fore,,,0,1184,1684,1308,1798,124,114
4172,levle3_115.jpg,fore,,,0,1415,1874,1529,1991,114,117
4173,levle3_115.jpg,fore,,,0,1360,2257,1519,2360,159,103
4174,levle3_115.jpg,fore,,,0,1108,2419,1229,2505,121,86
4175,levle3_115.jpg,fore,,,0,974,2612,1088,2712,114,100
4176,levle3_115.jpg,fore,,,0,2022,1881,2140,2032,118,151
4177,levle3_115.jpg,fore,,,0,2095,2167,2208,2288,113,121
4178,levle3_115.jpg,fore,,,0,1960,2036,2102,2167,142,131
4179,levle3_115.jpg,fore,,,0,1815,2112,1922,2246,107,134
4180,levle3_115.jpg,fore,,,0,1871,2063,1974,2184,103,121
4181,levle3_115.jpg,fore,,,0,1840,1557,1957,1667,117,110
4182,levle3_115.jpg,fore,,,0,1719,1112,1833,1212,114,100
4183,levle3_115.jpg,fore,,,0,1608,1074,1708,1184,100,110
4184,levle3_115.jpg,fore,,,0,1871,1198,1971,1284,100,86
4185,levle3_115.jpg,fore,,,0,1933,1136,2036,1239,103,103
4186,levle3_115.jpg,fore,,,0,2019,1112,2136,1229,117,117
4187,levle3_115.jpg,fore,,,0,1381,2484,1498,2584,117,100
4188,levle3_115.jpg,fore,,,0,867,1943,991,2046,124,103
4189,levle3_115.jpg,fore,,,0,1974,1546,2074,1660,100,114
4190,levle3_115.jpg,fore,,,0,1684,1846,1802,1946,118,100
4191,levle3_115.jpg,fore,,,0,2064,1563,2153,1705,89,142
4192,levle3_101.jpg,fore,,,0,1177,639,1218,685,41,46
4193,levle3_101.jpg,fore,,,0,1113,636,1167,677,54,41
4194,levle3_101.jpg,fore,,,0,1039,737,1091,764,52,27
4195,levle3_101.jpg,fore,,,0,988,783,1042,810,54,27
4196,levle3_101.jpg,fore,,,0,1012,804,1050,848,38,44
4197,levle3_101.jpg,fore,,,0,893,761,966,810,73,49
4198,levle3_101.jpg,fore,,,0,937,807,969,826,32,19
4199,levle3_101.jpg,fore,,,0,937,831,985,864,48,33
4200,levle3_101.jpg,fore,,,0,855,812,904,842,49,30
4201,levle3_101.jpg,fore,,,0,823,777,877,820,54,43
4202,levle3_101.jpg,fore,,,0,758,818,793,856,35,38
4203,levle3_101.jpg,fore,,,0,782,877,826,910,44,33
4204,levle3_101.jpg,fore,,,0,815,818,885,885,70,67
4205,levle3_101.jpg,fore,,,0,744,940,820,999,76,59
4206,levle3_101.jpg,fore,,,0,850,907,882,931,32,24
4207,levle3_101.jpg,fore,,,0,901,864,961,921,60,57
4208,levle3_101.jpg,fore,,,0,966,880,985,918,19,38
4209,levle3_101.jpg,fore,,,0,991,899,1045,953,54,54
4210,levle3_101.jpg,fore,,,0,761,615,826,661,65,46
4211,levle3_101.jpg,fore,,,0,866,931,915,956,49,25
4212,levle3_101.jpg,fore,,,0,1077,820,1115,858,38,38
4213,levle3_101.jpg,fore,,,0,1034,869,1083,921,49,52
4214,levle3_101.jpg,fore,,,0,636,590,685,626,49,36
4215,levle3_101.jpg,fore,,,0,631,525,666,588,35,63
4216,levle3_101.jpg,fore,,,0,677,539,731,582,54,43
4217,levle3_101.jpg,fore,,,0,533,515,585,582,52,67
4218,levle3_101.jpg,fore,,,0,742,276,777,322,35,46
4219,levle3_101.jpg,fore,,,0,631,163,685,217,54,54
4220,levle3_101.jpg,fore,,,0,644,81,687,130,43,49
4221,levle3_101.jpg,fore,,,0,574,136,612,176,38,40
4222,levle3_101.jpg,fore,,,0,530,79,571,108,41,29
4223,levle3_101.jpg,fore,,,0,834,658,866,712,32,54
4224,levle3_101.jpg,fore,,,0,766,533,839,612,73,79
4225,levle3_101.jpg,fore,,,0,701,455,752,523,51,68
4226,levle3_101.jpg,fore,,,0,1099,699,1140,739,41,40
4227,levle3_101.jpg,fore,,,0,828,964,863,1024,35,60
4228,levle3_101.jpg,fore,,,0,1272,634,1321,677,49,43
4229,levle3_101.jpg,fore,,,0,1226,691,1272,747,46,56
4230,levle3_101.jpg,fore,,,0,1340,680,1389,737,49,57
4231,levle3_101.jpg,fore,,,0,1359,650,1421,685,62,35
4232,levle3_101.jpg,fore,,,0,1140,826,1188,896,48,70
4233,levle3_101.jpg,fore,,,0,1196,799,1253,850,57,51
4234,levle3_101.jpg,fore,,,0,1256,785,1305,875,49,90
4235,levle3_101.jpg,fore,,,0,1253,737,1294,780,41,43
4236,levle3_101.jpg,fore,,,0,1218,896,1283,956,65,60
4237,levle3_101.jpg,fore,,,0,1169,923,1224,975,55,52
4238,levle3_101.jpg,fore,,,0,1056,768,1112,809,56,41
4239,levle3_101.jpg,fore,,,0,1100,942,1143,986,43,44
4240,levle3_101.jpg,fore,,,0,898,1057,947,1092,49,35
4241,levle3_101.jpg,fore,,,0,652,673,694,706,42,33
4242,levle3_101.jpg,fore,,,0,783,403,837,448,54,45
4243,levle3_101.jpg,fore,,,0,958,659,1005,703,47,44
4244,levle3_101.jpg,fore,,,0,984,744,1037,785,53,41
4245,levle3_101.jpg,fore,,,0,1312,790,1358,863,46,73
4246,levle3_101.jpg,fore,,,0,788,786,833,830,45,44
4247,levle3_101.jpg,fore,,,0,803,492,867,528,64,36
4248,levle3_129.jpg,fore,,,0,424,121,495,177,71,56
4249,levle3_129.jpg,fore,,,0,492,106,540,147,48,41
4250,levle3_129.jpg,fore,,,0,533,4,580,50,47,46
4251,levle3_129.jpg,fore,,,0,722,131,756,167,34,36
4252,levle3_129.jpg,fore,,,0,332,402,380,454,48,52
4253,levle3_129.jpg,fore,,,0,325,478,378,512,53,34
4254,levle3_129.jpg,fore,,,0,339,519,385,562,46,43
4255,levle3_129.jpg,fore,,,0,293,509,350,542,57,33
4256,levle3_129.jpg,fore,,,0,238,494,286,532,48,38
4257,levle3_129.jpg,fore,,,0,230,413,272,459,42,46
4258,levle3_129.jpg,fore,,,0,194,454,235,496,41,42
4259,levle3_129.jpg,fore,,,0,240,547,286,581,46,34
4260,levle3_129.jpg,fore,,,0,396,615,446,659,50,44
4261,levle3_129.jpg,fore,,,0,481,594,518,636,37,42
4262,levle3_129.jpg,fore,,,0,389,648,430,695,41,47
4263,levle3_129.jpg,fore,,,0,336,677,387,726,51,49
4264,levle3_129.jpg,fore,,,0,111,652,155,705,44,53
4265,levle3_129.jpg,fore,,,0,205,712,254,746,49,34
4266,levle3_129.jpg,fore,,,0,295,725,331,758,36,33
4267,levle3_129.jpg,fore,,,0,247,725,290,771,43,46
4268,levle3_129.jpg,fore,,,0,610,89,653,138,43,49
4269,levle3_129.jpg,fore,,,0,486,51,527,99,41,48
4270,levle3_129.jpg,fore,,,0,586,64,618,106,32,42
4271,levle3_129.jpg,fore,,,0,373,234,416,262,43,28
4272,levle3_129.jpg,fore,,,0,240,289,279,337,39,48
4273,levle3_129.jpg,fore,,,0,258,225,293,262,35,37
4274,levle3_129.jpg,fore,,,0,281,384,318,427,37,43
4275,levle3_129.jpg,fore,,,0,410,436,449,471,39,35
4276,levle3_129.jpg,fore,,,0,471,489,511,526,40,37
4277,levle3_129.jpg,fore,,,0,453,544,481,567,28,23
4278,levle3_129.jpg,fore,,,0,251,592,288,625,37,33
4279,levle3_129.jpg,fore,,,0,338,578,378,631,40,53
4280,levle3_129.jpg,fore,,,0,359,723,378,762,19,39
4281,levle3_129.jpg,fore,,,0,504,693,534,719,30,26
4282,levle3_129.jpg,fore,,,0,165,655,196,692,31,37
4283,levle3_129.jpg,fore,,,0,154,695,187,732,33,37
4284,levle3_129.jpg,fore,,,0,288,674,324,700,36,26
4285,levle3_129.jpg,fore,,,0,290,555,311,577,21,22
4286,levle3_129.jpg,fore,,,0,304,565,331,588,27,23
4287,levle3_129.jpg,fore,,,0,266,447,296,473,30,26
4288,levle3_129.jpg,fore,,,0,315,374,342,402,27,28
4289,levle3_129.jpg,fore,,,0,162,354,191,381,29,27
4290,levle3_129.jpg,fore,,,0,316,215,344,245,28,30
4291,levle3_129.jpg,fore,,,0,330,157,365,188,35,31
4292,levle3_129.jpg,fore,,,0,776,166,801,201,25,35
4293,levle3_129.jpg,fore,,,0,775,209,801,243,26,34
4294,levle3_129.jpg,fore,,,0,548,178,581,205,33,27
4295,levle3_129.jpg,fore,,,0,414,713,471,749,57,36
4296,levle3_129.jpg,fore,,,0,350,750,409,789,59,39
4297,levle3_129.jpg,fore,,,0,305,780,351,799,46,19
4298,levle3_129.jpg,fore,,,0,258,776,287,799,29,23
4299,levle3_129.jpg,fore,,,0,280,762,310,789,30,27
4300,levle3_129.jpg,fore,,,0,327,632,355,664,28,32
4301,levle3_129.jpg,fore,,,0,292,604,323,628,31,24
4302,levle3_129.jpg,fore,,,0,643,458,677,488,34,30
4303,levle3_129.jpg,fore,,,0,117,392,158,427,41,35
4304,levle3_129.jpg,fore,,,0,128,628,160,654,32,26
4305,levle3_129.jpg,fore,,,0,381,617,415,647,34,30
4306,levle3_129.jpg,fore,,,0,385,463,416,491,31,28
4307,levle3_129.jpg,fore,,,0,406,682,458,720,52,38
4308,levle3_129.jpg,fore,,,0,562,582,592,607,30,25
4309,levle3_128.jpg,fore,,,0,84,12,99,20,15,8
4310,levle3_128.jpg,fore,,,0,78,20,90,27,12,7
4311,levle3_128.jpg,fore,,,0,96,20,111,29,15,9
4312,levle3_128.jpg,fore,,,0,76,41,83,49,7,8
4313,levle3_128.jpg,fore,,,0,82,41,105,57,23,16
4314,levle3_128.jpg,fore,,,0,47,33,63,43,16,10
4315,levle3_128.jpg,fore,,,0,57,24,72,34,15,10
4316,levle3_128.jpg,fore,,,0,50,66,60,78,10,12
4317,levle3_128.jpg,fore,,,0,76,55,95,67,19,12
4318,levle3_128.jpg,fore,,,0,73,68,89,80,16,12
4319,levle3_128.jpg,fore,,,0,74,81,97,92,23,11
4320,levle3_128.jpg,fore,,,0,39,81,52,96,13,15
4321,levle3_128.jpg,fore,,,0,57,95,73,102,16,7
4322,levle3_128.jpg,fore,,,0,50,103,62,114,12,11
4323,levle3_128.jpg,fore,,,0,60,107,72,113,12,6
4324,levle3_128.jpg,fore,,,0,18,133,29,144,11,11
4325,levle3_128.jpg,fore,,,0,40,131,45,139,5,8
4326,levle3_128.jpg,fore,,,0,49,128,57,142,8,14
4327,levle3_128.jpg,fore,,,0,41,141,60,153,19,12
4328,levle3_128.jpg,fore,,,0,48,155,59,167,11,12
4329,levle3_128.jpg,fore,,,0,66,125,82,139,16,14
4330,levle3_128.jpg,fore,,,0,78,119,89,132,11,13
4331,levle3_128.jpg,fore,,,0,58,135,75,151,17,16
4332,levle3_128.jpg,fore,,,0,77,140,86,149,9,9
4333,levle3_128.jpg,fore,,,0,66,154,78,167,12,13
4334,levle3_128.jpg,fore,,,0,76,157,84,166,8,9
4335,levle3_128.jpg,fore,,,0,107,153,117,168,10,15
4336,levle3_128.jpg,fore,,,0,105,168,114,181,9,13
4337,levle3_128.jpg,fore,,,0,94,177,108,191,14,14
4338,levle3_128.jpg,fore,,,0,100,190,107,199,7,9
4339,levle3_128.jpg,fore,,,0,75,192,84,203,9,11
4340,levle3_128.jpg,fore,,,0,92,202,103,213,11,11
4341,levle3_128.jpg,fore,,,0,109,200,119,207,10,7
4342,levle3_128.jpg,fore,,,0,134,220,143,225,9,5
4343,levle3_128.jpg,fore,,,0,113,209,119,221,6,12
4344,levle3_128.jpg,fore,,,0,126,228,136,237,10,9
4345,levle3_128.jpg,fore,,,0,122,186,140,204,18,18
4346,levle3_128.jpg,fore,,,0,91,112,101,122,10,10
4347,levle3_128.jpg,fore,,,0,132,117,141,127,9,10
4348,levle3_128.jpg,fore,,,0,146,115,157,128,11,13
4349,levle3_128.jpg,fore,,,0,102,136,110,145,8,9
4350,levle3_128.jpg,fore,,,0,93,156,105,165,12,9
4351,levle3_128.jpg,fore,,,0,85,154,95,165,10,11
4352,levle3_128.jpg,fore,,,0,89,145,100,155,11,10
4353,levle3_128.jpg,fore,,,0,76,99,84,107,8,8
4354,levle3_128.jpg,fore,,,0,95,30,105,41,10,11
4355,levle3_128.jpg,fore,,,0,74,177,86,186,12,9
4356,levle3_128.jpg,fore,,,0,83,179,94,189,11,10
4357,levle3_128.jpg,fore,,,0,128,156,140,165,12,9
4358,levle3_128.jpg,fore,,,0,122,140,130,148,8,8
4359,levle3_128.jpg,fore,,,0,111,137,122,146,11,9
4360,levle3_128.jpg,fore,,,0,125,146,133,155,8,9
4361,levle3_128.jpg,fore,,,0,123,128,132,136,9,8
4362,levle3_128.jpg,fore,,,0,41,122,51,129,10,7
4363,levle3_100.jpg,fore,,,0,172,69,201,98,29,29
4364,levle3_100.jpg,fore,,,0,187,104,218,136,31,32
4365,levle3_100.jpg,fore,,,0,233,93,254,129,21,36
4366,levle3_100.jpg,fore,,,0,216,135,237,159,21,24
4367,levle3_100.jpg,fore,,,0,250,142,271,170,21,28
4368,levle3_100.jpg,fore,,,0,268,126,289,153,21,27
4369,levle3_100.jpg,fore,,,0,270,92,279,118,9,26
4370,levle3_100.jpg,fore,,,0,273,92,296,112,23,20
4371,levle3_100.jpg,fore,,,0,149,147,170,170,21,23
4372,levle3_100.jpg,fore,,,0,153,170,173,191,20,21
4373,levle3_100.jpg,fore,,,0,130,173,153,204,23,31
4374,levle3_100.jpg,fore,,,0,112,167,135,199,23,32
4375,levle3_100.jpg,fore,,,0,293,205,319,242,26,37
4376,levle3_100.jpg,fore,,,0,92,194,132,236,40,42
4377,levle3_100.jpg,fore,,,0,48,179,80,207,32,28
4378,levle3_100.jpg,fore,,,0,58,205,89,225,31,20
4379,levle3_100.jpg,fore,,,0,72,223,103,248,31,25
4380,levle3_100.jpg,fore,,,0,106,262,124,280,18,18
4381,levle3_100.jpg,fore,,,0,66,256,89,279,23,23
4382,levle3_100.jpg,fore,,,0,77,266,120,292,43,26
4383,levle3_100.jpg,fore,,,0,51,285,81,314,30,29
4384,levle3_100.jpg,fore,,,0,43,302,78,332,35,30
4385,levle3_100.jpg,fore,,,0,89,291,109,314,20,23
4386,levle3_100.jpg,fore,,,0,91,312,120,331,29,19
4387,levle3_100.jpg,fore,,,0,71,334,106,352,35,18
4388,levle3_100.jpg,fore,,,0,49,381,89,406,40,25
4389,levle3_100.jpg,fore,,,0,84,415,106,432,22,17
4390,levle3_100.jpg,fore,,,0,112,376,144,402,32,26
4391,levle3_100.jpg,fore,,,0,112,401,138,419,26,18
4392,levle3_100.jpg,fore,,,0,112,428,135,447,23,19
4393,levle3_100.jpg,fore,,,0,114,464,146,488,32,24
4394,levle3_100.jpg,fore,,,0,123,487,150,516,27,29
4395,levle3_100.jpg,fore,,,0,150,484,181,526,31,42
4396,levle3_100.jpg,fore,,,0,189,390,224,412,35,22
4397,levle3_100.jpg,fore,,,0,201,413,218,432,17,19
4398,levle3_100.jpg,fore,,,0,236,412,273,427,37,15
4399,levle3_100.jpg,fore,,,0,219,424,245,450,26,26
4400,levle3_100.jpg,fore,,,0,156,427,178,447,22,20
4401,levle3_100.jpg,fore,,,0,166,456,184,474,18,18
4402,levle3_100.jpg,fore,,,0,213,464,239,493,26,29
4403,levle3_100.jpg,fore,,,0,323,507,340,531,17,24
4404,levle3_100.jpg,fore,,,0,296,482,329,513,33,31
4405,levle3_100.jpg,fore,,,0,185,462,211,490,26,28
4406,levle3_100.jpg,fore,,,0,193,439,219,467,26,28
4407,levle3_100.jpg,fore,,,0,222,363,248,395,26,32
4408,levle3_100.jpg,fore,,,0,166,372,210,404,44,32
4409,levle3_100.jpg,fore,,,0,169,406,201,425,32,19
4410,levle3_100.jpg,fore,,,0,80,357,107,376,27,19
4411,levle3_100.jpg,fore,,,0,280,526,299,542,19,16
4412,levle3_100.jpg,fore,,,0,253,547,272,562,19,15
4413,levle3_100.jpg,fore,,,0,189,487,215,509,26,22
4414,levle3_100.jpg,fore,,,0,129,287,151,307,22,20
4415,levle3_100.jpg,fore,,,0,179,425,198,449,19,24
4416,levle3_100.jpg,fore,,,0,267,514,284,524,17,10
4417,levle3_100.jpg,fore,,,0,267,503,285,516,18,13
4418,levle3_100.jpg,fore,,,0,264,494,282,509,18,15
4419,levle3_100.jpg,fore,,,0,39,415,68,438,29,23
4420,levle3_100.jpg,fore,,,0,142,362,167,381,25,19
4421,levle3_2.jpg,fore,,,0,479,53,507,102,28,49
4422,levle3_2.jpg,fore,,,0,430,37,450,84,20,47
4423,levle3_2.jpg,fore,,,0,354,108,407,139,53,31
4424,levle3_2.jpg,fore,,,0,373,139,393,182,20,43
4425,levle3_2.jpg,fore,,,0,419,155,485,188,66,33
4426,levle3_2.jpg,fore,,,0,364,308,389,369,25,61
4427,levle3_2.jpg,fore,,,0,138,251,177,308,39,57
4428,levle3_2.jpg,fore,,,0,160,141,217,188,57,47
4429,levle3_2.jpg,fore,,,0,191,63,232,118,41,55
4430,levle3_2.jpg,fore,,,0,230,122,273,169,43,47
4431,levle3_2.jpg,fore,,,0,113,345,166,398,53,53
4432,levle3_2.jpg,fore,,,0,28,363,58,402,30,39
4433,levle3_2.jpg,fore,,,0,122,408,162,439,40,31
4434,levle3_2.jpg,fore,,,0,38,430,91,481,53,51
4435,levle3_2.jpg,fore,,,0,254,408,297,453,43,45
4436,levle3_2.jpg,fore,,,0,191,559,236,606,45,47
4437,levle3_2.jpg,fore,,,0,254,585,301,618,47,33
4438,levle3_2.jpg,fore,,,0,346,485,379,508,33,23
4439,levle3_2.jpg,fore,,,0,271,532,311,573,40,41
4440,levle3_2.jpg,fore,,,0,334,518,368,561,34,43
4441,levle3_2.jpg,fore,,,0,364,528,413,596,49,68
4442,levle3_2.jpg,fore,,,0,511,506,544,557,33,51
4443,levle3_2.jpg,fore,,,0,379,428,424,471,45,43
4444,levle3_2.jpg,fore,,,0,381,457,438,506,57,49
4445,levle3_2.jpg,fore,,,0,391,492,440,541,49,49
4446,levle3_2.jpg,fore,,,0,450,483,489,522,39,39
4447,levle3_2.jpg,fore,,,0,464,312,503,343,39,31
4448,levle3_2.jpg,fore,,,0,495,359,536,410,41,51
4449,levle3_2.jpg,fore,,,0,560,302,617,361,57,59
4450,levle3_2.jpg,fore,,,0,562,190,615,247,53,57
4451,levle3_2.jpg,fore,,,0,328,247,368,281,40,34
4452,levle3_2.jpg,fore,,,0,95,239,107,247,12,8
4453,levle3_2.jpg,fore,,,0,69,196,103,243,34,47
4454,levle3_2.jpg,fore,,,0,38,239,85,292,47,53
4455,levle3_2.jpg,fore,,,0,81,284,122,328,41,44
4456,levle3_2.jpg,fore,,,0,197,261,231,294,34,33
4457,levle3_2.jpg,fore,,,0,223,276,250,315,27,39
4458,levle3_2.jpg,fore,,,0,225,232,258,273,33,41
4459,levle3_2.jpg,fore,,,0,270,174,307,206,37,32
4460,levle3_2.jpg,fore,,,0,253,318,287,350,34,32
4461,levle3_2.jpg,fore,,,0,201,397,225,421,24,24
4462,levle3_2.jpg,fore,,,0,176,420,202,450,26,30
4463,levle3_2.jpg,fore,,,0,101,389,127,421,26,32
4464,levle3_2.jpg,fore,,,0,83,347,124,382,41,35
4465,levle3_2.jpg,fore,,,0,47,324,80,367,33,43
4466,levle3_2.jpg,fore,,,0,436,360,474,402,38,42
4467,levle3_2.jpg,fore,,,0,493,430,519,457,26,27
4468,levle3_2.jpg,fore,,,0,503,464,532,492,29,28
4469,levle3_2.jpg,fore,,,0,561,448,584,473,23,25
4470,levle3_2.jpg,fore,,,0,605,374,629,398,24,24
4471,levle3_2.jpg,fore,,,0,606,393,633,415,27,22
4472,levle3_2.jpg,fore,,,0,204,470,237,499,33,29
4473,levle3_2.jpg,fore,,,0,153,490,178,512,25,22
4474,levle3_2.jpg,fore,,,0,228,528,250,559,22,31
4475,levle3_2.jpg,fore,,,0,265,491,321,528,56,37
4476,levle3_2.jpg,fore,,,0,167,543,186,575,19,32
4477,levle3_2.jpg,fore,,,0,1,410,20,444,19,34
4478,levle3_2.jpg,fore,,,0,141,315,174,356,33,41
4479,levle3_2.jpg,fore,,,0,96,501,144,549,48,48
4480,levle3_2.jpg,fore,,,0,96,426,132,457,36,31
4481,levle3_2.jpg,fore,,,0,139,542,168,571,29,29
4482,levle3_2.jpg,fore,,,0,161,526,191,549,30,23
4483,levle3_2.jpg,fore,,,0,220,492,260,517,40,25
4484,levle3_2.jpg,fore,,,0,465,17,494,59,29,42
4485,levle3_2.jpg,fore,,,0,504,114,545,157,41,43
4486,levle3_114.jpg,fore,,,0,2568,1354,2639,1450,71,96
4487,levle3_114.jpg,fore,,,0,2603,1257,2691,1354,88,97
4488,levle3_114.jpg,fore,,,0,2674,1239,2744,1362,70,123
4489,levle3_114.jpg,fore,,,0,2419,1617,2568,1739,149,122
4490,levle3_114.jpg,fore,,,0,2533,1661,2621,1783,88,122
4491,levle3_114.jpg,fore,,,0,2595,1853,2674,1897,79,44
4492,levle3_114.jpg,fore,,,0,2665,1853,2744,1959,79,106
4493,levle3_114.jpg,fore,,,0,2551,1932,2682,2020,131,88
4494,levle3_114.jpg,fore,,,0,2586,1994,2709,2064,123,70
4495,levle3_114.jpg,fore,,,0,2419,1889,2533,1968,114,79
4496,levle3_114.jpg,fore,,,0,2507,2046,2621,2143,114,97
4497,levle3_114.jpg,fore,,,0,2472,2108,2603,2248,131,140
4498,levle3_114.jpg,fore,,,0,2595,2020,2770,2178,175,158
4499,levle3_114.jpg,fore,,,0,2507,2239,2647,2353,140,114
4500,levle3_114.jpg,fore,,,0,2454,2275,2551,2389,97,114
4501,levle3_114.jpg,fore,,,0,2323,2117,2463,2231,140,114
4502,levle3_114.jpg,fore,,,0,1805,2292,1928,2424,123,132
4503,levle3_114.jpg,fore,,,0,1981,2239,2121,2353,140,114
4504,levle3_114.jpg,fore,,,0,2112,2371,2288,2494,176,123
4505,levle3_114.jpg,fore,,,0,2139,2196,2305,2353,166,157
4506,levle3_114.jpg,fore,,,0,2305,2266,2446,2336,141,70
4507,levle3_114.jpg,fore,,,0,2288,2371,2410,2397,122,26
4508,levle3_114.jpg,fore,,,0,2647,1687,2796,1783,149,96
4509,levle3_114.jpg,fore,,,0,2761,1783,2875,1906,114,123
4510,levle3_114.jpg,fore,,,0,2349,1748,2446,1871,97,123
4511,levle3_114.jpg,fore,,,0,2446,1731,2560,1880,114,149
4512,levle3_114.jpg,fore,,,0,2314,2003,2437,2073,123,70
4513,levle3_114.jpg,fore,,,0,2410,880,2525,1073,115,193
4514,levle3_114.jpg,fore,,,0,2794,1558,2869,1638,75,80
4515,levle3_114.jpg,fore,,,0,2713,1417,2799,1481,86,64
4516,levle3_114.jpg,fore,,,0,2179,1674,2292,1758,113,84
4517,levle3_114.jpg,fore,,,0,2040,1972,2129,2033,89,61
4518,levle3_114.jpg,fore,,,0,1979,1929,2065,2001,86,72
4519,levle3_114.jpg,fore,,,0,2067,2369,2144,2431,77,62
4520,levle3_114.jpg,fore,,,0,1976,2415,2058,2463,82,48
4521,levle3_114.jpg,fore,,,0,1974,2371,2058,2419,84,48
4522,levle3_114.jpg,fore,,,0,2156,1222,2244,1315,88,93
4523,levle3_114.jpg,fore,,,0,2117,808,2192,867,75,59
4524,levle3_114.jpg,fore,,,0,2222,854,2297,908,75,54
4525,levle3_114.jpg,fore,,,0,2538,1224,2606,1301,68,77
4526,levle3_114.jpg,fore,,,0,2519,1301,2599,1369,80,68
4527,levle3_114.jpg,fore,,,0,2735,1644,2810,1706,75,62
4528,levle3_114.jpg,fore,,,0,2385,2365,2438,2424,53,59
4529,levle3_114.jpg,fore,,,0,2451,2367,2608,2431,157,64
4530,levle3_114.jpg,fore,,,0,1897,2376,1969,2449,72,73
4531,levle3_114.jpg,fore,,,0,2158,1947,2219,2010,61,63
4532,levle3_114.jpg,fore,,,0,1881,1076,1958,1147,77,71
4533,levle3_114.jpg,fore,,,0,1779,1333,1865,1419,86,86
4534,levle3_114.jpg,fore,,,0,1906,1288,1979,1367,73,79
4535,levle3_114.jpg,fore,,,0,2626,1335,2692,1419,66,84
4536,levle3_114.jpg,fore,,,0,2481,1963,2565,2044,84,81
4537,levle3_114.jpg,fore,,,0,2447,2047,2538,2142,91,95
4538,levle1_549.jpg,fore,Unspecified,0.0,0,807,1048,884,1209,77,161
4539,levle1_549.jpg,fore,Unspecified,0.0,0,670,1232,830,1439,160,207
4540,levle1_549.jpg,fore,Unspecified,0.0,0,984,1363,1137,1516,153,153
4541,levle1_549.jpg,fore,Unspecified,0.0,0,1290,1455,1397,1531,107,76
4542,levle1_549.jpg,fore,Unspecified,0.0,0,938,2014,1060,2106,122,92
4543,levle1_549.jpg,fore,Unspecified,0.0,0,1336,2098,1459,2221,123,123
4544,levle1_549.jpg,fore,Unspecified,0.0,0,1620,1930,1666,1983,46,53
4545,levle1_549.jpg,fore,Unspecified,0.0,0,1581,1853,1673,1930,92,77
4546,levle1_213.jpg,fore,Unspecified,0.0,0,2708,2229,2853,2389,145,160
4547,levle1_213.jpg,fore,Unspecified,0.0,0,2286,2604,2424,2711,138,107
4548,levle1_213.jpg,fore,Unspecified,0.0,0,2371,2780,2478,2903,107,123
4549,levle1_213.jpg,fore,Unspecified,0.0,0,2011,2865,2125,2995,114,130
4550,levle1_213.jpg,fore,Unspecified,0.0,0,2639,2911,2769,3048,130,137
4551,levle1_213.jpg,fore,Unspecified,0.0,0,2815,2926,3037,3079,222,153
4552,levle1_213.jpg,fore,Unspecified,0.0,0,2662,3194,2815,3347,153,153
4553,levle1_213.jpg,fore,Unspecified,0.0,0,2478,3018,2578,3186,100,168
4554,levle1_23.jpg,fore,Unspecified,0.0,0,1145,1907,1298,2052,153,145
4555,levle1_23.jpg,fore,Unspecified,0.0,0,869,1861,999,2029,130,168
4556,levle1_23.jpg,fore,Unspecified,0.0,0,1007,1937,1145,2137,138,200
4557,levle1_23.jpg,fore,Unspecified,0.0,0,1413,2029,1566,2175,153,146
4558,levle1_23.jpg,fore,Unspecified,0.0,0,1719,1884,1804,2006,85,122
4559,levle1_23.jpg,fore,Unspecified,0.0,0,1612,2527,1735,2627,123,100
4560,levle1_23.jpg,fore,Unspecified,0.0,0,1413,2458,1589,2573,176,115
4561,levle1_23.jpg,fore,Unspecified,0.0,0,1689,2366,1827,2550,138,184
4562,levle1_23.jpg,fore,Unspecified,0.0,0,1367,2750,1543,2888,176,138
4563,levle1_575.jpg,fore,Unspecified,0.0,0,876,2558,1076,2780,200,222
4564,levle1_575.jpg,fore,Unspecified,0.0,0,884,2152,1030,2297,146,145
4565,levle1_575.jpg,fore,Unspecified,0.0,0,1857,1884,1995,2029,138,145
4566,levle1_575.jpg,fore,Unspecified,0.0,0,1827,1746,1980,1868,153,122
4567,levle1_575.jpg,fore,Unspecified,0.0,0,1589,1738,1758,1822,169,84
4568,levle1_575.jpg,fore,Unspecified,0.0,0,1658,1524,1796,1623,138,99
4569,levle1_575.jpg,fore,Unspecified,0.0,0,1827,1615,1949,1730,122,115
4570,levle1_575.jpg,fore,Unspecified,0.0,0,1827,1455,1972,1585,145,130
4571,levle1_575.jpg,fore,Unspecified,0.0,0,1957,1301,2095,1508,138,207
4572,levle1_575.jpg,fore,Unspecified,0.0,0,1788,1271,1949,1424,161,153
4573,levle1_575.jpg,fore,Unspecified,0.0,0,2095,1378,2286,1508,191,130
4574,levle1_575.jpg,fore,Unspecified,0.0,0,2095,1248,2309,1317,214,69
4575,levle1_575.jpg,fore,Unspecified,0.0,0,2332,1194,2470,1370,138,176
4576,levle1_575.jpg,fore,Unspecified,0.0,0,2018,1018,2217,1148,199,130
4577,levle1_575.jpg,fore,Unspecified,0.0,0,2325,933,2478,1056,153,123
4578,levle1_37.jpg,fore,Unspecified,0.0,0,999,995,1145,1140,146,145
4579,levle1_37.jpg,fore,Unspecified,0.0,0,1214,2305,1344,2466,130,161
4580,levle1_37.jpg,fore,Unspecified,0.0,0,1336,2213,1474,2351,138,138
4581,levle1_37.jpg,fore,Unspecified,0.0,0,1459,2359,1604,2481,145,122
4582,levle1_37.jpg,fore,Unspecified,0.0,0,1382,2489,1505,2619,123,130
4583,levle1_37.jpg,fore,Unspecified,0.0,0,1566,2619,1696,2765,130,146
4584,levle1_37.jpg,fore,Unspecified,0.0,0,1589,2229,1689,2313,100,84
4585,levle1_37.jpg,fore,Unspecified,0.0,0,1773,2274,1880,2389,107,115
4586,levle1_37.jpg,fore,Unspecified,0.0,0,1865,2351,1988,2481,123,130
4587,levle1_37.jpg,fore,Unspecified,0.0,0,1988,2366,2079,2497,91,131
4588,levle1_37.jpg,fore,Unspecified,0.0,0,2118,2175,2279,2290,161,115
4589,levle1_37.jpg,fore,Unspecified,0.0,0,2102,2068,2210,2144,108,76
4590,levle1_37.jpg,fore,Unspecified,0.0,0,2003,2006,2049,2091,46,85
4591,levle1_37.jpg,fore,Unspecified,0.0,0,2003,2221,2110,2336,107,115
4592,levle1_561.jpg,fore,Unspecified,0.0,0,1466,566,1643,750,177,184
4593,levle1_561.jpg,fore,Unspecified,0.0,0,493,1569,616,1715,123,146
4594,levle1_561.jpg,fore,Unspecified,0.0,0,447,2397,578,2512,131,115
4595,levle1_561.jpg,fore,Unspecified,0.0,0,470,2558,570,2719,100,161
4596,levle1_561.jpg,fore,Unspecified,0.0,0,631,2305,807,2512,176,207
4597,levle1_561.jpg,fore,Unspecified,0.0,0,715,2497,823,2589,108,92
4598,levle1_561.jpg,fore,Unspecified,0.0,0,700,2558,861,2727,161,169
4599,levle1_561.jpg,fore,Unspecified,0.0,0,853,2535,976,2711,123,176
4600,levle1_561.jpg,fore,Unspecified,0.0,0,738,2865,915,3018,177,153
4601,levle1_207.jpg,fore,Unspecified,0.0,0,1704,2075,1781,2213,77,138
4602,levle1_207.jpg,fore,Unspecified,0.0,0,1834,2190,1926,2336,92,146
4603,levle1_207.jpg,fore,Unspecified,0.0,0,1650,2451,1758,2566,108,115
4604,levle1_207.jpg,fore,Unspecified,0.0,0,1397,2336,1489,2451,92,115
4605,levle1_207.jpg,fore,Unspecified,0.0,0,1198,2366,1306,2443,108,77
4606,levle1_207.jpg,fore,Unspecified,0.0,0,1612,2704,1712,2849,100,145
4607,levle1_207.jpg,fore,Unspecified,0.0,0,1788,2627,1919,2727,131,100
4608,levle1_207.jpg,fore,Unspecified,0.0,0,1719,2803,1827,2895,108,92
4609,levle1_207.jpg,fore,Unspecified,0.0,0,1451,2696,1597,2842,146,146
4610,levle2_139.jpg,fore,Unspecified,0.0,0,1283,627,1382,757,99,130
4611,levle2_139.jpg,fore,Unspecified,0.0,0,2072,1217,2187,1363,115,146
4612,levle2_139.jpg,fore,Unspecified,0.0,0,1612,1684,1765,1815,153,131
4613,levle2_139.jpg,fore,Unspecified,0.0,0,1206,1937,1375,2137,169,200
4614,levle2_139.jpg,fore,Unspecified,0.0,0,1198,2114,1313,2236,115,122
4615,levle2_139.jpg,fore,Unspecified,0.0,0,1512,2029,1643,2114,131,85
4616,levle2_139.jpg,fore,Unspecified,0.0,0,1489,1953,1620,2052,131,99
4617,levle2_139.jpg,fore,Unspecified,0.0,0,1873,2037,1980,2167,107,130
4618,levle2_139.jpg,fore,Unspecified,0.0,0,1689,2052,1781,2152,92,100
4619,levle2_139.jpg,fore,Unspecified,0.0,0,1635,2190,1758,2267,123,77
4620,levle2_139.jpg,fore,Unspecified,0.0,0,1497,2114,1589,2229,92,115
4621,levle2_139.jpg,fore,Unspecified,0.0,0,1712,2259,1827,2351,115,92
4622,levle2_139.jpg,fore,Unspecified,0.0,0,1620,2290,1719,2389,99,99
4623,levle2_139.jpg,fore,Unspecified,0.0,0,1681,2382,1804,2489,123,107
4624,levle2_139.jpg,fore,Unspecified,0.0,0,1551,2359,1666,2443,115,84
4625,levle2_139.jpg,fore,Unspecified,0.0,0,1489,2305,1635,2405,146,100
4626,levle2_139.jpg,fore,Unspecified,0.0,0,1359,2244,1466,2320,107,76
4627,levle2_139.jpg,fore,Unspecified,0.0,0,1390,2343,1489,2428,99,85
4628,levle2_139.jpg,fore,Unspecified,0.0,0,1443,2420,1551,2527,108,107
4629,levle2_139.jpg,fore,Unspecified,0.0,0,1512,2527,1604,2665,92,138
4630,levle2_139.jpg,fore,Unspecified,0.0,0,1589,2489,1689,2566,100,77
4631,levle2_139.jpg,fore,Unspecified,0.0,0,1666,2527,1742,2650,76,123
4632,levle2_139.jpg,fore,Unspecified,0.0,0,1643,2642,1712,2742,69,100
4633,levle2_139.jpg,fore,Unspecified,0.0,0,1528,2719,1612,2803,84,84
4634,levle2_139.jpg,fore,Unspecified,0.0,0,1635,2834,1719,2941,84,107
4635,levle2_111.jpg,fore,Unspecified,0.0,0,731,251,846,374,115,123
4636,levle2_111.jpg,fore,Unspecified,0.0,0,1152,458,1336,596,184,138
4637,levle2_111.jpg,fore,Unspecified,0.0,0,1643,405,1796,550,153,145
4638,levle2_111.jpg,fore,Unspecified,0.0,0,1988,910,2118,1033,130,123
4639,levle2_111.jpg,fore,Unspecified,0.0,0,1850,1041,1926,1148,76,107
4640,levle2_111.jpg,fore,Unspecified,0.0,0,2340,1478,2501,1608,161,130
4641,levle2_111.jpg,fore,Unspecified,0.0,0,2601,1654,2746,1822,145,168
4642,levle2_111.jpg,fore,Unspecified,0.0,0,2846,1776,2991,1922,145,146
4643,levle2_111.jpg,fore,Unspecified,0.0,0,2861,1930,2984,2006,123,76
4644,levle2_111.jpg,fore,Unspecified,0.0,0,2899,2160,3053,2336,154,176
4645,levle2_111.jpg,fore,Unspecified,0.0,0,2547,2098,2693,2236,146,138
4646,levle2_111.jpg,fore,Unspecified,0.0,0,2647,1960,2830,2121,183,161
4647,levle2_111.jpg,fore,Unspecified,0.0,0,2079,2106,2240,2236,161,130
4648,levle2_111.jpg,fore,Unspecified,0.0,0,1865,2206,2018,2313,153,107
4649,levle2_111.jpg,fore,Unspecified,0.0,0,1919,2803,2133,2979,214,176
4650,levle2_111.jpg,fore,Unspecified,0.0,0,2141,2803,2271,2972,130,169
4651,levle2_111.jpg,fore,Unspecified,0.0,0,2302,2481,2463,2612,161,131
4652,levle2_111.jpg,fore,Unspecified,0.0,0,2555,2328,2662,2481,107,153
4653,levle2_111.jpg,fore,Unspecified,0.0,0,2716,2512,2869,2642,153,130
4654,levle2_111.jpg,fore,Unspecified,0.0,0,2830,2673,2976,2803,146,130
4655,levle2_111.jpg,fore,Unspecified,0.0,0,2777,2780,2984,2956,207,176
4656,levle2_111.jpg,fore,Unspecified,0.0,0,2332,2803,2493,2934,161,131
4657,levle2_111.jpg,fore,Unspecified,0.0,0,2539,2918,2647,3048,108,130
4658,levle2_111.jpg,fore,Unspecified,0.0,0,2547,3041,2685,3140,138,99
4659,levle2_111.jpg,fore,Unspecified,0.0,0,2516,3179,2624,3271,108,92
4660,levle2_111.jpg,fore,Unspecified,0.0,0,2294,3125,2432,3255,138,130
4661,levle2_111.jpg,fore,Unspecified,0.0,0,2041,3278,2210,3424,169,146
4662,levle2_111.jpg,fore,Unspecified,0.0,0,1957,3133,2087,3232,130,99
4663,levle2_111.jpg,fore,Unspecified,0.0,0,1574,3232,1704,3355,130,123
4664,levle2_105.jpg,fore,Unspecified,0.0,0,1719,2389,1834,2520,115,131
4665,levle2_105.jpg,fore,Unspecified,0.0,0,2026,2711,2156,2796,130,85
4666,levle2_105.jpg,fore,Unspecified,0.0,0,2294,2535,2409,2604,115,69
4667,levle2_105.jpg,fore,Unspecified,0.0,0,2294,2642,2409,2780,115,138
4668,levle2_105.jpg,fore,Unspecified,0.0,0,2409,2022,2501,2098,92,76
4669,levle2_105.jpg,fore,Unspecified,0.0,0,2516,2091,2654,2213,138,122
4670,levle2_105.jpg,fore,Unspecified,0.0,0,2317,2236,2440,2351,123,115
4671,levle2_105.jpg,fore,Unspecified,0.0,0,1735,2650,1781,2742,46,92
4672,levle2_105.jpg,fore,Unspecified,0.0,0,1957,2313,2110,2458,153,145
4673,levle2_105.jpg,fore,Unspecified,0.0,0,1359,796,1505,956,146,160
4674,levle2_105.jpg,fore,Unspecified,0.0,0,1290,987,1413,1094,123,107
4675,levle2_99.jpg,fore,Unspecified,0.0,0,1558,3025,1712,3179,154,154
4676,levle2_99.jpg,fore,Unspecified,0.0,0,1696,3002,1773,3140,77,138
4677,levle2_99.jpg,fore,Unspecified,0.0,0,2034,2872,2171,3041,137,169
4678,levle2_99.jpg,fore,Unspecified,0.0,0,2179,2949,2309,3087,130,138
4679,levle2_99.jpg,fore,Unspecified,0.0,0,2378,2880,2516,3018,138,138
4680,levle2_99.jpg,fore,Unspecified,0.0,0,2716,2267,2899,2389,183,122
4681,levle2_99.jpg,fore,Unspecified,0.0,0,2792,1830,2961,2014,169,184
4682,levle2_99.jpg,fore,Unspecified,0.0,0,2784,1217,2953,1401,169,184
4683,levle2_99.jpg,fore,Unspecified,0.0,0,2769,2481,2938,2604,169,123
4684,levle2_99.jpg,fore,Unspecified,0.0,0,938,811,1114,987,176,176
4685,levle2_99.jpg,fore,Unspecified,0.0,0,1175,658,1290,750,115,92
4686,levle1_0.jpg,fore,Unspecified,0.0,0,121,548,166,610,45,62
4687,levle1_0.jpg,fore,Unspecified,0.0,0,61,624,121,681,60,57
4688,levle1_0.jpg,fore,Unspecified,0.0,0,248,763,297,831,49,68
4689,levle1_0.jpg,fore,Unspecified,0.0,0,407,1144,470,1189,63,45
4690,levle1_0.jpg,fore,Unspecified,0.0,0,107,746,161,780,54,34
4691,levle1_0.jpg,fore,Unspecified,0.0,0,172,647,220,687,48,40
4692,levle1_0.jpg,fore,Unspecified,0.0,0,206,576,257,633,51,57
4693,levle1_0.jpg,fore,Unspecified,0.0,0,189,760,240,823,51,63
4694,levle1_0.jpg,fore,Unspecified,0.0,0,70,894,118,948,48,54
4695,levle1_0.jpg,fore,Unspecified,0.0,0,55,948,101,999,46,51
4696,levle2_72.jpg,fore,Unspecified,0.0,0,1666,926,1719,1094,53,168
4697,levle2_72.jpg,fore,Unspecified,0.0,0,1888,895,2102,1033,214,138
4698,levle2_72.jpg,fore,Unspecified,0.0,0,1995,742,2125,872,130,130
4699,levle2_72.jpg,fore,Unspecified,0.0,0,677,1983,792,2083,115,100
4700,levle2_72.jpg,fore,Unspecified,0.0,0,930,2336,1060,2481,130,145
4701,levle2_72.jpg,fore,Unspecified,0.0,0,869,2466,961,2581,92,115
4702,levle2_72.jpg,fore,Unspecified,0.0,0,1198,2206,1344,2328,146,122
4703,levle2_72.jpg,fore,Unspecified,0.0,0,1413,2389,1505,2566,92,177
4704,levle2_72.jpg,fore,Unspecified,0.0,0,1175,2489,1313,2612,138,123
4705,levle2_72.jpg,fore,Unspecified,0.0,0,961,2566,1045,2742,84,176
4706,levle2_72.jpg,fore,Unspecified,0.0,0,961,2780,1083,2895,122,115
4707,levle2_72.jpg,fore,Unspecified,0.0,0,708,2849,876,3002,168,153
4708,levle2_72.jpg,fore,Unspecified,0.0,0,1765,1692,1934,1830,169,138
4709,levle2_72.jpg,fore,Unspecified,0.0,0,1934,1784,2095,1914,161,130
4710,levle2_72.jpg,fore,Unspecified,0.0,0,1543,2918,1650,3056,107,138
4711,levle2_72.jpg,fore,Unspecified,0.0,0,1535,3140,1627,3286,92,146
4712,levle2_72.jpg,fore,Unspecified,0.0,0,1375,3064,1474,3240,99,176
4713,levle2_72.jpg,fore,Unspecified,0.0,0,631,2435,769,2604,138,169
4714,levle2_72.jpg,fore,Unspecified,0.0,0,777,2106,861,2282,84,176
4715,levle2_72.jpg,fore,Unspecified,0.0,0,884,2083,1007,2267,123,184
4716,levle2_72.jpg,fore,Unspecified,0.0,0,815,1769,930,1945,115,176
4717,levle2_72.jpg,fore,Unspecified,0.0,0,1221,1891,1474,2045,253,154
4718,levle2_72.jpg,fore,Unspecified,0.0,0,1612,1738,1727,1853,115,115
4719,levle2_72.jpg,fore,Unspecified,0.0,0,2210,2037,2340,2160,130,123
4720,levle2_72.jpg,fore,Unspecified,0.0,0,1543,527,1666,681,123,154
4721,levle2_66.jpg,fore,,,0,3165,1576,3290,1660,125,84
4722,levle2_66.jpg,fore,,,0,3040,1709,3157,1826,117,117
4723,levle2_66.jpg,fore,,,0,3090,1801,3281,1975,191,174
4724,levle2_66.jpg,fore,,,0,2907,1834,3082,2009,175,175
4725,levle2_66.jpg,fore,,,0,2932,1967,3090,2075,158,108
4726,levle2_66.jpg,fore,,,0,2558,2009,2658,2117,100,108
4727,levle2_66.jpg,fore,,,0,2766,1959,2899,2067,133,108
4728,levle2_66.jpg,fore,,,0,2384,2083,2542,2225,158,142
4729,levle2_66.jpg,fore,,,0,2508,2158,2616,2299,108,141
4730,levle2_66.jpg,fore,,,0,2616,2324,2716,2491,100,167
4731,levle2_66.jpg,fore,,,0,2741,2191,2833,2316,92,125
4732,levle2_66.jpg,fore,,,0,2866,2200,2999,2324,133,124
4733,levle2_66.jpg,fore,,,0,2808,2408,2949,2524,141,116
4734,levle2_66.jpg,fore,,,0,2957,2299,3099,2466,142,167
4735,levle2_66.jpg,fore,,,0,3049,2158,3190,2299,141,141
4736,levle2_66.jpg,fore,,,0,2758,2698,2874,2848,116,150
4737,levle2_66.jpg,fore,,,0,2941,2058,3065,2216,124,158
4738,levle2_66.jpg,fore,,,0,3232,1601,3439,1751,207,150
4739,levle2_66.jpg,fore,,,0,3215,1726,3365,1884,150,158
4740,levle2_66.jpg,fore,,,0,1826,594,1966,710,140,116
4741,levle2_66.jpg,fore,,,0,2170,1762,2290,1902,120,140
4742,levle0_202.jpg,fore,Unspecified,0.0,0,1827,1999,1942,2152,115,153
4743,levle0_202.jpg,fore,Unspecified,0.0,0,1643,1056,1796,1248,153,192
4744,levle0_216.jpg,fore,Unspecified,0.0,0,1505,2964,1704,3071,199,107
4745,levle0_216.jpg,fore,Unspecified,0.0,0,1796,3041,1988,3133,192,92
4746,levle0_389.jpg,fore,Unspecified,0.0,0,815,2558,968,2750,153,192
4747,levle0_88.jpg,fore,Unspecified,0.0,0,2450,2466,2583,2590,133,124
4748,levle0_77.jpg,fore,Unspecified,0.0,0,2309,1751,2508,1925,199,174
4749,levle0_77.jpg,fore,Unspecified,0.0,0,1470,2549,1636,2715,166,166
4750,levle0_77.jpg,fore,Unspecified,0.0,0,1844,2574,2060,2715,216,141
4751,levle1_159.jpg,fore,Unspecified,0.0,0,945,2796,1068,2934,123,138
4752,levle1_159.jpg,fore,Unspecified,0.0,0,884,2297,1068,2412,184,115
4753,levle1_159.jpg,fore,Unspecified,0.0,0,984,2612,1145,2719,161,107
4754,levle0_438.jpg,fore,Unspecified,0.0,0,1275,1991,1420,2190,145,199
4755,levle0_63.jpg,fore,Unspecified,0.0,0,2974,1635,3248,1917,274,282
4756,levle0_63.jpg,fore,Unspecified,0.0,0,3123,1294,3439,1618,316,324
4757,levle0_410.jpg,fore,Unspecified,0.0,0,317,1815,455,1991,138,176
4758,levle1_603.jpg,fore,Unspecified,0.0,0,1091,3232,1206,3370,115,138
4759,levle1_603.jpg,fore,Unspecified,0.0,0,1834,2635,1972,2826,138,191
4760,levle1_603.jpg,fore,Unspecified,0.0,0,1903,2819,2087,3002,184,183
4761,levle1_603.jpg,fore,Unspecified,0.0,0,2049,2619,2233,2773,184,154
4762,levle1_603.jpg,fore,Unspecified,0.0,0,1788,2343,1972,2566,184,223
4763,levle1_603.jpg,fore,Unspecified,0.0,0,1988,2137,2110,2274,122,137
4764,levle1_603.jpg,fore,Unspecified,0.0,0,2087,2267,2271,2412,184,145
4765,levle1_603.jpg,fore,Unspecified,0.0,0,2225,2152,2371,2297,146,145
4766,levle1_603.jpg,fore,Unspecified,0.0,0,2363,1991,2555,2091,192,100
4767,levle1_165.jpg,fore,Unspecified,0.0,0,1306,604,1436,734,130,130
4768,levle1_165.jpg,fore,Unspecified,0.0,0,761,2351,861,2489,100,138
4769,levle1_165.jpg,fore,Unspecified,0.0,0,899,2274,991,2366,92,92
4770,levle1_165.jpg,fore,Unspecified,0.0,0,1260,2566,1382,2696,122,130
4771,levle1_165.jpg,fore,Unspecified,0.0,0,1160,596,1283,750,123,154
4772,levle1_165.jpg,fore,Unspecified,0.0,0,1543,604,1689,765,146,161
4773,levle0_376.jpg,fore,Unspecified,0.0,0,1413,1002,1505,1094,92,92
4774,levle0_376.jpg,fore,Unspecified,0.0,0,2647,2129,2830,2229,183,100
4775,levle0_376.jpg,fore,Unspecified,0.0,0,2532,2198,2654,2320,122,122
4776,levle1_171.jpg,fore,Unspecified,0.0,0,1091,972,1229,1025,138,53
4777,levle1_171.jpg,fore,Unspecified,0.0,0,853,811,984,903,131,92
4778,levle1_171.jpg,fore,Unspecified,0.0,0,830,926,922,1041,92,115
4779,levle1_171.jpg,fore,Unspecified,0.0,0,823,642,922,742,99,100
4780,levle1_171.jpg,fore,Unspecified,0.0,0,961,673,1091,796,130,123
4781,levle1_171.jpg,fore,Unspecified,0.0,0,1068,359,1137,428,69,69
4782,levle1_171.jpg,fore,Unspecified,0.0,0,1168,428,1267,558,99,130
4783,levle1_171.jpg,fore,Unspecified,0.0,0,830,374,922,451,92,77
4784,levle1_171.jpg,fore,Unspecified,0.0,0,2095,2535,2248,2681,153,146
4785,levle1_171.jpg,fore,Unspecified,0.0,0,2340,2596,2432,2750,92,154
4786,levle1_171.jpg,fore,Unspecified,0.0,0,2217,2244,2340,2359,123,115
4787,levle0_362.jpg,fore,Unspecified,0.0,0,2371,1784,2478,1953,107,169
4788,levle0_362.jpg,fore,Unspecified,0.0,0,2647,2543,2754,2688,107,145
4789,levle0_404.jpg,fore,Unspecified,0.0,0,1045,1087,1191,1271,146,184
4790,levle1_617.jpg,fore,Unspecified,0.0,0,2570,1792,2693,1907,123,115
4791,levle1_617.jpg,fore,Unspecified,0.0,0,2463,2052,2585,2167,122,115
4792,levle1_617.jpg,fore,Unspecified,0.0,0,2777,1953,2938,2137,161,184
4793,levle1_617.jpg,fore,Unspecified,0.0,0,2539,2229,2708,2382,169,153
4794,levle1_617.jpg,fore,Unspecified,0.0,0,2401,2343,2601,2466,200,123
4795,levle1_617.jpg,fore,Unspecified,0.0,0,2248,2504,2348,2627,100,123
4796,levle1_617.jpg,fore,Unspecified,0.0,0,2463,2535,2624,2612,161,77
4797,levle1_617.jpg,fore,Unspecified,0.0,0,2762,2221,2915,2320,153,99
4798,levle1_398.jpg,fore,Unspecified,0.0,0,164,1953,256,2075,92,122
4799,levle1_398.jpg,fore,Unspecified,0.0,0,240,2083,432,2290,192,207
4800,levle1_398.jpg,fore,Unspecified,0.0,0,317,2443,455,2619,138,176
4801,levle1_398.jpg,fore,Unspecified,0.0,0,432,2282,639,2512,207,230
4802,levle1_398.jpg,fore,Unspecified,0.0,0,692,2014,953,2229,261,215
4803,levle1_398.jpg,fore,Unspecified,0.0,0,738,2251,899,2389,161,138
4804,levle1_398.jpg,fore,Unspecified,0.0,0,784,2458,984,2589,200,131
4805,levle1_398.jpg,fore,Unspecified,0.0,0,769,2956,922,3148,153,192
4806,levle1_398.jpg,fore,Unspecified,0.0,0,1137,2366,1306,2635,169,269
4807,levle0_148.jpg,fore,Unspecified,0.0,0,1742,2274,1850,2389,108,115
4808,levle1_429.jpg,fore,Unspecified,0.0,0,800,2596,915,2765,115,169
4809,levle1_429.jpg,fore,Unspecified,0.0,0,984,3240,1129,3347,145,107
4810,levle1_429.jpg,fore,Unspecified,0.0,0,1382,3294,1589,3363,207,69
4811,levle1_429.jpg,fore,Unspecified,0.0,0,1620,3347,1689,3447,69,100
4812,levle1_429.jpg,fore,Unspecified,0.0,0,1811,3064,1919,3179,108,115
4813,levle1_429.jpg,fore,Unspecified,0.0,0,1911,3010,1988,3171,77,161
4814,levle1_429.jpg,fore,Unspecified,0.0,0,1719,2619,1865,2757,146,138
4815,levle1_429.jpg,fore,Unspecified,0.0,0,1712,3133,1834,3271,122,138
4816,levle3_26.jpg,fore,,,0,96,24,107,38,11,14
4817,levle3_26.jpg,fore,,,0,105,35,119,48,14,13
4818,levle3_26.jpg,fore,,,0,127,43,138,54,11,11
4819,levle3_26.jpg,fore,,,0,93,57,105,73,12,16
4820,levle3_26.jpg,fore,,,0,114,55,127,69,13,14
4821,levle3_26.jpg,fore,,,0,82,64,94,80,12,16
4822,levle3_26.jpg,fore,,,0,51,88,64,101,13,13
4823,levle3_26.jpg,fore,,,0,58,119,71,132,13,13
4824,levle3_26.jpg,fore,,,0,75,108,92,118,17,10
4825,levle3_26.jpg,fore,,,0,93,152,104,165,11,13
4826,levle3_26.jpg,fore,,,0,104,166,112,176,8,10
4827,levle3_26.jpg,fore,,,0,113,147,125,163,12,16
4828,levle3_26.jpg,fore,,,0,99,94,118,108,19,14
4829,levle3_26.jpg,fore,,,0,114,116,130,134,16,18
4830,levle3_26.jpg,fore,,,0,139,121,153,133,14,12
4831,levle3_26.jpg,fore,,,0,81,116,91,127,10,11
4832,levle3_26.jpg,fore,,,0,138,179,148,189,10,10
4833,levle3_26.jpg,fore,,,0,129,172,137,180,8,8
4834,levle3_26.jpg,fore,,,0,82,150,91,162,9,12
4835,levle3_26.jpg,fore,,,0,58,135,67,146,9,11
4836,levle3_26.jpg,fore,,,0,75,133,90,148,15,15
4837,levle3_26.jpg,fore,,,0,97,131,106,138,9,7
4838,levle3_26.jpg,fore,,,0,57,103,67,114,10,11
4839,levle3_26.jpg,fore,,,0,66,100,71,107,5,7
4840,levle3_26.jpg,fore,,,0,74,90,83,101,9,11
4841,levle3_26.jpg,fore,,,0,40,79,48,90,8,11
4842,levle3_26.jpg,fore,,,0,59,76,67,83,8,7
4843,levle3_26.jpg,fore,,,0,70,81,78,90,8,9
4844,levle3_26.jpg,fore,,,0,72,73,79,79,7,6
4845,levle3_26.jpg,fore,,,0,67,56,79,65,12,9
4846,levle3_26.jpg,fore,,,0,72,26,87,35,15,9
4847,levle3_26.jpg,fore,,,0,81,38,91,49,10,11
4848,levle3_26.jpg,fore,,,0,99,11,118,29,19,18
4849,levle3_26.jpg,fore,,,0,131,66,140,75,9,9
4850,levle3_26.jpg,fore,,,0,146,74,156,88,10,14
4851,levle3_26.jpg,fore,,,0,123,75,136,89,13,14
4852,levle3_26.jpg,fore,,,0,115,69,130,84,15,15
4853,levle3_26.jpg,fore,,,0,97,77,112,92,15,15
4854,levle3_26.jpg,fore,,,0,117,27,128,38,11,11
4855,levle3_26.jpg,fore,,,0,56,55,68,66,12,11
4856,levle3_26.jpg,fore,,,0,97,117,106,127,9,10
4857,levle3_26.jpg,fore,,,0,104,113,116,126,12,13
4858,levle3_26.jpg,fore,,,0,139,98,150,109,11,11
4859,levle3_26.jpg,fore,,,0,129,90,138,104,9,14
4860,levle3_26.jpg,fore,,,0,127,23,137,31,10,8
4861,levle3_26.jpg,fore,,,0,131,31,141,41,10,10
4862,levle3_26.jpg,fore,,,0,57,39,65,50,8,11
4863,levle3_26.jpg,fore,,,0,59,35,68,43,9,8
4864,levle3_26.jpg,fore,,,0,79,51,89,60,10,9
4865,levle3_26.jpg,fore,,,0,111,133,127,148,16,15
4866,levle3_26.jpg,fore,,,0,140,27,150,36,10,9
4867,levle3_26.jpg,fore,,,0,140,45,149,56,9,11
4868,levle3_26.jpg,fore,,,0,88,92,98,104,10,12
4869,levle3_26.jpg,fore,,,0,119,100,129,107,10,7
4870,levle3_26.jpg,fore,,,0,130,111,140,121,10,10
4871,levle3_26.jpg,fore,,,0,90,139,103,150,13,11
4872,levle3_26.jpg,fore,,,0,139,155,147,162,8,7
4873,levle3_26.jpg,fore,,,0,136,166,146,176,10,10
4874,levle3_26.jpg,fore,,,0,149,159,160,166,11,7
4875,levle3_26.jpg,fore,,,0,156,135,166,144,10,9
4876,levle3_26.jpg,fore,,,0,160,126,170,136,10,10
4877,levle3_26.jpg,fore,,,0,136,146,147,156,11,10
4878,levle0_174.jpg,fore,Unspecified,0.0,0,1022,2627,1198,2803,176,176
4879,levle0_174.jpg,fore,Unspecified,0.0,0,1329,1891,1451,2014,122,123
4880,levle1_367.jpg,fore,Unspecified,0.0,0,945,2658,1030,2803,85,145
4881,levle1_367.jpg,fore,Unspecified,0.0,0,754,2972,876,3087,122,115
4882,levle1_367.jpg,fore,Unspecified,0.0,0,670,3125,792,3317,122,192
4883,levle1_367.jpg,fore,Unspecified,0.0,0,1145,2926,1290,3048,145,122
4884,levle1_367.jpg,fore,Unspecified,0.0,0,1060,3033,1160,3156,100,123
4885,levle1_367.jpg,fore,Unspecified,0.0,0,1535,3148,1666,3294,131,146
4886,levle1_367.jpg,fore,Unspecified,0.0,0,1781,2819,1903,2918,122,99
4887,levle1_401.jpg,fore,Unspecified,0.0,0,677,2527,800,2681,123,154
4888,levle1_401.jpg,fore,Unspecified,0.0,0,838,2573,907,2757,69,184
4889,levle1_401.jpg,fore,Unspecified,0.0,0,907,2466,1045,2604,138,138
4890,levle1_401.jpg,fore,Unspecified,0.0,0,1083,2642,1175,2819,92,177
4891,levle1_401.jpg,fore,Unspecified,0.0,0,1267,2520,1451,2727,184,207
4892,levle1_401.jpg,fore,Unspecified,0.0,0,1658,865,1781,1048,123,183
4893,levle1_401.jpg,fore,Unspecified,0.0,0,1896,1592,1980,1707,84,115
4894,levle1_401.jpg,fore,Unspecified,0.0,0,2064,696,2179,834,115,138
4895,levle1_415.jpg,fore,Unspecified,0.0,0,1980,956,2064,1048,84,92
4896,levle1_415.jpg,fore,Unspecified,0.0,0,1076,635,1168,773,92,138
4897,levle1_415.jpg,fore,Unspecified,0.0,0,1267,3056,1375,3179,108,123
4898,levle1_415.jpg,fore,Unspecified,0.0,0,999,3140,1152,3240,153,100
4899,levle1_415.jpg,fore,Unspecified,0.0,0,1060,3018,1175,3156,115,138
4900,levle1_415.jpg,fore,Unspecified,0.0,0,861,3186,968,3309,107,123
4901,levle1_415.jpg,fore,Unspecified,0.0,0,1719,3041,1834,3148,115,107
4902,levle0_160.jpg,fore,Unspecified,0.0,0,708,2819,853,2972,145,153
4903,levle0_160.jpg,fore,Unspecified,0.0,0,807,2719,968,2842,161,123
4904,levle0_160.jpg,fore,Unspecified,0.0,0,654,2911,738,3025,84,114
4905,levle1_373.jpg,fore,Unspecified,0.0,0,1443,903,1581,1018,138,115
4906,levle1_373.jpg,fore,Unspecified,0.0,0,1949,2022,2079,2137,130,115
4907,levle1_373.jpg,fore,Unspecified,0.0,0,2248,2343,2378,2466,130,123
4908,levle1_373.jpg,fore,Unspecified,0.0,0,2125,2366,2256,2520,131,154
4909,levle1_373.jpg,fore,Unspecified,0.0,0,2371,2443,2470,2550,99,107
4910,levle1_373.jpg,fore,Unspecified,0.0,0,2447,2550,2516,2681,69,131
4911,levle1_373.jpg,fore,Unspecified,0.0,0,1765,3110,1873,3278,108,168
4912,levle1_373.jpg,fore,Unspecified,0.0,0,2087,2619,2194,2780,107,161
4913,levle1_328.jpg,fore,Unspecified,0.0,0,1076,2903,1175,3079,99,176
4914,levle1_328.jpg,fore,Unspecified,0.0,0,1543,3033,1696,3156,153,123
4915,levle1_328.jpg,fore,Unspecified,0.0,0,1413,3079,1543,3248,130,169
4916,levle1_328.jpg,fore,Unspecified,0.0,0,1811,2826,1965,2941,154,115
4917,levle1_328.jpg,fore,Unspecified,0.0,0,2141,2865,2363,3002,222,137
4918,levle1_328.jpg,fore,Unspecified,0.0,0,2095,2987,2279,3117,184,130
4919,levle1_328.jpg,fore,Unspecified,0.0,0,1903,3140,2034,3317,131,177
4920,levle1_328.jpg,fore,Unspecified,0.0,0,2057,3156,2194,3378,137,222
4921,levle1_472.jpg,fore,Unspecified,0.0,0,1857,803,1988,972,131,169
4922,levle1_472.jpg,fore,Unspecified,0.0,0,1313,412,1474,489,161,77
4923,levle1_472.jpg,fore,Unspecified,0.0,0,1796,3048,1926,3140,130,92
4924,levle1_472.jpg,fore,Unspecified,0.0,0,1482,3125,1666,3294,184,169
4925,levle1_472.jpg,fore,Unspecified,0.0,0,601,2796,746,2911,145,115
4926,levle1_472.jpg,fore,Unspecified,0.0,0,424,2458,516,2612,92,154
4927,levle1_472.jpg,fore,Unspecified,0.0,0,294,2451,409,2566,115,115
4928,levle1_472.jpg,fore,Unspecified,0.0,0,601,1930,685,2068,84,138
4929,levle1_472.jpg,fore,Unspecified,0.0,0,562,1769,692,1884,130,115
4930,levle0_107.jpg,fore,Unspecified,0.0,0,1520,2535,1696,2688,176,153
4931,levle1_314.jpg,fore,Unspecified,0.0,0,463,1033,578,1148,115,115
4932,levle1_314.jpg,fore,Unspecified,0.0,0,156,1478,256,1631,100,153
4933,levle1_314.jpg,fore,Unspecified,0.0,0,647,2014,777,2129,130,115
4934,levle1_314.jpg,fore,Unspecified,0.0,0,884,2144,1007,2305,123,161
4935,levle1_314.jpg,fore,Unspecified,0.0,0,1037,2834,1152,2972,115,138
4936,levle1_314.jpg,fore,Unspecified,0.0,0,1076,2956,1168,3087,92,131
4937,levle1_314.jpg,fore,Unspecified,0.0,0,692,2888,861,3025,169,137
4938,levle1_314.jpg,fore,Unspecified,0.0,0,1543,3087,1681,3240,138,153
4939,levle1_314.jpg,fore,Unspecified,0.0,0,1735,2834,1850,2964,115,130
4940,levle1_314.jpg,fore,Unspecified,0.0,0,509,2106,578,2221,69,115
4941,levle1_314.jpg,fore,Unspecified,0.0,0,271,2045,386,2190,115,145
4942,levle1_314.jpg,fore,Unspecified,0.0,0,601,2229,723,2359,122,130
4943,levle1_314.jpg,fore,Unspecified,0.0,0,876,2489,930,2619,54,130
4944,levle3_55.jpg,fore,,,0,407,204,446,238,39,34
4945,levle3_55.jpg,fore,,,0,474,187,507,214,33,27
4946,levle3_55.jpg,fore,,,0,356,173,403,220,47,47
4947,levle3_55.jpg,fore,,,0,513,248,556,293,43,45
4948,levle3_55.jpg,fore,,,0,383,250,454,309,71,59
4949,levle3_55.jpg,fore,,,0,305,216,352,271,47,55
4950,levle3_55.jpg,fore,,,0,372,307,434,375,62,68
4951,levle3_55.jpg,fore,,,0,434,313,519,372,85,59
4952,levle3_55.jpg,fore,,,0,431,407,472,438,41,31
4953,levle3_55.jpg,fore,,,0,409,466,442,495,33,29
4954,levle3_55.jpg,fore,,,0,289,417,336,462,47,45
4955,levle3_55.jpg,fore,,,0,277,698,330,733,53,35
4956,levle3_55.jpg,fore,,,0,454,629,517,672,63,43
4957,levle3_55.jpg,fore,,,0,458,676,509,727,51,51
4958,levle3_55.jpg,fore,,,0,399,653,440,698,41,45
4959,levle3_55.jpg,fore,,,0,554,609,598,653,44,44
4960,levle3_55.jpg,fore,,,0,511,179,531,222,20,43
4961,levle3_55.jpg,fore,,,0,379,387,421,432,42,45
4962,levle3_55.jpg,fore,,,0,372,448,413,503,41,55
4963,levle3_55.jpg,fore,,,0,336,519,383,556,47,37
4964,levle3_55.jpg,fore,,,0,413,590,440,617,27,27
4965,levle3_55.jpg,fore,,,0,324,545,364,600,40,55
4966,levle3_55.jpg,fore,,,0,328,639,395,690,67,51
4967,levle3_55.jpg,fore,,,0,256,590,322,668,66,78
4968,levle3_55.jpg,fore,,,0,157,625,197,680,40,55
4969,levle3_55.jpg,fore,,,0,136,560,183,611,47,51
4970,levle3_55.jpg,fore,,,0,537,527,568,582,31,55
4971,levle3_55.jpg,fore,,,0,478,489,513,535,35,46
4972,levle3_55.jpg,fore,,,0,525,434,576,484,51,50
4973,levle3_55.jpg,fore,,,0,621,360,676,415,55,55
4974,levle3_55.jpg,fore,,,0,309,792,372,839,63,47
4975,levle3_55.jpg,fore,,,0,171,737,228,786,57,49
4976,levle3_55.jpg,fore,,,0,208,494,248,531,40,37
4977,levle3_55.jpg,fore,,,0,170,407,240,450,70,43
4978,levle3_55.jpg,fore,,,0,210,289,258,314,48,25
4979,levle3_55.jpg,fore,,,0,172,298,214,346,42,48
4980,levle3_55.jpg,fore,,,0,123,429,155,482,32,53
4981,levle3_55.jpg,fore,,,0,132,528,168,559,36,31
4982,levle3_55.jpg,fore,,,0,123,332,156,372,33,40
4983,levle3_55.jpg,fore,,,0,135,272,167,332,32,60
4984,levle3_55.jpg,fore,,,0,281,560,314,591,33,31
4985,levle3_55.jpg,fore,,,0,326,708,358,738,32,30
4986,levle3_55.jpg,fore,,,0,304,744,347,779,43,35
4987,levle3_55.jpg,fore,,,0,231,660,271,701,40,41
4988,levle3_55.jpg,fore,,,0,370,720,416,758,46,38
4989,levle3_55.jpg,fore,,,0,400,811,441,845,41,34
4990,levle3_55.jpg,fore,,,0,445,769,501,811,56,42
4991,levle3_55.jpg,fore,,,0,486,574,525,607,39,33
4992,levle3_55.jpg,fore,,,0,603,505,644,546,41,41
4993,levle3_55.jpg,fore,,,0,477,389,517,423,40,34
4994,levle3_55.jpg,fore,,,0,460,242,500,284,40,42
4995,levle3_55.jpg,fore,,,0,577,291,624,324,47,33
4996,levle3_55.jpg,fore,,,0,186,532,228,564,42,32
4997,levle3_55.jpg,fore,,,0,281,810,325,840,44,30
4998,levle3_55.jpg,fore,,,0,461,828,511,864,50,36
4999,levle3_55.jpg,fore,,,0,504,736,540,775,36,39
5000,levle3_55.jpg,fore,,,0,522,605,556,642,34,37
5001,levle3_55.jpg,fore,,,0,148,458,195,495,47,37
5002,levle3_55.jpg,fore,,,0,593,410,636,452,43,42
5003,levle3_55.jpg,fore,,,0,580,449,620,497,40,48
5004,levle3_55.jpg,fore,,,0,154,691,200,738,46,47
5005,levle3_55.jpg,fore,,,0,230,716,273,749,43,33
5006,levle3_55.jpg,fore,,,0,201,449,229,477,28,28
5007,levle3_55.jpg,fore,,,0,440,452,484,491,44,39
5008,levle3_41.jpg,fore,,,0,198,60,244,93,46,33
5009,levle3_41.jpg,fore,,,0,186,21,211,42,25,21
5010,levle3_41.jpg,fore,,,0,207,180,242,201,35,21
5011,levle3_41.jpg,fore,,,0,237,249,262,282,25,33
5012,levle3_41.jpg,fore,,,0,165,198,198,237,33,39
5013,levle3_41.jpg,fore,,,0,115,203,147,237,32,34
5014,levle3_41.jpg,fore,,,0,85,221,128,255,43,34
5015,levle3_41.jpg,fore,,,0,130,249,158,280,28,31
5016,levle3_41.jpg,fore,,,0,166,278,195,305,29,27
5017,levle3_41.jpg,fore,,,0,314,308,351,343,37,35
5018,levle3_41.jpg,fore,,,0,346,335,370,356,24,21
5019,levle3_41.jpg,fore,,,0,356,372,375,398,19,26
5020,levle3_41.jpg,fore,,,0,267,400,313,438,46,38
5021,levle3_41.jpg,fore,,,0,231,370,250,404,19,34
5022,levle3_41.jpg,fore,,,0,116,365,141,400,25,35
5023,levle3_41.jpg,fore,,,0,50,314,72,343,22,29
5024,levle3_41.jpg,fore,,,0,39,366,82,402,43,36
5025,levle3_41.jpg,fore,,,0,146,449,180,478,34,29
5026,levle3_41.jpg,fore,,,0,257,75,281,107,24,32
5027,levle3_41.jpg,fore,,,0,225,150,265,189,40,39
5028,levle3_41.jpg,fore,,,0,301,136,341,169,40,33
5029,levle3_41.jpg,fore,,,0,182,302,225,331,43,29
5030,levle3_41.jpg,fore,,,0,243,317,280,341,37,24
5031,levle3_41.jpg,fore,,,0,274,290,296,316,22,26
5032,levle3_41.jpg,fore,,,0,290,253,314,282,24,29
5033,levle3_41.jpg,fore,,,0,172,343,213,394,41,51
5034,levle3_41.jpg,fore,,,0,127,448,144,475,17,27
5035,levle3_41.jpg,fore,,,0,108,442,112,449,4,7
5036,levle3_41.jpg,fore,,,0,76,416,102,452,26,36
5037,levle3_41.jpg,fore,,,0,105,458,129,487,24,29
5038,levle3_41.jpg,fore,,,0,297,367,328,414,31,47
5039,levle3_41.jpg,fore,,,0,316,192,329,213,13,21
5040,levle3_41.jpg,fore,,,0,389,178,410,204,21,26
5041,levle3_41.jpg,fore,,,0,312,90,329,117,17,27
5042,levle3_41.jpg,fore,,,0,213,34,240,57,27,23
5043,levle3_41.jpg,fore,,,0,172,134,193,158,21,24
5044,levle3_41.jpg,fore,,,0,94,126,109,144,15,18
5045,levle3_41.jpg,fore,,,0,88,183,109,201,21,18
5046,levle3_41.jpg,fore,,,0,83,200,107,219,24,19
5047,levle3_41.jpg,fore,,,0,28,245,54,267,26,22
5048,levle3_41.jpg,fore,,,0,32,201,51,222,19,21
5049,levle3_41.jpg,fore,,,0,56,294,78,315,22,21
5050,levle3_41.jpg,fore,,,0,13,286,40,316,27,30
5051,levle3_41.jpg,fore,,,0,114,343,134,360,20,17
5052,levle3_41.jpg,fore,,,0,112,291,128,312,16,21
5053,levle3_41.jpg,fore,,,0,78,382,98,405,20,23
5054,levle3_41.jpg,fore,,,0,92,396,113,416,21,20
5055,levle3_41.jpg,fore,,,0,363,287,382,308,19,21
5056,levle3_41.jpg,fore,,,0,328,242,347,259,19,17
5057,levle3_41.jpg,fore,,,0,225,451,240,471,15,20
5058,levle3_41.jpg,fore,,,0,231,204,250,222,19,18
5059,levle3_41.jpg,fore,,,0,111,437,141,459,30,22
5060,levle3_41.jpg,fore,,,0,271,210,295,238,24,28
5061,levle3_41.jpg,fore,,,0,132,422,157,448,25,26
5062,levle3_41.jpg,fore,,,0,90,461,108,481,18,20
5063,levle3_41.jpg,fore,,,0,244,228,263,248,19,20
5064,levle3_41.jpg,fore,,,0,220,286,242,306,22,20
5065,levle3_41.jpg,fore,,,0,201,209,221,227,20,18
5066,levle3_41.jpg,fore,,,0,168,317,193,338,25,21
5067,levle3_41.jpg,fore,,,0,212,3,233,22,21,19
5068,levle3_41.jpg,fore,,,0,24,402,49,425,25,23
5069,levle0_113.jpg,fore,Unspecified,0.0,0,2263,750,2394,895,131,145
5070,levle1_300.jpg,fore,Unspecified,0.0,0,332,1930,516,2114,184,184
5071,levle1_300.jpg,fore,Unspecified,0.0,0,601,2635,685,2803,84,168
5072,levle1_300.jpg,fore,Unspecified,0.0,0,493,2328,654,2481,161,153
5073,levle1_300.jpg,fore,Unspecified,0.0,0,363,3148,562,3317,199,169
5074,levle1_300.jpg,fore,Unspecified,0.0,0,654,3156,784,3340,130,184
5075,levle1_300.jpg,fore,Unspecified,0.0,0,685,3056,861,3240,176,184
5076,levle1_466.jpg,fore,Unspecified,0.0,0,1865,2229,2057,2366,192,137
5077,levle1_466.jpg,fore,Unspecified,0.0,0,1773,2420,1965,2612,192,192
5078,levle1_466.jpg,fore,Unspecified,0.0,0,1949,2589,2102,2742,153,153
5079,levle1_466.jpg,fore,Unspecified,0.0,0,2118,2665,2256,2834,138,169
5080,levle1_466.jpg,fore,Unspecified,0.0,0,2424,2190,2562,2328,138,138
5081,levle1_466.jpg,fore,Unspecified,0.0,0,2593,2313,2731,2573,138,260
5082,levle1_499.jpg,fore,Unspecified,0.0,0,692,1884,815,2006,123,122
5083,levle1_499.jpg,fore,Unspecified,0.0,0,1321,2052,1451,2167,130,115
5084,levle1_499.jpg,fore,Unspecified,0.0,0,1558,2428,1696,2581,138,153
5085,levle1_499.jpg,fore,Unspecified,0.0,0,2003,2420,2087,2535,84,115
5086,levle1_499.jpg,fore,Unspecified,0.0,0,2003,2558,2148,2704,145,146
5087,levle1_499.jpg,fore,Unspecified,0.0,0,1382,3048,1497,3125,115,77
5088,levle1_499.jpg,fore,Unspecified,0.0,0,1528,3071,1643,3179,115,108
5089,levle1_499.jpg,fore,Unspecified,0.0,0,1727,3010,1857,3171,130,161
5090,levle3_96.jpg,fore,,,0,3040,147,3223,346,183,199
5091,levle3_96.jpg,fore,,,0,2101,1593,2359,1817,258,224
5092,levle3_96.jpg,fore,,,0,2583,1967,2608,2009,25,42
5093,levle3_96.jpg,fore,,,0,2434,1842,2575,2009,141,167
5094,levle3_96.jpg,fore,,,0,2608,1784,2799,1942,191,158
5095,levle3_96.jpg,fore,,,0,2633,1901,2808,2142,175,241
5096,levle3_96.jpg,fore,,,0,2791,1901,2974,2092,183,191
5097,levle3_96.jpg,fore,,,0,2741,2125,2858,2316,117,191
5098,levle3_96.jpg,fore,,,0,2051,1909,2201,2067,150,158
5099,levle3_96.jpg,fore,,,0,2409,2034,2592,2250,183,216
5100,levle3_96.jpg,fore,,,0,2267,1086,2375,1211,108,125
5101,levle3_96.jpg,fore,,,0,2434,1153,2675,1327,241,174
5102,levle3_96.jpg,fore,,,0,1868,1452,2051,1551,183,99
5103,levle3_96.jpg,fore,,,0,1943,1618,2101,1801,158,183
5104,levle3_96.jpg,fore,,,0,2101,1477,2276,1585,175,108
5105,levle3_96.jpg,fore,,,0,2932,571,3132,729,200,158
5106,levle3_96.jpg,fore,,,0,2758,1028,2808,1103,50,75
5107,levle3_96.jpg,fore,,,0,2616,862,2774,978,158,116
5108,levle3_96.jpg,fore,,,0,3190,1102,3306,1270,116,168
5109,levle3_96.jpg,fore,,,0,3234,994,3398,1110,164,116
5110,levle3_96.jpg,fore,,,0,3334,318,3470,462,136,144
5111,levle3_96.jpg,fore,,,0,1586,2546,1710,2686,124,140
5112,levle3_96.jpg,fore,,,0,1466,2430,1586,2586,120,156
5113,levle3_96.jpg,fore,,,0,2006,2274,2174,2438,168,164
5114,levle3_96.jpg,fore,,,0,1890,2074,2026,2206,136,132
5115,levle3_96.jpg,fore,,,0,2030,2070,2166,2186,136,116
5116,levle3_96.jpg,fore,,,0,2338,1458,2470,1542,132,84
5117,levle3_96.jpg,fore,,,0,1966,1174,2138,1338,172,164
5118,levle3_96.jpg,fore,,,0,1942,1330,2186,1458,244,128
5119,levle3_96.jpg,fore,,,0,2422,802,2578,986,156,184
5120,levle3_96.jpg,fore,,,0,2538,2298,2670,2450,132,152
5121,levle3_96.jpg,fore,,,0,1622,2002,1754,2134,132,132
5122,levle3_96.jpg,fore,,,0,1806,2286,1926,2430,120,144
5123,levle3_96.jpg,fore,,,0,2014,2534,2174,2682,160,148
5124,levle3_96.jpg,fore,,,0,2202,2270,2314,2366,112,96
5125,levle3_96.jpg,fore,,,0,2270,2358,2382,2470,112,112
5126,levle3_96.jpg,fore,,,0,2478,2574,2606,2702,128,128
5127,levle3_96.jpg,fore,,,0,2206,2022,2322,2166,116,144
5128,levle3_96.jpg,fore,,,0,2238,2518,2366,2618,128,100
5129,levle3_96.jpg,fore,,,0,2498,1058,2658,1194,160,136
5130,levle3_96.jpg,fore,,,0,2794,378,2966,554,172,176
5131,levle3_96.jpg,fore,,,0,2978,390,3258,546,280,156
5132,levle3_96.jpg,fore,,,0,2814,138,3058,354,244,216
5133,levle3_96.jpg,fore,,,0,2506,1462,2650,1658,144,196
5134,levle3_96.jpg,fore,,,0,2670,1562,2866,1774,196,212
5135,levle3_96.jpg,fore,,,0,2026,2654,2282,2810,256,156
5136,levle3_96.jpg,fore,,,0,2714,2946,2866,3062,152,116
5137,levle3_96.jpg,fore,,,0,2594,2626,2762,2778,168,152
5138,levle3_96.jpg,fore,,,0,2626,2234,2798,2438,172,204
5139,levle3_96.jpg,fore,,,0,2502,1662,2670,1822,168,160
5140,levle3_96.jpg,fore,,,0,2350,1690,2514,1870,164,180
5141,levle3_96.jpg,fore,,,0,2378,1542,2554,1666,176,124
5142,levle3_96.jpg,fore,,,0,2958,1546,3090,1686,132,140
5143,levle3_96.jpg,fore,,,0,2946,1798,3106,1994,160,196
5144,levle3_96.jpg,fore,,,0,2406,2282,2602,2410,196,128
5145,levle3_96.jpg,fore,,,0,2170,1330,2322,1462,152,132
5146,levle3_96.jpg,fore,,,0,3222,182,3458,334,236,152
5147,levle3_82.jpg,fore,,,0,1574,397,1765,612,191,215
5148,levle3_82.jpg,fore,,,0,1237,826,1413,956,176,130
5149,levle3_82.jpg,fore,,,0,1191,627,1505,842,314,215
5150,levle3_82.jpg,fore,,,0,1482,727,1635,803,153,76
5151,levle3_82.jpg,fore,,,0,1903,834,2118,995,215,161
5152,levle3_82.jpg,fore,,,0,1275,910,1436,1079,161,169
5153,levle3_82.jpg,fore,,,0,922,803,1214,941,292,138
5154,levle3_82.jpg,fore,,,0,2148,796,2286,987,138,191
5155,levle3_82.jpg,fore,,,0,2087,1010,2286,1171,199,161
5156,levle3_82.jpg,fore,,,0,2225,941,2348,1064,123,123
5157,levle3_82.jpg,fore,,,0,2233,673,2394,826,161,153
5158,levle3_82.jpg,fore,,,0,2355,658,2486,849,131,191
5159,levle3_82.jpg,fore,,,0,2486,673,2654,857,168,184
5160,levle3_82.jpg,fore,,,0,2386,903,2532,1056,146,153
5161,levle3_82.jpg,fore,,,0,2486,1010,2685,1102,199,92
5162,levle3_82.jpg,fore,,,0,2516,1048,2739,1248,223,200
5163,levle3_82.jpg,fore,,,0,2440,1133,2616,1317,176,184
5164,levle3_82.jpg,fore,,,0,2332,1255,2509,1340,177,85
5165,levle3_82.jpg,fore,,,0,2478,1255,2631,1432,153,177
5166,levle3_82.jpg,fore,,,0,2562,1171,2762,1355,200,184
5167,levle3_82.jpg,fore,,,0,2662,1393,2861,1654,199,261
5168,levle3_82.jpg,fore,,,0,2539,1393,2685,1547,146,154
5169,levle3_82.jpg,fore,,,0,2486,1569,2654,1799,168,230
5170,levle3_82.jpg,fore,,,0,2716,1638,2984,1853,268,215
5171,levle3_82.jpg,fore,,,0,2409,1807,2539,1960,130,153
5172,levle3_82.jpg,fore,,,0,2340,1968,2440,2091,100,123
5173,levle3_82.jpg,fore,,,0,2340,2045,2493,2267,153,222
5174,levle3_82.jpg,fore,,,0,2524,1899,2708,2121,184,222
5175,levle3_82.jpg,fore,,,0,2539,1968,2662,2183,123,215
5176,levle3_82.jpg,fore,,,0,2171,1907,2363,2083,192,176
5177,levle3_82.jpg,fore,,,0,2011,2037,2171,2236,160,199
5178,levle3_82.jpg,fore,,,0,2187,2029,2371,2183,184,154
5179,levle3_82.jpg,fore,,,0,1926,2244,2041,2420,115,176
5180,levle3_82.jpg,fore,,,0,2057,2259,2210,2397,153,138
5181,levle3_82.jpg,fore,,,0,2179,2313,2340,2520,161,207
5182,levle3_82.jpg,fore,,,0,2263,2267,2501,2458,238,191
5183,levle3_82.jpg,fore,,,0,2509,2229,2624,2466,115,237
5184,levle3_82.jpg,fore,,,0,2585,2183,2815,2351,230,168
5185,levle3_82.jpg,fore,,,0,2670,1830,2830,2029,160,199
5186,levle3_82.jpg,fore,,,0,1773,3156,1965,3363,192,207
5187,levle3_82.jpg,fore,,,0,1560,843,1715,984,155,141
5188,levle3_82.jpg,fore,,,0,1746,2046,1929,2201,183,155
5189,levle3_82.jpg,fore,,,0,2098,2725,2219,2839,121,114
5190,levle3_82.jpg,fore,,,0,2171,2643,2295,2767,124,124
5191,levle3_82.jpg,fore,,,0,2515,2619,2602,2725,87,106
5192,levle3_82.jpg,fore,,,0,2446,2525,2588,2643,142,118
5193,levle3_82.jpg,fore,,,0,2653,2398,2753,2508,100,110
5194,levle3_82.jpg,fore,,,0,2253,1815,2346,1943,93,128
5195,levle3_82.jpg,fore,,,0,2257,1322,2415,1453,158,131
5196,levle3_82.jpg,fore,,,0,2440,1425,2560,1536,120,111
5197,levle3_82.jpg,fore,,,0,2219,494,2333,584,114,90
5198,levle3_82.jpg,fore,,,0,2046,332,2198,457,152,125
5199,levle3_82.jpg,fore,,,0,1336,446,1460,563,124,117
5200,levle3_82.jpg,fore,,,0,1036,501,1122,574,86,73
5201,levle3_82.jpg,fore,,,0,1312,1191,1408,1325,96,134
5202,levle3_82.jpg,fore,,,0,1267,1646,1415,1781,148,135
5203,levle3_82.jpg,fore,,,0,1474,3122,1588,3257,114,135
5204,levle3_82.jpg,fore,,,0,1971,2463,2177,2622,206,159
5205,levle3_82.jpg,fore,,,0,2715,1974,2826,2122,111,148
5206,levle3_82.jpg,fore,,,0,2812,1053,2919,1167,107,114
5207,levle3_82.jpg,fore,,,0,1836,2288,1953,2450,117,162
5208,levle3_82.jpg,fore,,,0,1477,2925,1646,3046,169,121
5209,levle3_82.jpg,fore,,,0,1305,2877,1433,2998,128,121
5210,levle3_82.jpg,fore,,,0,1071,2122,1191,2225,120,103
5211,levle3_82.jpg,fore,,,0,1146,2019,1277,2160,131,141
5212,levle2_5.jpg,fore,Unspecified,0.0,0,175,710,229,764,54,54
5213,levle2_5.jpg,fore,Unspecified,0.0,0,148,579,218,636,70,57
5214,levle2_5.jpg,fore,Unspecified,0.0,0,183,541,240,571,57,30
5215,levle2_5.jpg,fore,Unspecified,0.0,0,232,601,275,636,43,35
5216,levle2_5.jpg,fore,Unspecified,0.0,0,254,479,311,533,57,54
5217,levle2_5.jpg,fore,Unspecified,0.0,0,431,465,482,500,51,35
5218,levle2_5.jpg,fore,Unspecified,0.0,0,452,416,504,454,52,38
5219,levle2_5.jpg,fore,Unspecified,0.0,0,537,490,618,549,81,59
5220,levle2_5.jpg,fore,Unspecified,0.0,0,482,343,518,383,36,40
5221,levle2_5.jpg,fore,Unspecified,0.0,0,501,394,556,443,55,49
5222,levle2_5.jpg,fore,Unspecified,0.0,0,333,484,373,517,40,33
5223,levle2_5.jpg,fore,Unspecified,0.0,0,281,552,354,590,73,38
5224,levle2_5.jpg,fore,Unspecified,0.0,0,360,612,414,688,54,76
5225,levle2_5.jpg,fore,Unspecified,0.0,0,278,386,330,443,52,57
5226,levle2_5.jpg,fore,Unspecified,0.0,0,420,326,463,383,43,57
5227,levle2_5.jpg,fore,Unspecified,0.0,0,534,337,596,373,62,36
5228,levle2_5.jpg,fore,Unspecified,0.0,0,365,411,392,460,27,49
5229,levle2_5.jpg,fore,Unspecified,0.0,0,398,506,452,563,54,57
5230,levle2_5.jpg,fore,Unspecified,0.0,0,425,623,471,666,46,43
5231,levle2_5.jpg,fore,Unspecified,0.0,0,444,740,488,800,44,60
5232,levle2_5.jpg,fore,Unspecified,0.0,0,324,721,387,786,63,65
5233,levle0_339.jpg,fore,Unspecified,0.0,0,1145,2742,1267,2857,122,115
5234,levle0_339.jpg,fore,Unspecified,0.0,0,1919,1930,2057,2075,138,145
5235,levle0_10.jpg,fore,Unspecified,0.0,0,357,92,373,119,16,27
5236,levle0_10.jpg,fore,Unspecified,0.0,0,394,114,424,139,30,25
5237,levle0_10.jpg,fore,Unspecified,0.0,0,314,174,336,194,22,20
5238,levle0_10.jpg,fore,Unspecified,0.0,0,316,246,342,276,26,30
5239,levle0_10.jpg,fore,Unspecified,0.0,0,265,303,291,334,26,31
5240,levle0_10.jpg,fore,Unspecified,0.0,0,170,315,196,342,26,27
5241,levle0_10.jpg,fore,Unspecified,0.0,0,203,317,224,337,21,20
5242,levle0_10.jpg,fore,Unspecified,0.0,0,90,219,110,240,20,21
5243,levle0_10.jpg,fore,Unspecified,0.0,0,63,163,84,191,21,28
5244,levle0_10.jpg,fore,Unspecified,0.0,0,87,164,100,191,13,27
5245,levle0_10.jpg,fore,Unspecified,0.0,0,106,172,118,190,12,18
5246,levle0_10.jpg,fore,Unspecified,0.0,0,106,79,126,106,20,27
5247,levle0_10.jpg,fore,Unspecified,0.0,0,377,85,400,100,23,15
5248,levle0_10.jpg,fore,Unspecified,0.0,0,246,151,269,173,23,22
5249,levle0_10.jpg,fore,Unspecified,0.0,0,343,298,367,316,24,18
5250,levle0_10.jpg,fore,Unspecified,0.0,0,160,240,185,255,25,15
5251,levle0_10.jpg,fore,Unspecified,0.0,0,161,113,188,136,27,23
5252,levle0_10.jpg,fore,Unspecified,0.0,0,219,253,242,276,23,23
5253,levle0_10.jpg,fore,Unspecified,0.0,0,151,157,180,183,29,26
5254,levle0_10.jpg,fore,Unspecified,0.0,0,381,193,406,223,25,30
5255,levle1_116.jpg,fore,Unspecified,0.0,0,2168,2150,2342,2308,174,158
5256,levle1_116.jpg,fore,Unspecified,0.0,0,2982,1701,3049,1892,67,191
5257,levle1_116.jpg,fore,Unspecified,0.0,0,2209,2466,2284,2565,75,99
5258,levle1_116.jpg,fore,Unspecified,0.0,0,2301,2549,2409,2682,108,133
5259,levle1_116.jpg,fore,Unspecified,0.0,0,2284,2698,2384,2815,100,117
5260,levle1_116.jpg,fore,Unspecified,0.0,0,2459,2640,2567,2757,108,117
5261,levle1_116.jpg,fore,Unspecified,0.0,0,2592,2723,2708,2865,116,142
5262,levle0_305.jpg,fore,Unspecified,0.0,0,1873,2297,2018,2412,145,115
5263,levle0_305.jpg,fore,Unspecified,0.0,0,2057,2274,2194,2458,137,184
5264,levle0_38.jpg,fore,Unspecified,0.0,0,386,1462,509,1592,123,130
5265,levle0_38.jpg,fore,Unspecified,0.0,0,547,1401,647,1485,100,84
5266,levle0_38.jpg,fore,Unspecified,0.0,0,440,2290,539,2382,99,92
5267,levle0_38.jpg,fore,Unspecified,0.0,0,524,2382,654,2504,130,122
5268,levle0_463.jpg,fore,Unspecified,0.0,0,1045,1018,1214,1202,169,184
5269,levle0_463.jpg,fore,Unspecified,0.0,0,455,1899,639,2075,184,176
5270,levle0_477.jpg,fore,Unspecified,0.0,0,1535,2297,1673,2497,138,200
5271,levle0_477.jpg,fore,Unspecified,0.0,0,1313,2229,1505,2451,192,222
5272,levle1_102.jpg,fore,Unspecified,0.0,0,2434,712,2558,853,124,141
5273,levle1_102.jpg,fore,Unspecified,0.0,0,2849,1776,3024,2034,175,258
5274,levle1_102.jpg,fore,Unspecified,0.0,0,3107,2241,3232,2391,125,150
5275,levle1_102.jpg,fore,Unspecified,0.0,0,2675,2723,2791,2848,116,125
5276,levle1_102.jpg,fore,Unspecified,0.0,0,2783,2906,2916,3056,133,150
5277,levle1_102.jpg,fore,Unspecified,0.0,0,2367,2873,2508,3006,141,133
5278,levle1_102.jpg,fore,Unspecified,0.0,0,2550,2948,2675,3056,125,108
5279,levle1_102.jpg,fore,Unspecified,0.0,0,3755,1186,3855,1327,100,141
5280,levle0_311.jpg,fore,Unspecified,0.0,0,1114,2091,1237,2190,123,99
5281,levle0_311.jpg,fore,Unspecified,0.0,0,1298,2137,1428,2251,130,114
5282,levle0_311.jpg,fore,Unspecified,0.0,0,1949,3117,2125,3240,176,123
5283,levle0_488.jpg,fore,Unspecified,0.0,0,1689,3025,1911,3148,222,123
5284,levle0_488.jpg,fore,Unspecified,0.0,0,1451,2727,1604,2872,153,145
5285,levle0_488.jpg,fore,Unspecified,0.0,0,1198,2911,1306,3025,108,114
5286,levle0_7.jpg,fore,Unspecified,0.0,0,218,102,262,134,44,32
5287,levle0_7.jpg,fore,Unspecified,0.0,0,214,72,246,97,32,25
5288,levle2_15.jpg,fore,Unspecified,0.0,0,104,100,126,121,22,21
5289,levle2_15.jpg,fore,Unspecified,0.0,0,175,23,195,44,20,21
5290,levle2_15.jpg,fore,Unspecified,0.0,0,205,51,226,68,21,17
5291,levle2_15.jpg,fore,Unspecified,0.0,0,201,64,219,84,18,20
5292,levle2_15.jpg,fore,Unspecified,0.0,0,230,85,255,102,25,17
5293,levle2_15.jpg,fore,Unspecified,0.0,0,201,100,236,123,35,23
5294,levle2_15.jpg,fore,Unspecified,0.0,0,272,73,291,89,19,16
5295,levle2_15.jpg,fore,Unspecified,0.0,0,271,86,293,112,22,26
5296,levle2_15.jpg,fore,Unspecified,0.0,0,297,101,320,123,23,22
5297,levle2_15.jpg,fore,Unspecified,0.0,0,292,141,317,166,25,25
5298,levle2_15.jpg,fore,Unspecified,0.0,0,300,162,327,186,27,24
5299,levle2_15.jpg,fore,Unspecified,0.0,0,323,130,343,155,20,25
5300,levle2_15.jpg,fore,Unspecified,0.0,0,240,244,262,277,22,33
5301,levle2_15.jpg,fore,Unspecified,0.0,0,266,240,291,257,25,17
5302,levle2_15.jpg,fore,Unspecified,0.0,0,323,210,337,239,14,29
5303,levle2_15.jpg,fore,Unspecified,0.0,0,312,257,335,285,23,28
5304,levle2_15.jpg,fore,Unspecified,0.0,0,305,284,327,305,22,21
5305,levle2_15.jpg,fore,Unspecified,0.0,0,275,276,296,297,21,21
5306,levle2_15.jpg,fore,Unspecified,0.0,0,246,272,268,296,22,24
5307,levle2_15.jpg,fore,Unspecified,0.0,0,235,306,259,329,24,23
5308,levle2_15.jpg,fore,Unspecified,0.0,0,267,297,280,322,13,25
5309,levle2_15.jpg,fore,Unspecified,0.0,0,262,318,287,340,25,22
5310,levle2_15.jpg,fore,Unspecified,0.0,0,254,333,274,363,20,30
5311,levle2_15.jpg,fore,Unspecified,0.0,0,278,341,307,369,29,28
5312,levle2_15.jpg,fore,Unspecified,0.0,0,313,321,329,341,16,20
5313,levle2_15.jpg,fore,Unspecified,0.0,0,250,402,279,419,29,17
5314,levle2_15.jpg,fore,Unspecified,0.0,0,229,403,254,431,25,28
5315,levle2_15.jpg,fore,Unspecified,0.0,0,230,357,246,386,16,29
5316,levle2_15.jpg,fore,Unspecified,0.0,0,229,475,259,499,30,24
5317,levle2_15.jpg,fore,Unspecified,0.0,0,191,493,213,515,22,22
5318,levle2_15.jpg,fore,Unspecified,0.0,0,172,313,195,333,23,20
5319,levle2_15.jpg,fore,Unspecified,0.0,0,178,342,205,375,27,33
5320,levle2_15.jpg,fore,Unspecified,0.0,0,197,342,218,357,21,15
5321,levle2_15.jpg,fore,Unspecified,0.0,0,197,439,226,467,29,28
5322,levle2_15.jpg,fore,Unspecified,0.0,0,264,155,287,184,23,29
5323,levle2_189.jpg,fore,Unspecified,0.0,0,1844,1668,2051,1809,207,141
5324,levle2_189.jpg,fore,Unspecified,0.0,0,1627,1502,1810,1660,183,158
5325,levle2_189.jpg,fore,Unspecified,0.0,0,1819,1867,1960,2000,141,133
5326,levle2_189.jpg,fore,Unspecified,0.0,0,1918,2034,2060,2208,142,174
5327,levle2_189.jpg,fore,Unspecified,0.0,0,2051,1917,2176,2092,125,175
5328,levle2_189.jpg,fore,Unspecified,0.0,0,2226,1684,2375,1884,149,200
5329,levle2_189.jpg,fore,Unspecified,0.0,0,2251,1876,2434,2067,183,191
5330,levle2_189.jpg,fore,Unspecified,0.0,0,2375,2050,2542,2250,167,200
5331,levle2_189.jpg,fore,Unspecified,0.0,0,2209,2316,2400,2516,191,200
5332,levle2_189.jpg,fore,Unspecified,0.0,0,2417,2250,2583,2491,166,241
5333,levle2_189.jpg,fore,Unspecified,0.0,0,2068,2582,2209,2682,141,100
5334,levle2_189.jpg,fore,Unspecified,0.0,0,2126,2673,2226,2823,100,150
5335,levle2_189.jpg,fore,Unspecified,0.0,0,1910,2599,2035,2765,125,166
5336,levle2_189.jpg,fore,Unspecified,0.0,0,1760,2474,1877,2665,117,191
5337,levle2_189.jpg,fore,Unspecified,0.0,0,2492,2732,2658,2881,166,149
5338,levle2_189.jpg,fore,Unspecified,0.0,0,2400,2856,2658,3081,258,225
5339,levle2_189.jpg,fore,Unspecified,0.0,0,2209,2773,2434,3031,225,258
5340,levle2_189.jpg,fore,Unspecified,0.0,0,2334,2532,2459,2698,125,166
5341,levle2_189.jpg,fore,Unspecified,0.0,0,2592,2216,2766,2374,174,158
5342,levle2_189.jpg,fore,Unspecified,0.0,0,1852,1410,2060,1576,208,166
5343,levle2_189.jpg,fore,Unspecified,0.0,0,2043,1585,2242,1776,199,191
5344,levle0_259.jpg,fore,Unspecified,0.0,0,1229,3171,1428,3324,199,153
5345,levle0_271.jpg,fore,Unspecified,0.0,0,164,1868,286,2022,122,154
5346,levle0_271.jpg,fore,Unspecified,0.0,0,72,1041,187,1209,115,168
5347,levle0_271.jpg,fore,Unspecified,0.0,0,700,2466,869,2658,169,192
5348,levle0_517.jpg,fore,Unspecified,0.0,0,486,2198,692,2382,206,184
5349,levle0_517.jpg,fore,Unspecified,0.0,0,1014,3179,1122,3294,108,115
5350,levle0_517.jpg,fore,Unspecified,0.0,0,884,2727,1014,2956,130,229
5351,levle0_503.jpg,fore,Unspecified,0.0,0,2601,1907,2762,2114,161,207
5352,levle0_503.jpg,fore,Unspecified,0.0,0,1888,3094,2164,3286,276,192
5353,levle0_503.jpg,fore,Unspecified,0.0,0,1221,1148,1367,1332,146,184
5354,levle0_265.jpg,fore,Unspecified,0.0,0,1298,2504,1443,2696,145,192
5355,levle2_29.jpg,fore,Unspecified,0.0,0,236,80,271,115,35,35
5356,levle2_29.jpg,fore,Unspecified,0.0,0,193,75,248,118,55,43
5357,levle2_29.jpg,fore,Unspecified,0.0,0,204,103,229,128,25,25
5358,levle2_29.jpg,fore,Unspecified,0.0,0,183,123,216,156,33,33
5359,levle2_29.jpg,fore,Unspecified,0.0,0,138,163,171,201,33,38
5360,levle2_29.jpg,fore,Unspecified,0.0,0,161,178,188,200,27,22
5361,levle2_29.jpg,fore,Unspecified,0.0,0,113,206,140,243,27,37
5362,levle2_29.jpg,fore,Unspecified,0.0,0,203,198,226,223,23,25
5363,levle2_29.jpg,fore,Unspecified,0.0,0,166,213,193,250,27,37
5364,levle2_29.jpg,fore,Unspecified,0.0,0,179,231,198,258,19,27
5365,levle2_29.jpg,fore,Unspecified,0.0,0,191,258,216,274,25,16
5366,levle2_29.jpg,fore,Unspecified,0.0,0,321,388,344,413,23,25
5367,levle2_29.jpg,fore,Unspecified,0.0,0,346,384,372,408,26,24
5368,levle2_29.jpg,fore,Unspecified,0.0,0,146,383,186,406,40,23
5369,levle2_29.jpg,fore,Unspecified,0.0,0,153,401,178,434,25,33
5370,levle2_29.jpg,fore,Unspecified,0.0,0,108,507,140,544,32,37
5371,levle2_29.jpg,fore,Unspecified,0.0,0,143,484,163,506,20,22
5372,levle2_29.jpg,fore,Unspecified,0.0,0,155,507,173,531,18,24
5373,levle2_29.jpg,fore,Unspecified,0.0,0,169,476,194,496,25,20
5374,levle2_29.jpg,fore,Unspecified,0.0,0,179,501,203,521,24,20
5375,levle2_29.jpg,fore,Unspecified,0.0,0,188,517,221,541,33,24
5376,levle2_29.jpg,fore,Unspecified,0.0,0,213,519,236,554,23,35
5377,levle2_29.jpg,fore,Unspecified,0.0,0,238,527,256,544,18,17
5378,levle2_29.jpg,fore,Unspecified,0.0,0,196,459,216,486,20,27
5379,levle2_29.jpg,fore,Unspecified,0.0,0,168,431,193,467,25,36
5380,levle2_29.jpg,fore,Unspecified,0.0,0,183,404,221,444,38,40
5381,levle2_29.jpg,fore,Unspecified,0.0,0,303,502,324,527,21,25
5382,levle2_29.jpg,fore,Unspecified,0.0,0,308,477,331,501,23,24
5383,levle2_29.jpg,fore,Unspecified,0.0,0,279,467,298,492,19,25
5384,levle2_29.jpg,fore,Unspecified,0.0,0,243,471,288,512,45,41
5385,levle2_29.jpg,fore,Unspecified,0.0,0,184,286,273,344,89,58
5386,levle2_29.jpg,fore,Unspecified,0.0,0,254,394,288,434,34,40
5387,levle2_29.jpg,fore,Unspecified,0.0,0,216,436,239,466,23,30
5388,levle2_29.jpg,fore,Unspecified,0.0,0,276,439,308,466,32,27
5389,levle2_162.jpg,fore,Unspecified,0.0,0,1574,2489,1612,2665,38,176
5390,levle2_162.jpg,fore,Unspecified,0.0,0,1260,3133,1397,3286,137,153
5391,levle2_162.jpg,fore,Unspecified,0.0,0,1474,3125,1566,3240,92,115
5392,levle2_162.jpg,fore,Unspecified,0.0,0,1696,3071,1827,3209,131,138
5393,levle2_162.jpg,fore,Unspecified,0.0,0,1819,2888,1934,3025,115,137
5394,levle2_162.jpg,fore,Unspecified,0.0,0,1972,2895,2125,3010,153,115
5395,levle2_162.jpg,fore,Unspecified,0.0,0,1903,2796,2072,2918,169,122
5396,levle2_162.jpg,fore,Unspecified,0.0,0,2003,2681,2179,2757,176,76
5397,levle2_162.jpg,fore,Unspecified,0.0,0,2141,2604,2263,2734,122,130
5398,levle2_162.jpg,fore,Unspecified,0.0,0,2148,2903,2233,3018,85,115
5399,levle2_162.jpg,fore,Unspecified,0.0,0,2217,2888,2386,3079,169,191
5400,levle2_162.jpg,fore,Unspecified,0.0,0,2654,2435,2716,2589,62,154
5401,levle2_162.jpg,fore,Unspecified,0.0,0,2693,2267,2861,2366,168,99
5402,levle2_162.jpg,fore,Unspecified,0.0,0,2685,2106,2869,2251,184,145
5403,levle2_162.jpg,fore,Unspecified,0.0,0,2363,2091,2539,2206,176,115
5404,levle2_162.jpg,fore,Unspecified,0.0,0,2624,1999,2731,2045,107,46
5405,levle2_162.jpg,fore,Unspecified,0.0,0,2516,1884,2654,1999,138,115
5406,levle2_162.jpg,fore,Unspecified,0.0,0,2631,1838,2746,1953,115,115
5407,levle2_162.jpg,fore,Unspecified,0.0,0,2716,1907,2815,2014,99,107
5408,levle2_162.jpg,fore,Unspecified,0.0,0,2861,1853,2968,1968,107,115
5409,levle2_162.jpg,fore,Unspecified,0.0,0,2693,1661,2869,1799,176,138
5410,levle2_176.jpg,fore,Unspecified,0.0,0,1574,428,1788,589,214,161
5411,levle2_176.jpg,fore,Unspecified,0.0,0,1727,397,1888,497,161,100
5412,levle2_176.jpg,fore,Unspecified,0.0,0,1727,251,1842,336,115,85
5413,levle2_176.jpg,fore,Unspecified,0.0,0,823,1646,991,1761,168,115
5414,levle2_176.jpg,fore,Unspecified,0.0,0,922,1822,1076,1899,154,77
5415,levle2_176.jpg,fore,Unspecified,0.0,0,1007,1884,1099,1991,92,107
5416,levle2_176.jpg,fore,Unspecified,0.0,0,1252,1838,1382,1968,130,130
5417,levle2_176.jpg,fore,Unspecified,0.0,0,1359,1807,1543,1930,184,123
5418,levle2_176.jpg,fore,Unspecified,0.0,0,1551,1715,1704,1769,153,54
5419,levle2_176.jpg,fore,Unspecified,0.0,0,1551,1799,1727,1945,176,146
5420,levle2_176.jpg,fore,Unspecified,0.0,0,1505,1976,1650,2068,145,92
5421,levle2_176.jpg,fore,Unspecified,0.0,0,1420,2167,1528,2259,108,92
5422,levle2_176.jpg,fore,Unspecified,0.0,0,1198,2229,1436,2336,238,107
5423,levle2_176.jpg,fore,Unspecified,0.0,0,738,2190,884,2366,146,176
5424,levle2_176.jpg,fore,Unspecified,0.0,0,892,2512,1007,2658,115,146
5425,levle2_176.jpg,fore,Unspecified,0.0,0,1014,2543,1168,2727,154,184
5426,levle2_176.jpg,fore,Unspecified,0.0,0,1750,2382,1857,2527,107,145
5427,levle2_176.jpg,fore,Unspecified,0.0,0,1865,2382,2026,2474,161,92
5428,levle2_176.jpg,fore,Unspecified,0.0,0,1842,2297,1988,2397,146,100
5429,levle2_176.jpg,fore,Unspecified,0.0,0,1850,1799,2018,1960,168,161
5430,levle2_176.jpg,fore,Unspecified,0.0,0,1750,2826,1903,2926,153,100
5431,levle2_176.jpg,fore,Unspecified,0.0,0,1604,2911,1727,3018,123,107
5432,levle2_176.jpg,fore,Unspecified,0.0,0,731,1876,984,2045,253,169
5433,levle2_176.jpg,fore,Unspecified,0.0,0,1106,2290,1329,2543,223,253
5434,levle2_176.jpg,fore,Unspecified,0.0,0,1896,290,1995,428,99,138
5435,levle2_176.jpg,fore,Unspecified,0.0,0,2011,328,2125,474,114,146
5436,levle1_248.jpg,fore,Unspecified,0.0,0,1765,2313,1911,2435,146,122
5437,levle1_248.jpg,fore,Unspecified,0.0,0,2011,2512,2156,2635,145,123
5438,levle1_248.jpg,fore,Unspecified,0.0,0,2447,2098,2547,2190,100,92
5439,levle1_248.jpg,fore,Unspecified,0.0,0,2409,2213,2532,2343,123,130
5440,levle1_248.jpg,fore,Unspecified,0.0,0,2102,3041,2233,3171,131,130
5441,levle1_248.jpg,fore,Unspecified,0.0,0,1980,3110,2064,3240,84,130
5442,levle1_248.jpg,fore,Unspecified,0.0,0,2194,2060,2286,2206,92,146
5443,levle1_248.jpg,fore,Unspecified,0.0,0,2348,3041,2440,3148,92,107
5444,levle1_78.jpg,fore,Unspecified,0.0,0,4129,1061,4295,1219,166,158
5445,levle1_78.jpg,fore,Unspecified,0.0,0,3090,363,3240,529,150,166
5446,levle1_78.jpg,fore,Unspecified,0.0,0,2592,1277,2749,1485,157,208
5447,levle1_78.jpg,fore,Unspecified,0.0,0,2342,1452,2525,1660,183,208
5448,levle1_78.jpg,fore,Unspecified,0.0,0,2550,1635,2749,1842,199,207
5449,levle1_78.jpg,fore,Unspecified,0.0,0,2791,1684,2949,1809,158,125
5450,levle1_78.jpg,fore,Unspecified,0.0,0,2758,1817,2874,1950,116,133
5451,levle1_78.jpg,fore,Unspecified,0.0,0,2616,1892,2774,2050,158,158
5452,levle1_78.jpg,fore,Unspecified,0.0,0,3348,1942,3514,2075,166,133
5453,levle1_78.jpg,fore,Unspecified,0.0,0,3398,2723,3564,2931,166,208
5454,levle1_50.jpg,fore,Unspecified,0.0,0,2286,788,2394,887,108,99
5455,levle1_50.jpg,fore,Unspecified,0.0,0,1168,1340,1313,1508,145,168
5456,levle1_50.jpg,fore,Unspecified,0.0,0,1344,1294,1466,1447,122,153
5457,levle1_50.jpg,fore,Unspecified,0.0,0,1474,1386,1604,1562,130,176
5458,levle1_50.jpg,fore,Unspecified,0.0,0,953,2206,1060,2343,107,137
5459,levle1_50.jpg,fore,Unspecified,0.0,0,1198,2282,1336,2366,138,84
5460,levle1_50.jpg,fore,Unspecified,0.0,0,1137,2320,1229,2474,92,154
5461,levle1_50.jpg,fore,Unspecified,0.0,0,1237,2389,1375,2550,138,161
5462,levle1_50.jpg,fore,Unspecified,0.0,0,1405,2328,1482,2428,77,100
5463,levle1_50.jpg,fore,Unspecified,0.0,0,1535,2389,1574,2520,39,131
5464,levle1_50.jpg,fore,Unspecified,0.0,0,1796,2359,1888,2520,92,161
5465,levle1_50.jpg,fore,Unspecified,0.0,0,1888,2290,2034,2458,146,168
5466,levle1_50.jpg,fore,Unspecified,0.0,0,1911,2481,2057,2704,146,223
5467,levle1_506.jpg,fore,Unspecified,0.0,0,463,1661,593,1815,130,154
5468,levle1_506.jpg,fore,Unspecified,0.0,0,294,2282,417,2397,123,115
5469,levle1_506.jpg,fore,Unspecified,0.0,0,478,2389,654,2543,176,154
5470,levle1_506.jpg,fore,Unspecified,0.0,0,125,2803,263,2918,138,115
5471,levle1_506.jpg,fore,Unspecified,0.0,0,148,2972,263,3102,115,130
5472,levle1_506.jpg,fore,Unspecified,0.0,0,1788,1661,1896,1799,108,138
5473,levle1_506.jpg,fore,Unspecified,0.0,0,1114,1056,1252,1240,138,184
5474,levle1_260.jpg,fore,Unspecified,0.0,0,2410,2389,2507,2476,97,87
5475,levle1_260.jpg,fore,Unspecified,0.0,0,2560,1073,2647,1134,87,61
5476,levle1_260.jpg,fore,Unspecified,0.0,0,2630,976,2700,1099,70,123
5477,levle1_260.jpg,fore,Unspecified,0.0,0,2516,1125,2595,1196,79,71
5478,levle1_260.jpg,fore,Unspecified,0.0,0,2779,1011,2858,1073,79,62
5479,levle1_260.jpg,fore,Unspecified,0.0,0,2507,836,2639,906,132,70
5480,levle1_260.jpg,fore,Unspecified,0.0,0,2533,1283,2621,1389,88,106
5481,levle1_260.jpg,fore,Unspecified,0.0,0,2446,1011,2542,1117,96,106
5482,levle1_274.jpg,fore,Unspecified,0.0,0,715,1976,838,2129,123,153
5483,levle1_274.jpg,fore,Unspecified,0.0,0,1007,1033,1168,1194,161,161
5484,levle1_274.jpg,fore,Unspecified,0.0,0,1804,2313,1926,2512,122,199
5485,levle1_274.jpg,fore,Unspecified,0.0,0,1934,2305,2079,2458,145,153
5486,levle1_274.jpg,fore,Unspecified,0.0,0,2455,2022,2562,2183,107,161
5487,levle1_274.jpg,fore,Unspecified,0.0,0,2325,1899,2470,2114,145,215
5488,levle1_274.jpg,fore,Unspecified,0.0,0,2141,2320,2240,2489,99,169
5489,levle1_44.jpg,fore,Unspecified,0.0,0,1060,589,1152,704,92,115
5490,levle1_44.jpg,fore,Unspecified,0.0,0,1114,2144,1229,2297,115,153
5491,levle1_44.jpg,fore,Unspecified,0.0,0,1175,2420,1313,2589,138,169
5492,levle1_44.jpg,fore,Unspecified,0.0,0,1390,2397,1566,2581,176,184
5493,levle1_44.jpg,fore,Unspecified,0.0,0,1459,2160,1612,2305,153,145
5494,levle1_44.jpg,fore,Unspecified,0.0,0,1612,1953,1742,2121,130,168
5495,levle1_44.jpg,fore,Unspecified,0.0,0,1819,2037,1942,2175,123,138
5496,levle1_512.jpg,fore,Unspecified,0.0,0,1742,512,1842,650,100,138
5497,levle1_512.jpg,fore,Unspecified,0.0,0,1865,596,2057,803,192,207
5498,levle1_512.jpg,fore,Unspecified,0.0,0,1612,2320,1727,2405,115,85
5499,levle1_512.jpg,fore,Unspecified,0.0,0,1696,2918,1781,3071,85,153
5500,levle1_512.jpg,fore,Unspecified,0.0,0,1375,3010,1459,3117,84,107
5501,levle1_512.jpg,fore,Unspecified,0.0,0,493,2213,585,2359,92,146
5502,levle1_512.jpg,fore,Unspecified,0.0,0,1528,3056,1658,3194,130,138
5503,levle1_93.jpg,fore,Unspecified,0.0,0,2966,1418,3207,1626,241,208
5504,levle1_93.jpg,fore,Unspecified,0.0,0,3198,1975,3398,2083,200,108
5505,levle1_93.jpg,fore,Unspecified,0.0,0,3223,1610,3389,1743,166,133
5506,levle1_93.jpg,fore,Unspecified,0.0,0,3464,1651,3689,1801,225,150
5507,levle1_93.jpg,fore,Unspecified,0.0,0,3896,1635,4096,1759,200,124
5508,levle1_93.jpg,fore,Unspecified,0.0,0,3830,1809,3971,1984,141,175
5509,levle1_93.jpg,fore,Unspecified,0.0,0,3805,1460,3921,1601,116,141
5510,levle1_93.jpg,fore,Unspecified,0.0,0,4004,1294,4162,1510,158,216
5511,levle1_87.jpg,fore,Unspecified,0.0,0,1819,2782,1968,2923,149,141
5512,levle1_87.jpg,fore,Unspecified,0.0,0,2417,2516,2641,2690,224,174
5513,levle1_87.jpg,fore,Unspecified,0.0,0,3348,1551,3514,1709,166,158
5514,levle1_87.jpg,fore,Unspecified,0.0,0,2974,1327,3148,1485,174,158
5515,levle1_87.jpg,fore,Unspecified,0.0,0,3497,1236,3655,1410,158,174
5516,levle1_87.jpg,fore,Unspecified,0.0,0,3074,587,3232,828,158,241
5517,levle1_87.jpg,fore,Unspecified,0.0,0,3107,222,3240,338,133,116
5518,levle1_87.jpg,fore,Unspecified,0.0,0,3090,80,3165,205,75,125
5519,levle1_87.jpg,fore,Unspecified,0.0,0,2608,247,2691,355,83,108
5520,levle1_87.jpg,fore,Unspecified,0.0,0,2749,205,2874,355,125,150
5521,levle1_92.jpg,fore,Unspecified,0.0,0,2600,2108,2783,2341,183,233
5522,levle1_92.jpg,fore,Unspecified,0.0,0,2126,2009,2334,2158,208,149
5523,levle1_92.jpg,fore,Unspecified,0.0,0,2226,2216,2367,2408,141,192
5524,levle1_92.jpg,fore,Unspecified,0.0,0,2292,770,2434,978,142,208
5525,levle1_92.jpg,fore,Unspecified,0.0,0,2608,330,2758,496,150,166
5526,levle1_92.jpg,fore,Unspecified,0.0,0,3057,621,3198,812,141,191
5527,levle1_275.jpg,fore,,,0,317,2206,501,2305,184,99
5528,levle1_275.jpg,fore,,,0,348,2366,524,2527,176,161
5529,levle1_275.jpg,fore,,,0,394,773,516,903,122,130
5530,levle1_275.jpg,fore,,,0,18,2750,102,2934,84,184
5531,levle1_275.jpg,fore,,,0,64,2290,225,2497,161,207
5532,levle1_275.jpg,fore,,,0,657,2408,815,2546,158,138
5533,levle1_513.jpg,fore,Unspecified,0.0,0,1650,1830,1819,1922,169,92
5534,levle1_513.jpg,fore,Unspecified,0.0,0,1397,880,1520,995,123,115
5535,levle1_513.jpg,fore,Unspecified,0.0,0,1635,849,1750,987,115,138
5536,levle1_513.jpg,fore,Unspecified,0.0,0,2708,1278,2784,1401,76,123
5537,levle1_513.jpg,fore,Unspecified,0.0,0,2493,1209,2608,1294,115,85
5538,levle1_513.jpg,fore,Unspecified,0.0,0,2486,1340,2601,1424,115,84
5539,levle1_513.jpg,fore,Unspecified,0.0,0,2616,1317,2739,1478,123,161
5540,levle1_45.jpg,fore,Unspecified,0.0,0,984,1294,1106,1432,122,138
5541,levle1_45.jpg,fore,Unspecified,0.0,0,784,1370,938,1524,154,154
5542,levle1_45.jpg,fore,Unspecified,0.0,0,1873,527,2041,612,168,85
5543,levle1_45.jpg,fore,Unspecified,0.0,0,1888,788,2072,1025,184,237
5544,levle1_45.jpg,fore,Unspecified,0.0,0,861,2198,1030,2305,169,107
5545,levle1_45.jpg,fore,Unspecified,0.0,0,861,2320,999,2420,138,100
5546,levle1_45.jpg,fore,Unspecified,0.0,0,1014,2297,1175,2428,161,131
5547,levle1_45.jpg,fore,Unspecified,0.0,0,1037,2435,1183,2535,146,100
5548,levle1_45.jpg,fore,Unspecified,0.0,0,1068,2527,1290,2704,222,177
5549,levle1_45.jpg,fore,Unspecified,0.0,0,1229,2282,1306,2435,77,153
5550,levle1_45.jpg,fore,Unspecified,0.0,0,1420,2359,1505,2520,85,161
5551,levle1_45.jpg,fore,Unspecified,0.0,0,1497,2305,1643,2443,146,138
5552,levle1_45.jpg,fore,Unspecified,0.0,0,1551,2458,1666,2642,115,184
5553,levle1_507.jpg,fore,Unspecified,0.0,0,1221,788,1306,895,85,107
5554,levle1_507.jpg,fore,Unspecified,0.0,0,1865,1531,1980,1631,115,100
5555,levle1_507.jpg,fore,Unspecified,0.0,0,830,1677,968,1807,138,130
5556,levle1_507.jpg,fore,Unspecified,0.0,0,1420,2589,1551,2719,131,130
5557,levle1_507.jpg,fore,Unspecified,0.0,0,1758,2895,1857,3002,99,107
5558,levle1_507.jpg,fore,Unspecified,0.0,0,1788,2681,1934,2834,146,153
5559,levle1_507.jpg,fore,Unspecified,0.0,0,1313,2911,1420,3025,107,114
5560,levle1_507.jpg,fore,Unspecified,0.0,0,1198,2895,1298,2987,100,92
5561,levle1_507.jpg,fore,Unspecified,0.0,0,884,3071,1037,3194,153,123
5562,levle1_507.jpg,fore,Unspecified,0.0,0,670,1278,792,1416,122,138
5563,levle1_51.jpg,fore,Unspecified,0.0,0,662,2098,800,2229,138,131
5564,levle1_51.jpg,fore,Unspecified,0.0,0,915,2160,1068,2320,153,160
5565,levle1_51.jpg,fore,Unspecified,0.0,0,807,2282,968,2428,161,146
5566,levle1_51.jpg,fore,Unspecified,0.0,0,991,2328,1091,2458,100,130
5567,levle1_51.jpg,fore,Unspecified,0.0,0,1099,2397,1175,2527,76,130
5568,levle1_51.jpg,fore,Unspecified,0.0,0,1083,2244,1175,2343,92,99
5569,levle1_51.jpg,fore,Unspecified,0.0,0,1612,2229,1712,2351,100,122
5570,levle1_51.jpg,fore,Unspecified,0.0,0,1466,2297,1604,2443,138,146
5571,levle1_51.jpg,fore,Unspecified,0.0,0,1597,2382,1788,2573,191,191
5572,levle1_51.jpg,fore,Unspecified,0.0,0,1742,704,1903,895,161,191
5573,levle1_51.jpg,fore,Unspecified,0.0,0,876,1286,1045,1478,169,192
5574,levle1_51.jpg,fore,Unspecified,0.0,0,1014,1232,1298,1432,284,200
5575,levle1_261.jpg,fore,Unspecified,0.0,0,2103,1327,2218,1485,115,158
5576,levle1_261.jpg,fore,Unspecified,0.0,0,2481,1134,2560,1231,79,97
5577,levle1_261.jpg,fore,Unspecified,0.0,0,2568,1152,2656,1239,88,87
5578,levle1_261.jpg,fore,Unspecified,0.0,0,2007,1011,2103,1099,96,88
5579,levle1_261.jpg,fore,Unspecified,0.0,0,1972,854,2095,976,123,122
5580,levle1_261.jpg,fore,Unspecified,0.0,0,2270,713,2393,818,123,105
5581,levle1_261.jpg,fore,Unspecified,0.0,0,2147,968,2235,1047,88,79
5582,levle1_261.jpg,fore,Unspecified,0.0,0,2174,1073,2253,1125,79,52
5583,levle1_249.jpg,fore,Unspecified,0.0,0,2034,2826,2141,2972,107,146
5584,levle1_249.jpg,fore,Unspecified,0.0,0,1965,3010,2026,3133,61,123
5585,levle1_249.jpg,fore,Unspecified,0.0,0,1781,3087,1896,3186,115,99
5586,levle1_249.jpg,fore,Unspecified,0.0,0,1512,3117,1612,3209,100,92
5587,levle1_249.jpg,fore,Unspecified,0.0,0,2432,3018,2516,3133,84,115
5588,levle1_249.jpg,fore,Unspecified,0.0,0,2248,3033,2348,3156,100,123
5589,levle1_249.jpg,fore,Unspecified,0.0,0,2325,2926,2455,3033,130,107
5590,levle1_79.jpg,fore,Unspecified,0.0,0,3597,546,3689,712,92,166
5591,levle1_79.jpg,fore,Unspecified,0.0,0,2467,1219,2608,1427,141,208
5592,levle1_79.jpg,fore,Unspecified,0.0,0,2691,1734,2808,1851,117,117
5593,levle1_79.jpg,fore,Unspecified,0.0,0,2749,1892,2849,2017,100,125
5594,levle1_79.jpg,fore,Unspecified,0.0,0,2616,2125,2708,2233,92,108
5595,levle1_79.jpg,fore,Unspecified,0.0,0,2733,2150,2849,2333,116,183
5596,levle1_79.jpg,fore,Unspecified,0.0,0,2982,2150,3132,2308,150,158
5597,levle1_79.jpg,fore,Unspecified,0.0,0,2866,1635,2957,1759,91,124
5598,levle1_79.jpg,fore,Unspecified,0.0,0,2749,1385,2924,1568,175,183
5599,levle1_79.jpg,fore,Unspecified,0.0,0,2949,1975,3057,2083,108,108
5600,levle2_177.jpg,fore,Unspecified,0.0,0,2325,1294,2501,1393,176,99
5601,levle2_177.jpg,fore,Unspecified,0.0,0,2608,1455,2754,1569,146,114
5602,levle2_177.jpg,fore,Unspecified,0.0,0,1183,1378,1344,1478,161,100
5603,levle2_177.jpg,fore,Unspecified,0.0,0,1344,1485,1459,1661,115,176
5604,levle2_177.jpg,fore,Unspecified,0.0,0,938,979,1145,1156,207,177
5605,levle2_177.jpg,fore,Unspecified,0.0,0,1543,1041,1666,1163,123,122
5606,levle2_177.jpg,fore,Unspecified,0.0,0,1857,1033,2110,1209,253,176
5607,levle2_177.jpg,fore,Unspecified,0.0,0,1650,1922,1796,2029,146,107
5608,levle2_177.jpg,fore,Unspecified,0.0,0,1880,2045,1988,2144,108,99
5609,levle2_177.jpg,fore,Unspecified,0.0,0,1995,1999,2102,2198,107,199
5610,levle2_177.jpg,fore,Unspecified,0.0,0,2102,2029,2233,2160,131,131
5611,levle2_177.jpg,fore,Unspecified,0.0,0,2011,2297,2217,2481,206,184
5612,levle2_177.jpg,fore,Unspecified,0.0,0,2271,2045,2394,2152,123,107
5613,levle2_177.jpg,fore,Unspecified,0.0,0,2432,2129,2547,2274,115,145
5614,levle2_177.jpg,fore,Unspecified,0.0,0,2693,2045,2838,2190,145,145
5615,levle2_177.jpg,fore,Unspecified,0.0,0,2616,2282,2861,2435,245,153
5616,levle2_177.jpg,fore,Unspecified,0.0,0,2424,2366,2670,2466,246,100
5617,levle2_177.jpg,fore,Unspecified,0.0,0,2340,2458,2662,2642,322,184
5618,levle2_177.jpg,fore,Unspecified,0.0,0,1681,3010,1781,3087,100,77
5619,levle2_177.jpg,fore,Unspecified,0.0,0,2570,2114,2723,2282,153,168
5620,levle2_177.jpg,fore,Unspecified,0.0,0,1719,2911,1873,3018,154,107
5621,levle2_177.jpg,fore,Unspecified,0.0,0,1873,2865,2072,2987,199,122
5622,levle2_177.jpg,fore,Unspecified,0.0,0,1919,2987,2118,3087,199,100
5623,levle2_177.jpg,fore,Unspecified,0.0,0,1896,3102,2171,3225,275,123
5624,levle2_177.jpg,fore,Unspecified,0.0,0,1727,3056,1972,3186,245,130
5625,levle2_177.jpg,fore,Unspecified,0.0,0,1735,3194,1949,3332,214,138
5626,levle2_163.jpg,fore,Unspecified,0.0,0,2516,1317,2601,1393,85,76
5627,levle2_163.jpg,fore,Unspecified,0.0,0,2294,1983,2417,2152,123,169
5628,levle2_163.jpg,fore,Unspecified,0.0,0,2432,2259,2532,2405,100,146
5629,levle2_163.jpg,fore,Unspecified,0.0,0,2317,2320,2386,2374,69,54
5630,levle2_163.jpg,fore,Unspecified,0.0,0,2355,2366,2424,2428,69,62
5631,levle2_163.jpg,fore,Unspecified,0.0,0,2317,2420,2432,2481,115,61
5632,levle2_163.jpg,fore,Unspecified,0.0,0,2240,2466,2447,2558,207,92
5633,levle2_163.jpg,fore,Unspecified,0.0,0,2302,2558,2424,2627,122,69
5634,levle2_163.jpg,fore,Unspecified,0.0,0,2095,2489,2217,2619,122,130
5635,levle2_163.jpg,fore,Unspecified,0.0,0,1980,2581,2102,2681,122,100
5636,levle2_163.jpg,fore,Unspecified,0.0,0,1972,2665,2102,2734,130,69
5637,levle2_163.jpg,fore,Unspecified,0.0,0,2156,2673,2294,2765,138,92
5638,levle2_163.jpg,fore,Unspecified,0.0,0,2164,2757,2309,2872,145,115
5639,levle2_163.jpg,fore,Unspecified,0.0,0,2156,2849,2263,2949,107,100
5640,levle2_163.jpg,fore,Unspecified,0.0,0,2079,2918,2194,3041,115,123
5641,levle2_163.jpg,fore,Unspecified,0.0,0,2087,3094,2156,3156,69,62
5642,levle2_163.jpg,fore,Unspecified,0.0,0,1957,3033,2041,3110,84,77
5643,levle2_163.jpg,fore,Unspecified,0.0,0,2148,3041,2256,3140,108,99
5644,levle2_163.jpg,fore,Unspecified,0.0,0,2286,2911,2378,2995,92,84
5645,levle2_163.jpg,fore,Unspecified,0.0,0,2271,2995,2409,3117,138,122
5646,levle2_163.jpg,fore,Unspecified,0.0,0,2447,2926,2585,3056,138,130
5647,levle2_163.jpg,fore,Unspecified,0.0,0,2524,2842,2654,2956,130,114
5648,levle2_163.jpg,fore,Unspecified,0.0,0,2501,2727,2601,2811,100,84
5649,levle2_163.jpg,fore,Unspecified,0.0,0,2294,2612,2447,2727,153,115
5650,levle2_163.jpg,fore,Unspecified,0.0,0,2447,2627,2601,2750,154,123
5651,levle2_163.jpg,fore,Unspecified,0.0,0,968,1853,1099,1968,131,115
5652,levle2_163.jpg,fore,Unspecified,0.0,0,2463,1225,2585,1324,122,99
5653,levle2_163.jpg,fore,Unspecified,0.0,0,2547,1140,2677,1263,130,123
5654,levle2_163.jpg,fore,Unspecified,0.0,0,2417,987,2562,1133,145,146
5655,levle2_163.jpg,fore,Unspecified,0.0,0,2141,412,2248,573,107,161
5656,levle2_163.jpg,fore,Unspecified,0.0,0,2194,328,2325,435,131,107
5657,levle2_163.jpg,fore,Unspecified,0.0,0,1666,566,1827,658,161,92
5658,levle2_28.jpg,fore,Unspecified,0.0,0,1653,441,1705,496,52,55
5659,levle2_28.jpg,fore,Unspecified,0.0,0,1634,480,1689,538,55,58
5660,levle2_28.jpg,fore,Unspecified,0.0,0,1585,454,1631,502,46,48
5661,levle2_28.jpg,fore,Unspecified,0.0,0,1673,535,1744,587,71,52
5662,levle2_28.jpg,fore,Unspecified,0.0,0,1419,632,1458,694,39,62
5663,levle2_28.jpg,fore,Unspecified,0.0,0,532,476,578,509,46,33
5664,levle2_28.jpg,fore,Unspecified,0.0,0,562,502,617,558,55,56
5665,levle2_28.jpg,fore,Unspecified,0.0,0,857,281,965,346,108,65
5666,levle2_28.jpg,fore,Unspecified,0.0,0,857,174,903,216,46,42
5667,levle2_28.jpg,fore,Unspecified,0.0,0,893,142,968,190,75,48
5668,levle2_28.jpg,fore,Unspecified,0.0,0,926,197,978,249,52,52
5669,levle2_28.jpg,fore,Unspecified,0.0,0,1036,184,1082,229,46,45
5670,levle2_28.jpg,fore,Unspecified,0.0,0,1095,203,1156,265,61,62
5671,levle2_28.jpg,fore,Unspecified,0.0,0,1192,197,1280,272,88,75
5672,levle2_28.jpg,fore,Unspecified,0.0,0,1192,242,1224,291,32,49
5673,levle2_28.jpg,fore,Unspecified,0.0,0,1224,275,1280,337,56,62
5674,levle2_28.jpg,fore,Unspecified,0.0,0,1293,346,1338,398,45,52
5675,levle2_28.jpg,fore,Unspecified,0.0,0,1338,330,1397,389,59,59
5676,levle2_28.jpg,fore,Unspecified,0.0,0,1442,444,1504,496,62,52
5677,levle2_28.jpg,fore,Unspecified,0.0,0,1377,437,1426,499,49,62
5678,levle2_28.jpg,fore,Unspecified,0.0,0,1306,392,1364,463,58,71
5679,levle2_28.jpg,fore,Unspecified,0.0,0,1416,359,1510,389,94,30
5680,levle2_28.jpg,fore,Unspecified,0.0,0,1494,304,1527,350,33,46
5681,levle2_28.jpg,fore,Unspecified,0.0,0,1543,242,1618,324,75,82
5682,levle2_28.jpg,fore,Unspecified,0.0,0,1348,281,1429,317,81,36
5683,levle2_28.jpg,fore,Unspecified,0.0,0,1384,226,1429,268,45,42
5684,levle2_28.jpg,fore,Unspecified,0.0,0,1293,197,1371,246,78,49
5685,levle2_28.jpg,fore,Unspecified,0.0,0,1315,151,1403,194,88,43
5686,levle2_28.jpg,fore,Unspecified,0.0,0,1166,177,1244,220,78,43
5687,levle2_28.jpg,fore,Unspecified,0.0,0,1172,112,1234,187,62,75
5688,levle2_28.jpg,fore,Unspecified,0.0,0,1124,119,1159,168,35,49
5689,levle0_264.jpg,fore,Unspecified,0.0,0,1857,2098,2011,2259,154,161
5690,levle0_264.jpg,fore,Unspecified,0.0,0,861,2060,961,2221,100,161
5691,levle0_270.jpg,fore,Unspecified,0.0,0,1597,2328,1712,2451,115,123
5692,levle0_270.jpg,fore,Unspecified,0.0,0,1643,2750,1788,2926,145,176
5693,levle0_516.jpg,fore,Unspecified,0.0,0,2133,2037,2332,2305,199,268
5694,levle0_516.jpg,fore,Unspecified,0.0,0,2110,2405,2302,2558,192,153
5695,levle0_516.jpg,fore,Unspecified,0.0,0,2501,2060,2616,2190,115,130
5696,levle0_258.jpg,fore,Unspecified,0.0,0,1053,3202,1191,3363,138,161
5697,levle2_188.jpg,fore,Unspecified,0.0,0,157,91,169,107,12,16
5698,levle2_188.jpg,fore,Unspecified,0.0,0,146,74,158,84,12,10
5699,levle2_188.jpg,fore,Unspecified,0.0,0,138,86,156,103,18,17
5700,levle2_188.jpg,fore,Unspecified,0.0,0,128,85,137,98,9,13
5701,levle2_188.jpg,fore,Unspecified,0.0,0,115,92,125,100,10,8
5702,levle2_188.jpg,fore,Unspecified,0.0,0,117,107,126,115,9,8
5703,levle2_188.jpg,fore,Unspecified,0.0,0,110,103,117,111,7,8
5704,levle2_188.jpg,fore,Unspecified,0.0,0,110,116,119,123,9,7
5705,levle2_188.jpg,fore,Unspecified,0.0,0,111,124,122,136,11,12
5706,levle2_188.jpg,fore,Unspecified,0.0,0,99,118,108,127,9,9
5707,levle2_188.jpg,fore,Unspecified,0.0,0,146,134,159,142,13,8
5708,levle2_188.jpg,fore,Unspecified,0.0,0,145,144,157,155,12,11
5709,levle2_188.jpg,fore,Unspecified,0.0,0,132,130,138,138,6,8
5710,levle2_188.jpg,fore,Unspecified,0.0,0,121,134,130,143,9,9
5711,levle2_188.jpg,fore,Unspecified,0.0,0,129,144,135,149,6,5
5712,levle2_188.jpg,fore,Unspecified,0.0,0,125,147,135,161,10,14
5713,levle2_188.jpg,fore,Unspecified,0.0,0,107,151,118,161,11,10
5714,levle2_188.jpg,fore,Unspecified,0.0,0,99,161,110,169,11,8
5715,levle2_188.jpg,fore,Unspecified,0.0,0,102,166,110,177,8,11
5716,levle2_188.jpg,fore,Unspecified,0.0,0,116,157,125,165,9,8
5717,levle2_188.jpg,fore,Unspecified,0.0,0,128,170,141,176,13,6
5718,levle2_188.jpg,fore,Unspecified,0.0,0,134,176,143,186,9,10
5719,levle2_188.jpg,fore,Unspecified,0.0,0,142,171,154,186,12,15
5720,levle2_188.jpg,fore,Unspecified,0.0,0,152,177,163,186,11,9
5721,levle2_188.jpg,fore,Unspecified,0.0,0,137,190,145,199,8,9
5722,levle2_188.jpg,fore,Unspecified,0.0,0,126,187,134,194,8,7
5723,levle2_188.jpg,fore,Unspecified,0.0,0,94,187,106,200,12,13
5724,levle2_188.jpg,fore,Unspecified,0.0,0,91,178,101,188,10,10
5725,levle2_188.jpg,fore,Unspecified,0.0,0,120,192,126,204,6,12
5726,levle2_188.jpg,fore,Unspecified,0.0,0,128,196,136,211,8,15
5727,levle2_188.jpg,fore,Unspecified,0.0,0,133,201,145,216,12,15
5728,levle2_188.jpg,fore,Unspecified,0.0,0,147,195,156,209,9,14
5729,levle2_14.jpg,fore,Unspecified,0.0,0,196,86,213,98,17,12
5730,levle2_14.jpg,fore,Unspecified,0.0,0,188,90,200,105,12,15
5731,levle2_14.jpg,fore,Unspecified,0.0,0,184,69,201,88,17,19
5732,levle2_14.jpg,fore,Unspecified,0.0,0,157,77,166,90,9,13
5733,levle2_14.jpg,fore,Unspecified,0.0,0,167,77,181,89,14,12
5734,levle2_14.jpg,fore,Unspecified,0.0,0,161,92,183,107,22,15
5735,levle2_14.jpg,fore,Unspecified,0.0,0,148,112,164,133,16,21
5736,levle2_14.jpg,fore,Unspecified,0.0,0,136,94,150,116,14,22
5737,levle2_14.jpg,fore,Unspecified,0.0,0,130,163,140,178,10,15
5738,levle2_14.jpg,fore,Unspecified,0.0,0,131,183,147,201,16,18
5739,levle2_14.jpg,fore,Unspecified,0.0,0,155,170,164,187,9,17
5740,levle2_14.jpg,fore,Unspecified,0.0,0,171,166,192,184,21,18
5741,levle2_14.jpg,fore,Unspecified,0.0,0,184,189,196,208,12,19
5742,levle2_14.jpg,fore,Unspecified,0.0,0,183,209,196,227,13,18
5743,levle2_14.jpg,fore,Unspecified,0.0,0,164,210,180,228,16,18
5744,levle2_14.jpg,fore,Unspecified,0.0,0,154,208,166,226,12,18
5745,levle2_14.jpg,fore,Unspecified,0.0,0,146,191,156,205,10,14
5746,levle2_14.jpg,fore,Unspecified,0.0,0,139,212,156,233,17,21
5747,levle2_14.jpg,fore,Unspecified,0.0,0,138,228,156,243,18,15
5748,levle2_14.jpg,fore,Unspecified,0.0,0,139,251,148,264,9,13
5749,levle2_14.jpg,fore,Unspecified,0.0,0,159,249,175,262,16,13
5750,levle2_14.jpg,fore,Unspecified,0.0,0,161,263,174,277,13,14
5751,levle2_14.jpg,fore,Unspecified,0.0,0,178,232,188,250,10,18
5752,levle2_14.jpg,fore,Unspecified,0.0,0,192,245,208,257,16,12
5753,levle2_14.jpg,fore,Unspecified,0.0,0,200,207,221,222,21,15
5754,levle2_14.jpg,fore,Unspecified,0.0,0,206,187,229,203,23,16
5755,levle2_14.jpg,fore,Unspecified,0.0,0,181,286,197,303,16,17
5756,levle2_14.jpg,fore,Unspecified,0.0,0,158,285,166,296,8,11
5757,levle2_14.jpg,fore,Unspecified,0.0,0,196,276,212,291,16,15
5758,levle0_6.jpg,fore,Unspecified,0.0,0,119,48,154,101,35,53
5759,levle0_6.jpg,fore,Unspecified,0.0,0,90,115,125,174,35,59
5760,levle0_6.jpg,fore,Unspecified,0.0,0,8,401,45,458,37,57
5761,levle0_489.jpg,fore,Unspecified,0.0,0,2164,3117,2294,3232,130,115
5762,levle0_489.jpg,fore,Unspecified,0.0,0,2716,1730,2876,1891,160,161
5763,levle0_476.jpg,fore,Unspecified,0.0,0,1420,2987,1505,3079,85,92
5764,levle0_476.jpg,fore,Unspecified,0.0,0,1842,3041,1919,3171,77,130
5765,levle0_476.jpg,fore,Unspecified,0.0,0,2263,2267,2363,2389,100,122
5766,levle0_476.jpg,fore,Unspecified,0.0,0,2363,2236,2562,2420,199,184
5767,levle0_476.jpg,fore,Unspecified,0.0,0,2516,2458,2593,2612,77,154
5768,levle0_310.jpg,fore,Unspecified,0.0,0,1068,2029,1260,2221,192,192
5769,levle0_310.jpg,fore,Unspecified,0.0,0,2332,2558,2478,2711,146,153
5770,levle1_103.jpg,fore,Unspecified,0.0,0,3473,787,3622,978,149,191
5771,levle1_103.jpg,fore,Unspecified,0.0,0,2924,1950,3065,2167,141,217
5772,levle1_103.jpg,fore,Unspecified,0.0,0,2625,2682,2774,2806,149,124
5773,levle1_103.jpg,fore,Unspecified,0.0,0,2666,2915,2824,2998,158,83
5774,levle1_103.jpg,fore,Unspecified,0.0,0,2725,2998,2882,3106,157,108
5775,levle1_103.jpg,fore,Unspecified,0.0,0,2708,2790,2866,2931,158,141
5776,levle1_103.jpg,fore,Unspecified,0.0,0,3115,2948,3240,3089,125,141
5777,levle0_304.jpg,fore,Unspecified,0.0,0,2248,1822,2371,1953,123,131
5778,levle0_304.jpg,fore,Unspecified,0.0,0,1581,2183,1727,2328,146,145
5779,levle1_117.jpg,fore,Unspecified,0.0,0,2633,911,2749,1028,116,117
5780,levle1_117.jpg,fore,Unspecified,0.0,0,1760,1859,1860,1975,100,116
5781,levle1_117.jpg,fore,Unspecified,0.0,0,1902,1784,2018,1909,116,125
5782,levle1_117.jpg,fore,Unspecified,0.0,0,1927,1901,2043,2017,116,116
5783,levle1_117.jpg,fore,Unspecified,0.0,0,2060,1942,2151,2075,91,133
5784,levle1_117.jpg,fore,Unspecified,0.0,0,2143,2042,2218,2108,75,66
5785,levle1_117.jpg,fore,Unspecified,0.0,0,2392,2865,2500,2956,108,91
5786,levle1_117.jpg,fore,Unspecified,0.0,0,2334,2665,2425,2757,91,92
5787,levle1_117.jpg,fore,Unspecified,0.0,0,2500,2765,2700,2890,200,125
5788,levle0_462.jpg,fore,Unspecified,0.0,0,2164,1524,2271,1646,107,122
5789,levle0_462.jpg,fore,Unspecified,0.0,0,2217,1960,2378,2091,161,131
5790,levle0_462.jpg,fore,Unspecified,0.0,0,2562,1002,2723,1194,161,192
5791,levle0_39.jpg,fore,Unspecified,0.0,0,2608,1822,2723,1983,115,161
5792,levle0_39.jpg,fore,Unspecified,0.0,0,2325,1393,2524,1516,199,123
5793,levle0_11.jpg,fore,Unspecified,0.0,0,227,394,252,417,25,23
5794,levle0_11.jpg,fore,Unspecified,0.0,0,81,442,109,464,28,22
5795,levle0_11.jpg,fore,Unspecified,0.0,0,106,393,135,418,29,25
5796,levle0_338.jpg,fore,Unspecified,0.0,0,194,1255,355,1363,161,108
5797,levle3_83.jpg,fore,Unspecified,0.0,0,424,979,539,1117,115,138
5798,levle3_83.jpg,fore,Unspecified,0.0,0,493,987,639,1110,146,123
5799,levle3_83.jpg,fore,Unspecified,0.0,0,486,1064,662,1232,176,168
5800,levle3_83.jpg,fore,Unspecified,0.0,0,516,1232,692,1393,176,161
5801,levle3_83.jpg,fore,Unspecified,0.0,0,317,1278,509,1409,192,131
5802,levle3_83.jpg,fore,Unspecified,0.0,0,325,1462,493,1608,168,146
5803,levle3_83.jpg,fore,Unspecified,0.0,0,325,1577,516,1769,191,192
5804,levle3_83.jpg,fore,Unspecified,0.0,0,386,1700,524,1830,138,130
5805,levle3_83.jpg,fore,Unspecified,0.0,0,317,1815,440,1922,123,107
5806,levle3_83.jpg,fore,Unspecified,0.0,0,417,1807,616,1937,199,130
5807,levle3_83.jpg,fore,Unspecified,0.0,0,424,1868,562,2029,138,161
5808,levle3_83.jpg,fore,Unspecified,0.0,0,524,1907,677,2029,153,122
5809,levle3_83.jpg,fore,Unspecified,0.0,0,240,1983,417,2106,177,123
5810,levle3_83.jpg,fore,Unspecified,0.0,0,279,2244,440,2351,161,107
5811,levle3_83.jpg,fore,Unspecified,0.0,0,348,2114,578,2267,230,153
5812,levle3_83.jpg,fore,Unspecified,0.0,0,432,2221,539,2405,107,184
5813,levle3_83.jpg,fore,Unspecified,0.0,0,524,2251,708,2374,184,123
5814,levle3_83.jpg,fore,Unspecified,0.0,0,570,2543,761,2788,191,245
5815,levle3_83.jpg,fore,Unspecified,0.0,0,930,1845,1106,2045,176,200
5816,levle3_83.jpg,fore,Unspecified,0.0,0,1045,1953,1283,2137,238,184
5817,levle3_83.jpg,fore,Unspecified,0.0,0,1221,1922,1375,2029,154,107
5818,levle3_83.jpg,fore,Unspecified,0.0,0,1099,2106,1191,2183,92,77
5819,levle3_83.jpg,fore,Unspecified,0.0,0,1244,2229,1382,2374,138,145
5820,levle3_83.jpg,fore,Unspecified,0.0,0,792,2167,999,2297,207,130
5821,levle3_83.jpg,fore,Unspecified,0.0,0,777,2397,869,2535,92,138
5822,levle3_83.jpg,fore,Unspecified,0.0,0,869,2405,1053,2635,184,230
5823,levle3_83.jpg,fore,Unspecified,0.0,0,1014,2604,1237,2765,223,161
5824,levle3_83.jpg,fore,Unspecified,0.0,0,792,2750,945,2888,153,138
5825,levle3_83.jpg,fore,Unspecified,0.0,0,899,2742,1076,2987,177,245
5826,levle3_83.jpg,fore,Unspecified,0.0,0,1267,2458,1451,2742,184,284
5827,levle3_83.jpg,fore,Unspecified,0.0,0,1535,2466,1750,2619,215,153
5828,levle3_83.jpg,fore,Unspecified,0.0,0,1252,3033,1497,3156,245,123
5829,levle3_83.jpg,fore,Unspecified,0.0,0,1352,3125,1528,3309,176,184
5830,levle3_83.jpg,fore,Unspecified,0.0,0,1551,2972,1727,3186,176,214
5831,levle3_83.jpg,fore,Unspecified,0.0,0,861,956,1007,1156,146,200
5832,levle3_83.jpg,fore,Unspecified,0.0,0,700,918,884,1156,184,238
5833,levle3_83.jpg,fore,Unspecified,0.0,0,624,742,800,949,176,207
5834,levle3_83.jpg,fore,Unspecified,0.0,0,700,573,876,734,176,161
5835,levle3_83.jpg,fore,Unspecified,0.0,0,846,382,961,512,115,130
5836,levle3_83.jpg,fore,Unspecified,0.0,0,976,619,1129,780,153,161
5837,levle3_83.jpg,fore,Unspecified,0.0,0,1168,627,1298,757,130,130
5838,levle3_83.jpg,fore,Unspecified,0.0,0,1428,489,1581,673,153,184
5839,levle3_83.jpg,fore,Unspecified,0.0,0,1451,719,1612,857,161,138
5840,levle3_83.jpg,fore,Unspecified,0.0,0,1696,612,1834,780,138,168
5841,levle3_83.jpg,fore,Unspecified,0.0,0,1597,811,1788,933,191,122
5842,levle3_83.jpg,fore,Unspecified,0.0,0,1903,497,2049,627,146,130
5843,levle3_83.jpg,fore,Unspecified,0.0,0,1896,328,2072,504,176,176
5844,levle3_83.jpg,fore,Unspecified,0.0,0,1942,642,2095,765,153,123
5845,levle3_83.jpg,fore,Unspecified,0.0,0,1980,857,2118,987,138,130
5846,levle3_83.jpg,fore,Unspecified,0.0,0,2018,2068,2179,2229,161,161
5847,levle3_83.jpg,fore,Unspecified,0.0,0,2118,1914,2271,2068,153,154
5848,levle2_4.jpg,fore,,,0,406,612,444,642,38,30
5849,levle2_4.jpg,fore,,,0,409,655,431,694,22,39
5850,levle2_4.jpg,fore,,,0,333,685,379,721,46,36
5851,levle2_4.jpg,fore,,,0,365,438,395,479,30,41
5852,levle2_4.jpg,fore,,,0,411,454,466,514,55,60
5853,levle2_4.jpg,fore,,,0,327,481,401,530,74,49
5854,levle2_4.jpg,fore,,,0,235,419,303,484,68,65
5855,levle2_4.jpg,fore,,,0,333,288,395,343,62,55
5856,levle2_4.jpg,fore,,,0,360,381,398,422,38,41
5857,levle2_4.jpg,fore,,,0,300,821,352,860,52,39
5858,levle2_4.jpg,fore,,,0,349,783,398,827,49,44
5859,levle2_4.jpg,fore,,,0,22,691,52,732,30,41
5860,levle2_4.jpg,fore,,,0,246,579,308,628,62,49
5861,levle2_4.jpg,fore,,,0,254,539,303,577,49,38
5862,levle2_4.jpg,fore,,,0,303,536,363,601,60,65
5863,levle2_4.jpg,fore,,,0,354,585,409,639,55,54
5864,levle2_4.jpg,fore,,,0,349,265,393,301,44,36
5865,levle2_4.jpg,fore,,,0,327,434,368,473,41,39
5866,levle2_4.jpg,fore,,,0,41,787,78,816,37,29
5867,levle2_4.jpg,fore,,,0,75,808,116,842,41,34
5868,levle2_4.jpg,fore,,,0,373,520,423,571,50,51
5869,levle3_97.jpg,fore,,,0,2101,911,2284,1144,183,233
5870,levle3_97.jpg,fore,,,0,1777,1618,1993,1784,216,166
5871,levle3_97.jpg,fore,,,0,2118,1568,2301,1743,183,175
5872,levle3_97.jpg,fore,,,0,3115,837,3340,1011,225,174
5873,levle3_97.jpg,fore,,,0,2317,1759,2459,1909,142,150
5874,levle3_97.jpg,fore,,,0,2508,2050,2658,2216,150,166
5875,levle3_97.jpg,fore,,,0,1752,2050,1935,2275,183,225
5876,levle3_97.jpg,fore,,,0,2367,2673,2558,2848,191,175
5877,levle3_97.jpg,fore,,,0,2168,421,2292,579,124,158
5878,levle3_97.jpg,fore,,,0,1943,1211,2143,1344,200,133
5879,levle3_97.jpg,fore,,,0,1802,1302,1977,1493,175,191
5880,levle3_97.jpg,fore,,,0,2957,637,3090,795,133,158
5881,levle3_97.jpg,fore,,,0,1985,1693,2143,1859,158,166
5882,levle3_97.jpg,fore,,,0,1968,1992,2110,2108,142,116
5883,levle3_97.jpg,fore,,,0,2459,1684,2666,1942,207,258
5884,levle3_97.jpg,fore,,,0,2583,1901,2708,2042,125,141
5885,levle3_97.jpg,fore,,,0,2110,1917,2242,2034,132,117
5886,levle3_97.jpg,fore,,,0,2301,2117,2467,2241,166,124
5887,levle3_97.jpg,fore,,,0,2384,2250,2492,2366,108,116
5888,levle3_97.jpg,fore,,,0,2367,2590,2492,2673,125,83
5889,levle3_97.jpg,fore,,,0,2517,2366,2708,2565,191,199
5890,levle3_97.jpg,fore,,,0,2533,2233,2658,2349,125,116
5891,levle3_97.jpg,fore,,,0,2658,1576,2833,1759,175,183
5892,levle3_97.jpg,fore,,,0,2450,2881,2592,3072,142,191
5893,levle3_97.jpg,fore,,,0,2633,2981,2808,3114,175,133
5894,levle3_97.jpg,fore,,,0,1935,2491,2126,2640,191,149
5895,levle3_97.jpg,fore,,,0,2051,2457,2251,2615,200,158
5896,levle3_97.jpg,fore,,,0,1827,2324,1993,2432,166,108
5897,levle3_97.jpg,fore,,,0,1461,1942,1578,2158,117,216
5898,levle3_97.jpg,fore,,,0,1790,758,1966,938,176,180
5899,levle3_97.jpg,fore,,,0,2314,406,2398,534,84,128
5900,levle3_97.jpg,fore,,,0,2434,334,2562,458,128,124
5901,levle3_97.jpg,fore,,,0,1766,2610,1918,2758,152,148
5902,levle3_97.jpg,fore,,,0,1834,2526,1970,2690,136,164
5903,levle3_97.jpg,fore,,,0,1890,2858,2006,2990,116,132
5904,levle3_97.jpg,fore,,,0,1790,2766,1938,2894,148,128
5905,levle3_97.jpg,fore,,,0,2034,2674,2174,2782,140,108
5906,levle3_97.jpg,fore,,,0,2066,2086,2178,2186,112,100
5907,levle3_97.jpg,fore,,,0,2098,1782,2234,1918,136,136
5908,levle3_97.jpg,fore,,,0,1762,1782,1890,1914,128,132
5909,levle3_97.jpg,fore,,,0,1922,1418,2050,1550,128,132
5910,levle3_97.jpg,fore,,,0,1874,1078,2018,1186,144,108
5911,levle3_97.jpg,fore,,,0,1830,1206,1966,1326,136,120
5912,levle3_97.jpg,fore,,,0,2946,434,3122,574,176,140
5913,levle3_97.jpg,fore,,,0,3274,566,3402,706,128,140
5914,levle3_97.jpg,fore,,,0,2278,606,2398,738,120,132
5915,levle3_97.jpg,fore,,,0,1698,1522,1866,1630,168,108
5916,levle3_97.jpg,fore,,,0,2258,2414,2418,2546,160,132
5917,levle3_97.jpg,fore,,,0,2646,2074,2782,2206,136,132
5918,levle3_97.jpg,fore,,,0,2758,2694,2874,2802,116,108
5919,levle3_97.jpg,fore,,,0,2722,2798,2846,2894,124,96
5920,levle3_97.jpg,fore,,,0,2666,2878,2922,2986,256,108
5921,levle3_97.jpg,fore,,,0,2902,2830,3018,2974,116,144
5922,levle3_97.jpg,fore,,,0,2882,2966,3050,3054,168,88
5923,levle3_97.jpg,fore,,,0,2694,2302,2858,2458,164,156
5924,levle3_97.jpg,fore,,,0,2138,1430,2350,1586,212,156
5925,levle3_97.jpg,fore,,,0,2026,542,2134,662,108,120
5926,levle3_97.jpg,fore,,,0,2126,694,2266,806,140,112
5927,levle3_97.jpg,fore,,,0,2074,2790,2278,2934,204,144
5928,levle3_97.jpg,fore,,,0,1990,2818,2094,2966,104,148
5929,levle3_97.jpg,fore,,,0,2266,2522,2390,2642,124,120
5930,levle3_97.jpg,fore,,,0,2162,2186,2322,2330,160,144
5931,levle3_97.jpg,fore,,,0,2278,1994,2426,2130,148,136
5932,levle3_97.jpg,fore,,,0,2446,1954,2578,2050,132,96
5933,levle1_498.jpg,fore,Unspecified,0.0,0,409,1930,516,2022,107,92
5934,levle1_498.jpg,fore,Unspecified,0.0,0,509,1976,601,2106,92,130
5935,levle1_498.jpg,fore,Unspecified,0.0,0,677,2129,800,2244,123,115
5936,levle1_498.jpg,fore,Unspecified,0.0,0,532,2412,631,2527,99,115
5937,levle1_498.jpg,fore,Unspecified,0.0,0,647,2282,761,2428,114,146
5938,levle1_498.jpg,fore,Unspecified,0.0,0,1221,2267,1375,2412,154,145
5939,levle1_498.jpg,fore,Unspecified,0.0,0,1474,2972,1612,3071,138,99
5940,levle1_498.jpg,fore,Unspecified,0.0,0,1566,3102,1758,3225,192,123
5941,levle1_498.jpg,fore,Unspecified,0.0,0,1114,3202,1267,3340,153,138
5942,levle1_301.jpg,fore,Unspecified,0.0,0,754,1937,869,2075,115,138
5943,levle1_301.jpg,fore,Unspecified,0.0,0,654,2106,807,2282,153,176
5944,levle1_301.jpg,fore,Unspecified,0.0,0,876,2297,991,2451,115,154
5945,levle1_301.jpg,fore,Unspecified,0.0,0,945,2627,1076,2773,131,146
5946,levle1_301.jpg,fore,Unspecified,0.0,0,1091,2627,1175,2742,84,115
5947,levle1_301.jpg,fore,Unspecified,0.0,0,1221,2964,1344,3079,123,115
5948,levle1_301.jpg,fore,Unspecified,0.0,0,1045,3117,1191,3317,146,200
5949,levle1_301.jpg,fore,Unspecified,0.0,0,754,3140,930,3286,176,146
5950,levle0_112.jpg,fore,Unspecified,0.0,0,2424,1968,2547,2152,123,184
5951,levle3_40.jpg,fore,,,0,206,199,245,241,39,42
5952,levle3_40.jpg,fore,,,0,326,380,364,417,38,37
5953,levle3_40.jpg,fore,,,0,415,337,458,381,43,44
5954,levle3_40.jpg,fore,,,0,472,490,511,518,39,28
5955,levle3_40.jpg,fore,,,0,474,378,509,429,35,51
5956,levle3_40.jpg,fore,,,0,445,571,482,614,37,43
5957,levle3_40.jpg,fore,,,0,264,559,323,617,59,58
5958,levle3_40.jpg,fore,,,0,202,506,250,543,48,37
5959,levle3_40.jpg,fore,,,0,172,507,213,561,41,54
5960,levle3_40.jpg,fore,,,0,197,548,243,584,46,36
5961,levle3_40.jpg,fore,,,0,206,582,257,632,51,50
5962,levle3_40.jpg,fore,,,0,101,589,145,624,44,35
5963,levle3_40.jpg,fore,,,0,277,662,309,697,32,35
5964,levle3_40.jpg,fore,,,0,282,614,321,656,39,42
5965,levle3_40.jpg,fore,,,0,413,642,436,660,23,18
5966,levle3_40.jpg,fore,,,0,183,632,227,665,44,33
5967,levle3_40.jpg,fore,,,0,172,676,207,718,35,42
5968,levle3_40.jpg,fore,,,0,250,215,282,255,32,40
5969,levle3_40.jpg,fore,,,0,176,330,220,357,44,27
5970,levle3_40.jpg,fore,,,0,181,348,232,390,51,42
5971,levle3_40.jpg,fore,,,0,285,305,325,362,40,57
5972,levle3_40.jpg,fore,,,0,355,403,392,449,37,46
5973,levle3_40.jpg,fore,,,0,397,373,440,397,43,24
5974,levle3_40.jpg,fore,,,0,298,513,342,550,44,37
5975,levle3_40.jpg,fore,,,0,337,486,372,529,35,43
5976,levle3_40.jpg,fore,,,0,394,593,413,623,19,30
5977,levle3_40.jpg,fore,,,0,340,623,372,663,32,40
5978,levle3_40.jpg,fore,,,0,319,665,362,715,43,50
5979,levle3_40.jpg,fore,,,0,234,327,285,370,51,43
5980,levle3_40.jpg,fore,,,0,92,389,123,415,31,26
5981,levle3_40.jpg,fore,,,0,1,393,32,420,31,27
5982,levle3_40.jpg,fore,,,0,1,352,20,383,19,31
5983,levle3_40.jpg,fore,,,0,80,509,116,539,36,30
5984,levle3_40.jpg,fore,,,0,212,699,241,731,29,32
5985,levle3_40.jpg,fore,,,0,256,737,285,766,29,29
5986,levle3_40.jpg,fore,,,0,177,765,204,793,27,28
5987,levle3_40.jpg,fore,,,0,165,727,195,760,30,33
5988,levle3_40.jpg,fore,,,0,444,717,484,784,40,67
5989,levle3_40.jpg,fore,,,0,372,460,408,523,36,63
5990,levle3_40.jpg,fore,,,0,428,462,456,493,28,31
5991,levle3_40.jpg,fore,,,0,412,482,440,519,28,37
5992,levle3_40.jpg,fore,,,0,476,430,505,462,29,32
5993,levle3_40.jpg,fore,,,0,196,283,237,305,41,22
5994,levle3_40.jpg,fore,,,0,60,438,96,461,36,23
5995,levle3_40.jpg,fore,,,0,176,486,223,523,47,37
5996,levle3_40.jpg,fore,,,0,237,772,262,798,25,26
5997,levle3_40.jpg,fore,,,0,319,767,350,796,31,29
5998,levle3_40.jpg,fore,,,0,115,762,150,788,35,26
5999,levle3_40.jpg,fore,,,0,92,551,128,579,36,28
6000,levle3_40.jpg,fore,,,0,368,341,406,373,38,32
6001,levle3_40.jpg,fore,,,0,224,180,257,204,33,24
6002,levle1_467.jpg,fore,Unspecified,0.0,0,1329,2865,1497,3010,168,145
6003,levle1_467.jpg,fore,Unspecified,0.0,0,1482,2803,1643,2972,161,169
6004,levle1_467.jpg,fore,Unspecified,0.0,0,1252,2435,1375,2627,123,192
6005,levle1_467.jpg,fore,Unspecified,0.0,0,968,2474,1022,2688,54,214
6006,levle1_467.jpg,fore,Unspecified,0.0,0,1060,2550,1183,2727,123,177
6007,levle1_467.jpg,fore,Unspecified,0.0,0,715,2144,876,2290,161,146
6008,levle1_467.jpg,fore,Unspecified,0.0,0,861,2029,1076,2251,215,222
6009,levle3_54.jpg,fore,Unspecified,0.0,0,234,133,268,168,34,35
6010,levle3_54.jpg,fore,Unspecified,0.0,0,214,41,237,83,23,42
6011,levle3_54.jpg,fore,Unspecified,0.0,0,282,179,311,223,29,44
6012,levle3_54.jpg,fore,Unspecified,0.0,0,231,201,274,236,43,35
6013,levle3_54.jpg,fore,Unspecified,0.0,0,239,236,265,279,26,43
6014,levle3_54.jpg,fore,Unspecified,0.0,0,197,185,228,213,31,28
6015,levle3_54.jpg,fore,Unspecified,0.0,0,193,211,220,243,27,32
6016,levle3_54.jpg,fore,Unspecified,0.0,0,153,167,191,207,38,40
6017,levle3_54.jpg,fore,Unspecified,0.0,0,141,199,171,228,30,29
6018,levle3_54.jpg,fore,Unspecified,0.0,0,106,240,159,283,53,43
6019,levle3_54.jpg,fore,Unspecified,0.0,0,14,161,63,194,49,33
6020,levle3_54.jpg,fore,Unspecified,0.0,0,55,107,92,150,37,43
6021,levle3_54.jpg,fore,Unspecified,0.0,0,9,220,46,263,37,43
6022,levle3_54.jpg,fore,Unspecified,0.0,0,57,190,98,228,41,38
6023,levle3_54.jpg,fore,Unspecified,0.0,0,84,161,124,190,40,29
6024,levle3_54.jpg,fore,Unspecified,0.0,0,35,251,77,288,42,37
6025,levle3_54.jpg,fore,Unspecified,0.0,0,0,314,38,352,38,38
6026,levle3_54.jpg,fore,Unspecified,0.0,0,44,292,81,340,37,48
6027,levle3_54.jpg,fore,Unspecified,0.0,0,89,280,124,317,35,37
6028,levle3_54.jpg,fore,Unspecified,0.0,0,77,315,124,361,47,46
6029,levle3_54.jpg,fore,Unspecified,0.0,0,41,344,67,384,26,40
6030,levle3_54.jpg,fore,Unspecified,0.0,0,18,384,83,432,65,48
6031,levle3_54.jpg,fore,Unspecified,0.0,0,41,442,92,484,51,42
6032,levle3_54.jpg,fore,Unspecified,0.0,0,106,360,135,390,29,30
6033,levle3_54.jpg,fore,Unspecified,0.0,0,136,294,178,314,42,20
6034,levle3_54.jpg,fore,Unspecified,0.0,0,170,300,228,335,58,35
6035,levle3_54.jpg,fore,Unspecified,0.0,0,202,383,234,415,32,32
6036,levle3_54.jpg,fore,Unspecified,0.0,0,223,340,263,373,40,33
6037,levle3_54.jpg,fore,Unspecified,0.0,0,199,263,231,305,32,42
6038,levle3_54.jpg,fore,Unspecified,0.0,0,164,237,210,280,46,43
6039,levle3_54.jpg,fore,Unspecified,0.0,0,253,439,274,467,21,28
6040,levle3_54.jpg,fore,Unspecified,0.0,0,265,572,309,612,44,40
6041,levle3_54.jpg,fore,Unspecified,0.0,0,277,540,318,571,41,31
6042,levle3_54.jpg,fore,Unspecified,0.0,0,300,502,340,539,40,37
6043,levle3_54.jpg,fore,Unspecified,0.0,0,295,291,315,320,20,29
6044,levle3_54.jpg,fore,Unspecified,0.0,0,164,349,213,378,49,29
6045,levle3_54.jpg,fore,Unspecified,0.0,0,138,395,204,453,66,58
6046,levle1_315.jpg,fore,Unspecified,0.0,0,1206,979,1367,1140,161,161
6047,levle1_315.jpg,fore,Unspecified,0.0,0,922,1738,1060,1876,138,138
6048,levle1_315.jpg,fore,Unspecified,0.0,0,1175,2290,1329,2504,154,214
6049,levle1_315.jpg,fore,Unspecified,0.0,0,1466,2351,1650,2520,184,169
6050,levle1_315.jpg,fore,Unspecified,0.0,0,1781,2320,1965,2481,184,161
6051,levle1_315.jpg,fore,Unspecified,0.0,0,1949,2481,2102,2635,153,154
6052,levle1_315.jpg,fore,Unspecified,0.0,0,1658,2888,1788,2995,130,107
6053,levle1_315.jpg,fore,Unspecified,0.0,0,1788,3002,1888,3110,100,108
6054,levle1_315.jpg,fore,Unspecified,0.0,0,1206,2589,1352,2734,146,145
6055,levle0_106.jpg,fore,Unspecified,0.0,0,1980,1945,2141,2098,161,153
6056,levle1_329.jpg,fore,Unspecified,0.0,0,1106,1746,1252,1891,146,145
6057,levle1_329.jpg,fore,Unspecified,0.0,0,1206,2045,1321,2183,115,138
6058,levle1_329.jpg,fore,Unspecified,0.0,0,1474,2397,1574,2627,100,230
6059,levle1_329.jpg,fore,Unspecified,0.0,0,1627,2489,1758,2619,131,130
6060,levle1_329.jpg,fore,Unspecified,0.0,0,1160,3064,1283,3225,123,161
6061,levle1_329.jpg,fore,Unspecified,0.0,0,2386,2114,2501,2229,115,115
6062,levle1_329.jpg,fore,Unspecified,0.0,0,2394,2297,2555,2435,161,138
6063,levle3_68.jpg,fore,,,0,228,213,250,231,22,18
6064,levle3_68.jpg,fore,,,0,120,253,143,271,23,18
6065,levle3_68.jpg,fore,,,0,198,209,221,225,23,16
6066,levle3_68.jpg,fore,,,0,193,185,210,209,17,24
6067,levle3_68.jpg,fore,,,0,183,161,197,181,14,20
6068,levle3_68.jpg,fore,,,0,155,135,174,163,19,28
6069,levle3_68.jpg,fore,,,0,178,102,198,129,20,27
6070,levle3_68.jpg,fore,,,0,152,105,169,127,17,22
6071,levle3_68.jpg,fore,,,0,130,64,151,84,21,20
6072,levle3_68.jpg,fore,,,0,86,92,111,117,25,25
6073,levle3_68.jpg,fore,,,0,120,110,141,128,21,18
6074,levle3_68.jpg,fore,,,0,130,128,149,147,19,19
6075,levle3_68.jpg,fore,,,0,61,121,84,138,23,17
6076,levle3_68.jpg,fore,,,0,77,143,98,169,21,26
6077,levle3_68.jpg,fore,,,0,174,241,198,260,24,19
6078,levle3_68.jpg,fore,,,0,180,265,200,287,20,22
6079,levle3_68.jpg,fore,,,0,210,235,235,258,25,23
6080,levle3_68.jpg,fore,,,0,204,259,232,274,28,15
6081,levle3_68.jpg,fore,,,0,209,272,229,290,20,18
6082,levle3_68.jpg,fore,,,0,265,239,293,266,28,27
6083,levle3_68.jpg,fore,,,0,246,291,271,316,25,25
6084,levle3_68.jpg,fore,,,0,207,306,230,332,23,26
6085,levle3_68.jpg,fore,,,0,193,296,215,319,22,23
6086,levle3_68.jpg,fore,,,0,196,324,228,350,32,26
6087,levle3_68.jpg,fore,,,0,167,349,201,363,34,14
6088,levle3_68.jpg,fore,,,0,154,293,177,318,23,25
6089,levle3_68.jpg,fore,,,0,155,265,178,285,23,20
6090,levle3_68.jpg,fore,,,0,119,273,132,289,13,16
6091,levle3_68.jpg,fore,,,0,137,283,156,303,19,20
6092,levle3_68.jpg,fore,,,0,106,296,135,318,29,22
6093,levle3_68.jpg,fore,,,0,100,316,123,338,23,22
6094,levle3_68.jpg,fore,,,0,118,328,137,348,19,20
6095,levle3_68.jpg,fore,,,0,139,312,159,332,20,20
6096,levle3_68.jpg,fore,,,0,139,326,163,345,24,19
6097,levle3_68.jpg,fore,,,0,148,341,168,355,20,14
6098,levle3_68.jpg,fore,,,0,120,346,143,368,23,22
6099,levle3_68.jpg,fore,,,0,131,367,156,387,25,20
6100,levle3_68.jpg,fore,,,0,154,380,182,404,28,24
6101,levle3_68.jpg,fore,,,0,128,384,158,407,30,23
6102,levle3_68.jpg,fore,,,0,124,406,156,427,32,21
6103,levle3_68.jpg,fore,,,0,105,378,128,397,23,19
6104,levle3_68.jpg,fore,,,0,98,397,125,422,27,25
6105,levle3_68.jpg,fore,,,0,181,358,208,383,27,25
6106,levle3_68.jpg,fore,,,0,152,253,169,266,17,13
6107,levle3_68.jpg,fore,,,0,97,269,112,292,15,23
6108,levle3_68.jpg,fore,,,0,85,367,99,383,14,16
6109,levle3_68.jpg,fore,,,0,108,352,119,369,11,17
6110,levle3_68.jpg,fore,,,0,74,389,86,403,12,14
6111,levle3_68.jpg,fore,,,0,87,391,100,405,13,14
6112,levle3_68.jpg,fore,,,0,246,342,261,357,15,15
6113,levle3_68.jpg,fore,,,0,197,387,211,400,14,13
6114,levle3_68.jpg,fore,,,0,173,330,189,346,16,16
6115,levle3_68.jpg,fore,,,0,70,404,85,419,15,15
6116,levle3_68.jpg,fore,,,0,264,270,279,286,15,16
6117,levle3_68.jpg,fore,,,0,96,419,112,436,16,17
6118,levle3_68.jpg,fore,,,0,163,317,178,332,15,15
6119,levle1_459.jpg,fore,Unspecified,0.0,0,2148,2328,2271,2458,123,130
6120,levle1_459.jpg,fore,Unspecified,0.0,0,2087,2397,2171,2512,84,115
6121,levle1_459.jpg,fore,Unspecified,0.0,0,2355,2183,2509,2328,154,145
6122,levle1_459.jpg,fore,Unspecified,0.0,0,2455,2060,2624,2213,169,153
6123,levle1_459.jpg,fore,Unspecified,0.0,0,2371,2336,2593,2604,222,268
6124,levle1_459.jpg,fore,Unspecified,0.0,0,976,1087,1060,1179,84,92
6125,levle1_459.jpg,fore,Unspecified,0.0,0,1037,1171,1129,1248,92,77
6126,levle0_138.jpg,fore,Unspecified,0.0,0,2279,2274,2440,2435,161,161
6127,levle1_465.jpg,fore,Unspecified,0.0,0,2601,1355,2708,1524,107,169
6128,levle1_465.jpg,fore,Unspecified,0.0,0,2601,2435,2762,2627,161,192
6129,levle1_465.jpg,fore,Unspecified,0.0,0,2394,2251,2539,2443,145,192
6130,levle1_465.jpg,fore,Unspecified,0.0,0,2041,2374,2156,2489,115,115
6131,levle1_465.jpg,fore,Unspecified,0.0,0,1911,2573,2026,2742,115,169
6132,levle1_465.jpg,fore,Unspecified,0.0,0,2064,2688,2187,2834,123,146
6133,levle1_465.jpg,fore,Unspecified,0.0,0,2141,2857,2194,2995,53,138
6134,levle1_465.jpg,fore,Unspecified,0.0,0,2225,2780,2317,2934,92,154
6135,levle1_465.jpg,fore,Unspecified,0.0,0,2125,3010,2271,3171,146,161
6136,levle3_42.jpg,fore,,,0,395,335,423,374,28,39
6137,levle3_42.jpg,fore,,,0,375,309,400,344,25,35
6138,levle3_42.jpg,fore,,,0,345,309,374,342,29,33
6139,levle3_42.jpg,fore,,,0,375,367,409,401,34,34
6140,levle3_42.jpg,fore,,,0,358,346,388,376,30,30
6141,levle3_42.jpg,fore,,,0,338,374,368,410,30,36
6142,levle3_42.jpg,fore,,,0,317,342,351,387,34,45
6143,levle3_42.jpg,fore,,,0,255,291,290,339,35,48
6144,levle3_42.jpg,fore,,,0,225,259,253,295,28,36
6145,levle3_42.jpg,fore,,,0,195,250,230,295,35,45
6146,levle3_42.jpg,fore,,,0,171,298,207,346,36,48
6147,levle3_42.jpg,fore,,,0,210,305,242,337,32,32
6148,levle3_42.jpg,fore,,,0,304,419,340,444,36,25
6149,levle3_42.jpg,fore,,,0,235,436,289,499,54,63
6150,levle3_42.jpg,fore,,,0,278,449,315,493,37,44
6151,levle3_42.jpg,fore,,,0,319,490,351,525,32,35
6152,levle3_42.jpg,fore,,,0,319,532,340,552,21,20
6153,levle3_42.jpg,fore,,,0,377,502,422,530,45,28
6154,levle3_42.jpg,fore,,,0,365,548,395,578,30,30
6155,levle3_42.jpg,fore,,,0,399,468,425,507,26,39
6156,levle3_42.jpg,fore,,,0,317,442,358,488,41,46
6157,levle3_42.jpg,fore,,,0,344,410,407,454,63,44
6158,levle3_42.jpg,fore,,,0,395,392,425,436,30,44
6159,levle3_42.jpg,fore,,,0,271,380,308,420,37,40
6160,levle3_42.jpg,fore,,,0,207,339,244,373,37,34
6161,levle3_42.jpg,fore,,,0,265,151,289,193,24,42
6162,levle3_42.jpg,fore,,,0,274,128,313,165,39,37
6163,levle3_42.jpg,fore,,,0,257,103,287,135,30,32
6164,levle3_42.jpg,fore,,,0,306,62,342,92,36,30
6165,levle3_42.jpg,fore,,,0,354,117,404,169,50,52
6166,levle3_42.jpg,fore,,,0,388,44,420,85,32,41
6167,levle3_42.jpg,fore,,,0,354,27,379,57,25,30
6168,levle3_42.jpg,fore,,,0,407,28,439,64,32,36
6169,levle3_42.jpg,fore,,,0,441,75,477,110,36,35
6170,levle3_42.jpg,fore,,,0,376,277,404,302,28,25
6171,levle3_42.jpg,fore,,,0,260,227,292,248,32,21
6172,levle3_42.jpg,fore,,,0,252,199,280,228,28,29
6173,levle3_42.jpg,fore,,,0,348,181,383,211,35,30
6174,levle3_42.jpg,fore,,,0,438,362,465,391,27,29
6175,levle3_42.jpg,fore,,,0,425,431,453,454,28,23
6176,levle3_42.jpg,fore,,,0,408,95,443,132,35,37
6177,levle3_42.jpg,fore,,,0,412,536,444,566,32,30
6178,levle3_42.jpg,fore,,,0,477,534,495,555,18,21
6179,levle3_42.jpg,fore,,,0,423,570,454,586,31,16
6180,levle3_42.jpg,fore,,,0,444,556,468,575,24,19
6181,levle3_42.jpg,fore,,,0,270,340,292,362,22,22
6182,levle3_42.jpg,fore,,,0,363,96,393,117,30,21
6183,levle3_42.jpg,fore,,,0,210,420,236,443,26,23
6184,levle3_42.jpg,fore,,,0,161,355,182,375,21,20
6185,levle3_42.jpg,fore,,,0,161,377,183,400,22,23
6186,levle3_42.jpg,fore,,,0,498,76,520,99,22,23
6187,levle3_42.jpg,fore,,,0,386,5,422,31,36,26
6188,levle3_42.jpg,fore,,,0,339,67,379,95,40,28
6189,levle3_42.jpg,fore,,,0,440,53,466,77,26,24
6190,levle3_42.jpg,fore,,,0,275,520,300,541,25,21
6191,levle3_42.jpg,fore,,,0,260,501,292,529,32,28
6192,levle3_42.jpg,fore,,,0,211,443,235,466,24,23
6193,levle3_42.jpg,fore,,,0,293,313,320,337,27,24
6194,levle3_42.jpg,fore,,,0,245,371,269,397,24,26
6195,levle0_110.jpg,fore,Unspecified,0.0,0,2309,2236,2432,2374,123,138
6196,levle0_110.jpg,fore,Unspecified,0.0,0,1229,3002,1344,3156,115,154
6197,levle1_303.jpg,fore,Unspecified,0.0,0,478,2305,608,2405,130,100
6198,levle1_303.jpg,fore,Unspecified,0.0,0,455,2412,562,2558,107,146
6199,levle1_303.jpg,fore,Unspecified,0.0,0,555,2619,624,2750,69,131
6200,levle1_303.jpg,fore,Unspecified,0.0,0,1781,2466,1911,2612,130,146
6201,levle1_303.jpg,fore,Unspecified,0.0,0,1965,3278,2011,3424,46,146
6202,levle1_303.jpg,fore,Unspecified,0.0,0,1773,3179,1911,3355,138,176
6203,levle0_104.jpg,fore,Unspecified,0.0,0,2302,3163,2463,3286,161,123
6204,levle1_317.jpg,fore,Unspecified,0.0,0,2194,1194,2401,1378,207,184
6205,levle1_317.jpg,fore,Unspecified,0.0,0,2118,1470,2340,1684,222,214
6206,levle1_317.jpg,fore,Unspecified,0.0,0,1489,2083,1666,2244,177,161
6207,levle1_317.jpg,fore,Unspecified,0.0,0,1405,2336,1604,2527,199,191
6208,levle1_317.jpg,fore,Unspecified,0.0,0,1512,2642,1689,2842,177,200
6209,levle1_317.jpg,fore,Unspecified,0.0,0,1949,2497,2095,2727,146,230
6210,levle1_317.jpg,fore,Unspecified,0.0,0,1850,1669,2026,1845,176,176
6211,levle1_317.jpg,fore,Unspecified,0.0,0,1811,2259,2049,2458,238,199
6212,levle1_317.jpg,fore,Unspecified,0.0,0,1712,734,1873,887,161,153
6213,levle3_56.jpg,fore,Unspecified,0.0,0,239,51,252,68,13,17
6214,levle3_56.jpg,fore,Unspecified,0.0,0,236,69,253,83,17,14
6215,levle3_56.jpg,fore,Unspecified,0.0,0,128,71,144,90,16,19
6216,levle3_56.jpg,fore,Unspecified,0.0,0,119,100,137,120,18,20
6217,levle3_56.jpg,fore,Unspecified,0.0,0,146,44,160,56,14,12
6218,levle3_56.jpg,fore,Unspecified,0.0,0,171,16,190,31,19,15
6219,levle3_56.jpg,fore,Unspecified,0.0,0,288,6,309,19,21,13
6220,levle3_56.jpg,fore,Unspecified,0.0,0,216,101,234,118,18,17
6221,levle3_56.jpg,fore,Unspecified,0.0,0,216,119,234,139,18,20
6222,levle3_56.jpg,fore,Unspecified,0.0,0,245,104,261,117,16,13
6223,levle3_56.jpg,fore,Unspecified,0.0,0,252,123,263,135,11,12
6224,levle3_56.jpg,fore,Unspecified,0.0,0,286,70,302,81,16,11
6225,levle3_56.jpg,fore,Unspecified,0.0,0,261,164,277,178,16,14
6226,levle3_56.jpg,fore,Unspecified,0.0,0,258,135,275,160,17,25
6227,levle3_56.jpg,fore,Unspecified,0.0,0,295,181,306,199,11,18
6228,levle3_56.jpg,fore,Unspecified,0.0,0,315,182,331,198,16,16
6229,levle3_56.jpg,fore,Unspecified,0.0,0,288,208,305,227,17,19
6230,levle3_56.jpg,fore,Unspecified,0.0,0,268,193,285,214,17,21
6231,levle3_56.jpg,fore,Unspecified,0.0,0,252,219,261,232,9,13
6232,levle3_56.jpg,fore,Unspecified,0.0,0,242,182,261,200,19,18
6233,levle3_56.jpg,fore,Unspecified,0.0,0,221,214,239,225,18,11
6234,levle3_56.jpg,fore,Unspecified,0.0,0,219,182,236,197,17,15
6235,levle3_56.jpg,fore,Unspecified,0.0,0,206,235,230,243,24,8
6236,levle3_56.jpg,fore,Unspecified,0.0,0,203,216,219,232,16,16
6237,levle3_56.jpg,fore,Unspecified,0.0,0,157,180,176,196,19,16
6238,levle3_56.jpg,fore,Unspecified,0.0,0,148,200,160,217,12,17
6239,levle3_56.jpg,fore,Unspecified,0.0,0,130,223,148,238,18,15
6240,levle3_56.jpg,fore,Unspecified,0.0,0,129,179,145,196,16,17
6241,levle3_56.jpg,fore,Unspecified,0.0,0,107,180,125,201,18,21
6242,levle3_56.jpg,fore,Unspecified,0.0,0,97,173,111,184,14,11
6243,levle3_56.jpg,fore,Unspecified,0.0,0,118,153,143,166,25,13
6244,levle3_56.jpg,fore,Unspecified,0.0,0,69,124,87,143,18,19
6245,levle3_56.jpg,fore,Unspecified,0.0,0,96,103,113,117,17,14
6246,levle3_56.jpg,fore,Unspecified,0.0,0,157,135,176,151,19,16
6247,levle3_56.jpg,fore,Unspecified,0.0,0,269,5,286,13,17,8
6248,levle3_56.jpg,fore,Unspecified,0.0,0,315,1,330,11,15,10
6249,levle3_56.jpg,fore,Unspecified,0.0,0,295,21,310,37,15,16
6250,levle3_56.jpg,fore,Unspecified,0.0,0,284,36,305,51,21,15
6251,levle3_56.jpg,fore,Unspecified,0.0,0,256,31,275,51,19,20
6252,levle3_56.jpg,fore,Unspecified,0.0,0,214,33,237,55,23,22
6253,levle3_56.jpg,fore,Unspecified,0.0,0,156,1,183,14,27,13
6254,levle3_56.jpg,fore,Unspecified,0.0,0,140,11,159,26,19,15
6255,levle3_56.jpg,fore,Unspecified,0.0,0,110,7,134,32,24,25
6256,levle3_56.jpg,fore,Unspecified,0.0,0,177,33,197,50,20,17
6257,levle3_56.jpg,fore,Unspecified,0.0,0,185,53,200,65,15,12
6258,levle3_56.jpg,fore,Unspecified,0.0,0,177,68,198,80,21,12
6259,levle3_56.jpg,fore,Unspecified,0.0,0,98,66,119,80,21,14
6260,levle3_56.jpg,fore,Unspecified,0.0,0,113,68,133,91,20,23
6261,levle3_56.jpg,fore,Unspecified,0.0,0,148,87,163,102,15,15
6262,levle3_56.jpg,fore,Unspecified,0.0,0,36,155,50,168,14,13
6263,levle3_56.jpg,fore,Unspecified,0.0,0,106,124,115,133,9,9
6264,levle3_56.jpg,fore,Unspecified,0.0,0,76,194,96,218,20,24
6265,levle3_56.jpg,fore,Unspecified,0.0,0,176,168,199,187,23,19
6266,levle3_56.jpg,fore,Unspecified,0.0,0,193,193,208,208,15,15
6267,levle3_56.jpg,fore,Unspecified,0.0,0,237,153,254,165,17,12
6268,levle3_56.jpg,fore,Unspecified,0.0,0,278,140,295,157,17,17
6269,levle3_56.jpg,fore,Unspecified,0.0,0,198,123,210,136,12,13
6270,levle1_471.jpg,fore,Unspecified,0.0,0,2501,1853,2593,2014,92,161
6271,levle1_471.jpg,fore,Unspecified,0.0,0,2455,2336,2647,2435,192,99
6272,levle1_471.jpg,fore,Unspecified,0.0,0,2271,2589,2524,2711,253,122
6273,levle1_471.jpg,fore,Unspecified,0.0,0,1551,2903,1750,3018,199,115
6274,levle1_471.jpg,fore,Unspecified,0.0,0,1942,2711,2133,2834,191,123
6275,levle1_471.jpg,fore,Unspecified,0.0,0,2141,2849,2233,2964,92,115
6276,levle2_6.jpg,fore,Unspecified,0.0,0,223,100,264,139,41,39
6277,levle2_6.jpg,fore,Unspecified,0.0,0,245,129,270,157,25,28
6278,levle2_6.jpg,fore,Unspecified,0.0,0,270,149,290,167,20,18
6279,levle2_6.jpg,fore,Unspecified,0.0,0,315,169,350,189,35,20
6280,levle2_6.jpg,fore,Unspecified,0.0,0,356,100,395,143,39,43
6281,levle2_6.jpg,fore,Unspecified,0.0,0,408,53,444,88,36,35
6282,levle2_6.jpg,fore,Unspecified,0.0,0,279,202,314,216,35,14
6283,levle2_6.jpg,fore,Unspecified,0.0,0,275,216,300,245,25,29
6284,levle2_6.jpg,fore,Unspecified,0.0,0,299,214,335,246,36,32
6285,levle2_6.jpg,fore,Unspecified,0.0,0,333,241,369,273,36,32
6286,levle2_6.jpg,fore,Unspecified,0.0,0,215,238,245,265,30,27
6287,levle2_6.jpg,fore,Unspecified,0.0,0,251,251,283,281,32,30
6288,levle2_6.jpg,fore,Unspecified,0.0,0,238,301,263,333,25,32
6289,levle2_6.jpg,fore,Unspecified,0.0,0,291,367,310,386,19,19
6290,levle2_6.jpg,fore,Unspecified,0.0,0,314,328,364,378,50,50
6291,levle2_6.jpg,fore,Unspecified,0.0,0,383,247,403,270,20,23
6292,levle2_6.jpg,fore,Unspecified,0.0,0,377,194,398,225,21,31
6293,levle2_6.jpg,fore,Unspecified,0.0,0,212,490,248,522,36,32
6294,levle2_6.jpg,fore,Unspecified,0.0,0,238,518,255,553,17,35
6295,levle2_6.jpg,fore,Unspecified,0.0,0,261,468,290,488,29,20
6296,levle2_6.jpg,fore,Unspecified,0.0,0,292,480,326,513,34,33
6297,levle2_6.jpg,fore,Unspecified,0.0,0,313,404,333,428,20,24
6298,levle2_6.jpg,fore,Unspecified,0.0,0,333,386,353,419,20,33
6299,levle2_6.jpg,fore,Unspecified,0.0,0,344,455,367,476,23,21
6300,levle2_6.jpg,fore,Unspecified,0.0,0,376,396,416,431,40,35
6301,levle2_6.jpg,fore,Unspecified,0.0,0,353,404,372,428,19,24
6302,levle2_6.jpg,fore,Unspecified,0.0,0,457,372,497,400,40,28
6303,levle2_6.jpg,fore,Unspecified,0.0,0,263,400,291,430,28,30
6304,levle2_6.jpg,fore,Unspecified,0.0,0,317,272,355,305,38,33
6305,levle2_6.jpg,fore,Unspecified,0.0,0,278,278,311,309,33,31
6306,levle2_6.jpg,fore,Unspecified,0.0,0,179,275,211,313,32,38
6307,levle2_6.jpg,fore,Unspecified,0.0,0,354,155,390,185,36,30
6308,levle2_6.jpg,fore,Unspecified,0.0,0,398,164,446,200,48,36
6309,levle2_6.jpg,fore,Unspecified,0.0,0,421,122,453,164,32,42
6310,levle2_6.jpg,fore,Unspecified,0.0,0,398,73,445,124,47,51
6311,levle3_81.jpg,fore,,,0,1696,1884,1819,2037,123,153
6312,levle3_81.jpg,fore,,,0,1106,1286,1252,1462,146,176
6313,levle3_81.jpg,fore,,,0,1106,834,1290,1010,184,176
6314,levle3_81.jpg,fore,,,0,1152,972,1321,1171,169,199
6315,levle3_81.jpg,fore,,,0,1252,949,1413,1071,161,122
6316,levle3_81.jpg,fore,,,0,1267,1025,1413,1194,146,169
6317,levle3_81.jpg,fore,,,0,1290,1225,1543,1416,253,191
6318,levle3_81.jpg,fore,,,0,1413,887,1597,1079,184,192
6319,levle3_81.jpg,fore,,,0,1558,933,1811,1117,253,184
6320,levle3_81.jpg,fore,,,0,1375,742,1497,880,122,138
6321,levle3_81.jpg,fore,,,0,1344,550,1443,658,99,108
6322,levle3_81.jpg,fore,,,0,1428,458,1612,658,184,200
6323,levle3_81.jpg,fore,,,0,1543,290,1673,466,130,176
6324,levle3_81.jpg,fore,,,0,1980,566,2079,696,99,130
6325,levle3_81.jpg,fore,,,0,1980,796,2164,1002,184,206
6326,levle3_81.jpg,fore,,,0,1191,1478,1359,1661,168,183
6327,levle3_81.jpg,fore,,,0,991,1470,1122,1585,131,115
6328,levle3_81.jpg,fore,,,0,976,1600,1091,1761,115,161
6329,levle3_81.jpg,fore,,,0,1106,1516,1290,1715,184,199
6330,levle3_81.jpg,fore,,,0,999,1723,1175,1853,176,130
6331,levle3_81.jpg,fore,,,0,1129,1592,1290,1784,161,192
6332,levle3_81.jpg,fore,,,0,907,1838,1068,2022,161,184
6333,levle3_81.jpg,fore,,,0,1114,1799,1267,1945,153,146
6334,levle3_81.jpg,fore,,,0,1122,1899,1283,2114,161,215
6335,levle3_81.jpg,fore,,,0,1267,1914,1436,2052,169,138
6336,levle3_81.jpg,fore,,,0,892,2175,1060,2389,168,214
6337,levle3_81.jpg,fore,,,0,692,2267,976,2481,284,214
6338,levle3_81.jpg,fore,,,0,685,1953,869,2206,184,253
6339,levle3_81.jpg,fore,,,0,1030,2297,1214,2543,184,246
6340,levle3_81.jpg,fore,,,0,1152,2229,1336,2458,184,229
6341,levle3_81.jpg,fore,,,0,1359,2474,1535,2635,176,161
6342,levle3_81.jpg,fore,,,0,1482,2206,1643,2359,161,153
6343,levle3_81.jpg,fore,,,0,1474,2328,1635,2535,161,207
6344,levle3_81.jpg,fore,,,0,1673,2083,1880,2290,207,207
6345,levle3_81.jpg,fore,,,0,1681,2374,1834,2489,153,115
6346,levle3_81.jpg,fore,,,0,777,2773,953,2995,176,222
6347,levle3_81.jpg,fore,,,0,991,2688,1206,2903,215,215
6348,levle3_81.jpg,fore,,,0,1551,2612,1719,2826,168,214
6349,levle3_81.jpg,fore,,,0,1267,2811,1436,3018,169,207
6350,levle3_81.jpg,fore,,,0,1589,3071,1811,3278,222,207
6351,levle3_81.jpg,fore,,,0,1735,2987,1965,3186,230,199
6352,levle3_81.jpg,fore,,,0,1681,581,1808,691,127,110
6353,levle3_81.jpg,fore,,,0,1440,2060,1546,2188,106,128
6354,levle3_81.jpg,fore,,,0,1029,3094,1122,3201,93,107
6355,levle3_81.jpg,fore,,,0,1464,3094,1588,3201,124,107
6356,levle3_81.jpg,fore,,,0,1408,2663,1540,2774,132,111
6357,levle3_81.jpg,fore,,,0,1288,2667,1419,2819,131,152
6358,levle3_81.jpg,fore,,,0,1188,2457,1312,2594,124,137
6359,levle3_81.jpg,fore,,,0,1546,1636,1653,1725,107,89
6360,levle3_81.jpg,fore,,,0,1799,1964,1950,2067,151,103
6361,levle3_81.jpg,fore,,,0,953,2001,1119,2112,166,111
6362,levle3_81.jpg,fore,,,0,1895,2453,2015,2570,120,117
6363,levle3_95.jpg,fore,,,0,1669,1319,1860,1477,191,158
6364,levle3_95.jpg,fore,,,0,1694,1684,1844,1842,150,158
6365,levle3_95.jpg,fore,,,0,1744,1909,1802,2067,58,158
6366,levle3_95.jpg,fore,,,0,1744,2258,1877,2441,133,183
6367,levle3_95.jpg,fore,,,0,1727,2541,1819,2782,92,241
6368,levle3_95.jpg,fore,,,0,1810,2599,1935,2698,125,99
6369,levle3_95.jpg,fore,,,0,2708,579,2882,762,174,183
6370,levle3_95.jpg,fore,,,0,2658,305,2799,355,141,50
6371,levle3_95.jpg,fore,,,0,2841,355,2982,513,141,158
6372,levle3_95.jpg,fore,,,0,2101,1884,2251,2058,150,174
6373,levle3_95.jpg,fore,,,0,2242,1934,2301,2133,59,199
6374,levle3_95.jpg,fore,,,0,2326,1826,2525,2000,199,174
6375,levle3_95.jpg,fore,,,0,2342,1950,2517,2108,175,158
6376,levle3_95.jpg,fore,,,0,2425,2167,2484,2225,59,58
6377,levle3_95.jpg,fore,,,0,2533,1967,2691,2133,158,166
6378,levle3_95.jpg,fore,,,0,2093,2133,2284,2275,191,142
6379,levle3_95.jpg,fore,,,0,2942,122,3058,250,116,128
6380,levle3_95.jpg,fore,,,0,2166,1282,2290,1398,124,116
6381,levle3_95.jpg,fore,,,0,2906,1242,3002,1358,96,116
6382,levle3_95.jpg,fore,,,0,2990,1210,3102,1330,112,120
6383,levle3_95.jpg,fore,,,0,1214,2438,1318,2574,104,136
6384,levle3_95.jpg,fore,,,0,1302,2518,1410,2642,108,124
6385,levle3_95.jpg,fore,,,0,1546,2318,1650,2438,104,120
6386,levle3_95.jpg,fore,,,0,2078,1506,2186,1622,108,116
6387,levle3_95.jpg,fore,,,0,1966,1202,2058,1310,92,108
6388,levle3_95.jpg,fore,,,0,2134,898,2326,1054,192,156
6389,levle3_95.jpg,fore,,,0,2006,1062,2154,1206,148,144
6390,levle3_95.jpg,fore,,,0,2530,1222,2690,1326,160,104
6391,levle3_95.jpg,fore,,,0,2674,1622,2790,1714,116,92
6392,levle3_95.jpg,fore,,,0,2646,1854,2778,2006,132,152
6393,levle3_95.jpg,fore,,,0,2226,2366,2318,2470,92,104
6394,levle3_95.jpg,fore,,,0,2258,2526,2434,2654,176,128
6395,levle3_95.jpg,fore,,,0,1890,1534,1986,1706,96,172
6396,levle3_95.jpg,fore,,,0,1774,1542,1890,1694,116,152
6397,levle3_95.jpg,fore,,,0,1862,1410,2078,1554,216,144
6398,levle3_95.jpg,fore,,,0,2246,1178,2370,1266,124,88
6399,levle3_95.jpg,fore,,,0,3038,262,3198,402,160,140
6400,levle3_95.jpg,fore,,,0,2818,190,2922,302,104,112
6401,levle3_95.jpg,fore,,,0,3066,406,3202,594,136,188
6402,levle3_95.jpg,fore,,,0,2718,746,2882,854,164,108
6403,levle3_95.jpg,fore,,,0,2578,506,2702,646,124,140
6404,levle3_95.jpg,fore,,,0,2850,542,3030,658,180,116
6405,levle3_95.jpg,fore,,,0,2930,698,3054,802,124,104
6406,levle3_95.jpg,fore,,,0,3146,706,3238,822,92,116
6407,levle3_95.jpg,fore,,,0,2402,958,2546,1098,144,140
6408,levle3_95.jpg,fore,,,0,2518,1054,2658,1182,140,128
6409,levle3_95.jpg,fore,,,0,2226,1618,2382,1710,156,92
6410,levle3_95.jpg,fore,,,0,1770,2050,1898,2134,128,84
6411,levle3_95.jpg,fore,,,0,1750,2130,1846,2226,96,96
6412,levle3_95.jpg,fore,,,0,1910,2074,2038,2238,128,164
6413,levle3_95.jpg,fore,,,0,1918,2298,2018,2390,100,92
6414,levle3_95.jpg,fore,,,0,1954,2378,2070,2482,116,104
6415,levle3_95.jpg,fore,,,0,1834,1734,1986,1854,152,120
6416,levle3_95.jpg,fore,,,0,2066,2314,2210,2446,144,132
6417,levle3_95.jpg,fore,,,0,1946,2534,2082,2654,136,120
6418,levle3_95.jpg,fore,,,0,1666,1518,1794,1654,128,136
6419,levle3_95.jpg,fore,,,0,1826,1878,2038,2026,212,148
6420,levle3_95.jpg,fore,,,0,1998,1666,2222,1882,224,216
6421,levle0_448.jpg,fore,Unspecified,0.0,0,846,3025,1022,3156,176,131
6422,levle0_448.jpg,fore,Unspecified,0.0,0,1313,3263,1459,3393,146,130
6423,levle0_448.jpg,fore,Unspecified,0.0,0,1566,3133,1727,3240,161,107
6424,levle0_448.jpg,fore,Unspecified,0.0,0,692,1209,815,1324,123,115
6425,levle0_448.jpg,fore,Unspecified,0.0,0,861,2435,1030,2581,169,146
6426,levle1_129.jpg,fore,Unspecified,0.0,0,1482,2412,1643,2566,161,154
6427,levle1_129.jpg,fore,Unspecified,0.0,0,1704,2412,1819,2543,115,131
6428,levle1_129.jpg,fore,Unspecified,0.0,0,2087,2244,2271,2374,184,130
6429,levle1_129.jpg,fore,Unspecified,0.0,0,1627,2734,1765,2803,138,69
6430,levle1_129.jpg,fore,Unspecified,0.0,0,1896,2742,2026,2857,130,115
6431,levle1_129.jpg,fore,Unspecified,0.0,0,1765,2819,1850,2903,85,84
6432,levle1_101.jpg,fore,Unspecified,0.0,0,2442,679,2525,820,83,141
6433,levle1_101.jpg,fore,Unspecified,0.0,0,2833,1859,3007,1992,174,133
6434,levle1_101.jpg,fore,Unspecified,0.0,0,3115,2258,3256,2358,141,100
6435,levle1_101.jpg,fore,Unspecified,0.0,0,2650,2624,2866,2748,216,124
6436,levle1_101.jpg,fore,Unspecified,0.0,0,2833,2815,2924,2915,91,100
6437,levle1_101.jpg,fore,Unspecified,0.0,0,2400,2748,2567,2906,167,158
6438,levle1_101.jpg,fore,Unspecified,0.0,0,2600,2856,2708,2948,108,92
6439,levle1_101.jpg,fore,Unspecified,0.0,0,3414,928,3564,1136,150,208
6440,levle0_312.jpg,fore,Unspecified,0.0,0,1045,1002,1175,1171,130,169
6441,levle0_312.jpg,fore,Unspecified,0.0,0,2018,750,2125,872,107,122
6442,levle0_312.jpg,fore,Unspecified,0.0,0,616,1133,754,1301,138,168
6443,levle0_312.jpg,fore,Unspecified,0.0,0,2072,1064,2194,1225,122,161
6444,levle0_474.jpg,fore,Unspecified,0.0,0,1750,3094,1942,3225,192,131
6445,levle0_474.jpg,fore,Unspecified,0.0,0,1788,2696,1919,2803,131,107
6446,levle0_460.jpg,fore,Unspecified,0.0,0,2409,979,2524,1094,115,115
6447,levle0_460.jpg,fore,Unspecified,0.0,0,2516,887,2639,979,123,92
6448,levle0_460.jpg,fore,Unspecified,0.0,0,2225,1317,2309,1447,84,130
6449,levle1_115.jpg,fore,Unspecified,0.0,0,2051,1759,2201,1867,150,108
6450,levle1_115.jpg,fore,Unspecified,0.0,0,2159,1909,2309,2050,150,141
6451,levle1_115.jpg,fore,Unspecified,0.0,0,2683,2366,2766,2541,83,175
6452,levle1_115.jpg,fore,Unspecified,0.0,0,2533,2557,2658,2698,125,141
6453,levle1_115.jpg,fore,Unspecified,0.0,0,2334,2707,2467,2840,133,133
6454,levle1_115.jpg,fore,Unspecified,0.0,0,2259,2549,2384,2690,125,141
6455,levle1_115.jpg,fore,Unspecified,0.0,0,1968,2615,2134,2748,166,133
6456,levle1_115.jpg,fore,Unspecified,0.0,0,1644,2432,1711,2582,67,150
6457,levle1_115.jpg,fore,Unspecified,0.0,0,1694,2632,1819,2723,125,91
6458,levle1_115.jpg,fore,Unspecified,0.0,0,1819,2715,1918,2840,99,125
6459,levle1_115.jpg,fore,Unspecified,0.0,0,1927,2142,2068,2333,141,191
6460,levle1_115.jpg,fore,Unspecified,0.0,0,2351,2167,2484,2308,133,141
6461,levle1_115.jpg,fore,Unspecified,0.0,0,2317,1967,2434,2100,117,133
6462,levle0_306.jpg,fore,Unspecified,0.0,0,2271,1631,2463,1776,192,145
6463,levle0_306.jpg,fore,Unspecified,0.0,0,1965,2290,2011,2458,46,168
6464,levle0_4.jpg,fore,Unspecified,0.0,0,285,712,351,794,66,82
6465,levle2_16.jpg,fore,Unspecified,0.0,0,251,99,296,140,45,41
6466,levle2_16.jpg,fore,Unspecified,0.0,0,194,152,227,174,33,22
6467,levle2_16.jpg,fore,Unspecified,0.0,0,231,166,251,208,20,42
6468,levle2_16.jpg,fore,Unspecified,0.0,0,194,174,215,202,21,28
6469,levle2_16.jpg,fore,Unspecified,0.0,0,219,212,257,257,38,45
6470,levle2_16.jpg,fore,Unspecified,0.0,0,178,210,213,257,35,47
6471,levle2_16.jpg,fore,Unspecified,0.0,0,130,277,164,318,34,41
6472,levle2_16.jpg,fore,Unspecified,0.0,0,69,344,110,386,41,42
6473,levle2_16.jpg,fore,Unspecified,0.0,0,217,376,259,425,42,49
6474,levle2_16.jpg,fore,Unspecified,0.0,0,283,506,332,530,49,24
6475,levle2_16.jpg,fore,Unspecified,0.0,0,288,532,338,566,50,34
6476,levle2_16.jpg,fore,Unspecified,0.0,0,287,568,342,625,55,57
6477,levle2_16.jpg,fore,Unspecified,0.0,0,423,455,463,496,40,41
6478,levle2_16.jpg,fore,Unspecified,0.0,0,271,643,298,678,27,35
6479,levle2_16.jpg,fore,Unspecified,0.0,0,227,706,273,744,46,38
6480,levle2_16.jpg,fore,Unspecified,0.0,0,237,756,277,795,40,39
6481,levle2_16.jpg,fore,Unspecified,0.0,0,277,789,316,835,39,46
6482,levle2_16.jpg,fore,Unspecified,0.0,0,186,670,221,704,35,34
6483,levle2_16.jpg,fore,Unspecified,0.0,0,229,659,267,712,38,53
6484,levle2_16.jpg,fore,Unspecified,0.0,0,144,605,172,635,28,30
6485,levle2_16.jpg,fore,Unspecified,0.0,0,116,562,156,609,40,47
6486,levle2_16.jpg,fore,Unspecified,0.0,0,33,572,69,621,36,49
6487,levle2_16.jpg,fore,Unspecified,0.0,0,79,643,105,698,26,55
6488,levle2_16.jpg,fore,Unspecified,0.0,0,108,667,152,712,44,45
6489,levle2_16.jpg,fore,Unspecified,0.0,0,45,684,77,718,32,34
6490,levle2_16.jpg,fore,Unspecified,0.0,0,31,714,63,750,32,36
6491,levle2_16.jpg,fore,Unspecified,0.0,0,53,738,97,779,44,41
6492,levle2_16.jpg,fore,Unspecified,0.0,0,130,744,158,779,28,35
6493,levle2_16.jpg,fore,Unspecified,0.0,0,154,785,182,819,28,34
6494,levle2_16.jpg,fore,Unspecified,0.0,0,180,775,227,833,47,58
6495,levle2_16.jpg,fore,Unspecified,0.0,0,231,825,277,868,46,43
6496,levle2_16.jpg,fore,Unspecified,0.0,0,263,837,306,878,43,41
6497,levle2_16.jpg,fore,Unspecified,0.0,0,227,425,265,465,38,40
6498,levle2_16.jpg,fore,Unspecified,0.0,0,176,435,221,491,45,56
6499,levle2_16.jpg,fore,Unspecified,0.0,0,112,477,138,516,26,39
6500,levle2_16.jpg,fore,Unspecified,0.0,0,122,358,154,402,32,44
6501,levle2_16.jpg,fore,Unspecified,0.0,0,178,724,217,775,39,51
6502,levle0_528.jpg,fore,Unspecified,0.0,0,1053,3018,1275,3209,222,191
6503,levle0_528.jpg,fore,Unspecified,0.0,0,838,2428,1037,2558,199,130
6504,levle0_528.jpg,fore,Unspecified,0.0,0,991,1922,1114,2075,123,153
6505,levle0_528.jpg,fore,Unspecified,0.0,0,1129,1784,1244,1976,115,192
6506,levle0_528.jpg,fore,Unspecified,0.0,0,815,1815,938,2022,123,207
6507,levle0_266.jpg,fore,Unspecified,0.0,0,1129,2389,1244,2566,115,177
6508,levle0_266.jpg,fore,Unspecified,0.0,0,1367,2037,1482,2190,115,153
6509,levle0_514.jpg,fore,Unspecified,0.0,0,2424,2435,2570,2566,146,131
6510,levle0_514.jpg,fore,Unspecified,0.0,0,2424,2137,2616,2374,192,237
6511,levle0_272.jpg,fore,Unspecified,0.0,0,1781,956,1857,1102,76,146
6512,levle0_272.jpg,fore,Unspecified,0.0,0,1168,2865,1321,2964,153,99
6513,levle0_299.jpg,fore,Unspecified,0.0,0,1857,1999,1980,2091,123,92
6514,levle0_299.jpg,fore,Unspecified,0.0,0,1405,2236,1566,2389,161,153
6515,levle2_149.jpg,fore,Unspecified,0.0,0,2876,1638,2961,1730,85,92
6516,levle2_149.jpg,fore,Unspecified,0.0,0,2984,1799,3060,1868,76,69
6517,levle2_149.jpg,fore,Unspecified,0.0,0,3007,1478,3099,1592,92,114
6518,levle2_149.jpg,fore,Unspecified,0.0,0,2516,1799,2608,1868,92,69
6519,levle2_149.jpg,fore,Unspecified,0.0,0,2693,1784,2807,1884,114,100
6520,levle2_149.jpg,fore,Unspecified,0.0,0,2493,1891,2631,1976,138,85
6521,levle2_149.jpg,fore,Unspecified,0.0,0,2585,2060,2693,2198,108,138
6522,levle2_149.jpg,fore,Unspecified,0.0,0,2463,2114,2608,2244,145,130
6523,levle2_149.jpg,fore,Unspecified,0.0,0,2325,2152,2440,2244,115,92
6524,levle2_149.jpg,fore,Unspecified,0.0,0,2133,2313,2202,2389,69,76
6525,levle2_149.jpg,fore,Unspecified,0.0,0,2133,2382,2248,2512,115,130
6526,levle2_149.jpg,fore,Unspecified,0.0,0,2248,2366,2401,2481,153,115
6527,levle2_149.jpg,fore,Unspecified,0.0,0,2348,2435,2424,2558,76,123
6528,levle2_149.jpg,fore,Unspecified,0.0,0,2447,2366,2539,2535,92,169
6529,levle2_149.jpg,fore,Unspecified,0.0,0,2516,2229,2616,2351,100,122
6530,levle2_149.jpg,fore,Unspecified,0.0,0,2739,2190,2846,2366,107,176
6531,levle2_149.jpg,fore,Unspecified,0.0,0,2654,2297,2807,2412,153,115
6532,levle2_149.jpg,fore,Unspecified,0.0,0,2708,2374,2846,2604,138,230
6533,levle2_149.jpg,fore,Unspecified,0.0,0,2378,2635,2486,2750,108,115
6534,levle2_149.jpg,fore,Unspecified,0.0,0,1214,2175,1290,2274,76,99
6535,levle2_149.jpg,fore,Unspecified,0.0,0,2693,1171,2830,1271,137,100
6536,levle2_149.jpg,fore,Unspecified,0.0,0,1551,2964,1673,3033,122,69
6537,levle2_149.jpg,fore,Unspecified,0.0,0,1551,3064,1673,3186,122,122
6538,levle2_149.jpg,fore,Unspecified,0.0,0,2853,1914,2984,2037,131,123
6539,levle2_175.jpg,fore,Unspecified,0.0,0,1520,2075,1735,2251,215,176
6540,levle2_175.jpg,fore,Unspecified,0.0,0,1566,1907,1742,2098,176,191
6541,levle2_175.jpg,fore,Unspecified,0.0,0,2164,2060,2378,2213,214,153
6542,levle2_175.jpg,fore,Unspecified,0.0,0,2424,2121,2624,2221,200,100
6543,levle2_175.jpg,fore,Unspecified,0.0,0,2386,2282,2524,2405,138,123
6544,levle2_175.jpg,fore,Unspecified,0.0,0,2654,1746,2830,1907,176,161
6545,levle2_175.jpg,fore,Unspecified,0.0,0,2539,1700,2647,1822,108,122
6546,levle2_175.jpg,fore,Unspecified,0.0,0,2662,1286,2769,1485,107,199
6547,levle2_175.jpg,fore,Unspecified,0.0,0,2325,1347,2432,1447,107,100
6548,levle2_175.jpg,fore,Unspecified,0.0,0,1359,573,1466,673,107,100
6549,levle2_175.jpg,fore,Unspecified,0.0,0,1489,504,1666,619,177,115
6550,levle2_175.jpg,fore,Unspecified,0.0,0,1957,527,2110,681,153,154
6551,levle2_175.jpg,fore,Unspecified,0.0,0,2164,527,2378,719,214,192
6552,levle2_175.jpg,fore,Unspecified,0.0,0,2041,366,2179,504,138,138
6553,levle2_175.jpg,fore,Unspecified,0.0,0,2194,213,2378,382,184,169
6554,levle2_175.jpg,fore,Unspecified,0.0,0,2102,75,2256,205,154,130
6555,levle2_175.jpg,fore,Unspecified,0.0,0,1811,374,2034,543,223,169
6556,levle2_175.jpg,fore,Unspecified,0.0,0,2371,887,2547,1071,176,184
6557,levle2_175.jpg,fore,Unspecified,0.0,0,1781,2006,1926,2098,145,92
6558,levle2_175.jpg,fore,Unspecified,0.0,0,1750,2183,1888,2290,138,107
6559,levle2_175.jpg,fore,Unspecified,0.0,0,2363,1478,2532,1554,169,76
6560,levle2_175.jpg,fore,Unspecified,0.0,0,2386,1646,2493,1845,107,199
6561,levle2_175.jpg,fore,Unspecified,0.0,0,2217,1868,2432,2022,215,154
6562,levle2_175.jpg,fore,Unspecified,0.0,0,2248,2428,2486,2612,238,184
6563,levle2_175.jpg,fore,Unspecified,0.0,0,1704,182,1911,389,207,207
6564,levle2_175.jpg,fore,Unspecified,0.0,0,1206,297,1405,435,199,138
6565,levle2_175.jpg,fore,Unspecified,0.0,0,1344,114,1566,313,222,199
6566,levle2_161.jpg,fore,Unspecified,0.0,0,1382,1700,1505,1761,123,61
6567,levle2_161.jpg,fore,Unspecified,0.0,0,1321,1753,1474,1807,153,54
6568,levle2_161.jpg,fore,Unspecified,0.0,0,1083,1715,1191,1861,108,146
6569,levle2_161.jpg,fore,Unspecified,0.0,0,984,1776,1122,1937,138,161
6570,levle2_161.jpg,fore,Unspecified,0.0,0,738,1600,922,1738,184,138
6571,levle2_161.jpg,fore,Unspecified,0.0,0,570,933,708,1010,138,77
6572,levle2_161.jpg,fore,Unspecified,0.0,0,493,1025,616,1117,123,92
6573,levle2_161.jpg,fore,Unspecified,0.0,0,133,1033,179,1094,46,61
6574,levle2_161.jpg,fore,Unspecified,0.0,0,133,1317,317,1447,184,130
6575,levle2_161.jpg,fore,Unspecified,0.0,0,677,1891,815,1999,138,108
6576,levle2_161.jpg,fore,Unspecified,0.0,0,493,1884,578,1983,85,99
6577,levle2_161.jpg,fore,Unspecified,0.0,0,601,1960,692,2022,91,62
6578,levle2_161.jpg,fore,Unspecified,0.0,0,432,2183,555,2305,123,122
6579,levle2_161.jpg,fore,Unspecified,0.0,0,432,2060,509,2152,77,92
6580,levle2_161.jpg,fore,Unspecified,0.0,0,692,2267,792,2359,100,92
6581,levle2_161.jpg,fore,Unspecified,0.0,0,746,2328,846,2451,100,123
6582,levle2_161.jpg,fore,Unspecified,0.0,0,662,2458,769,2589,107,131
6583,levle2_161.jpg,fore,Unspecified,0.0,0,539,2489,654,2650,115,161
6584,levle2_161.jpg,fore,Unspecified,0.0,0,279,2282,463,2412,184,130
6585,levle2_161.jpg,fore,Unspecified,0.0,0,256,2374,409,2520,153,146
6586,levle2_161.jpg,fore,Unspecified,0.0,0,271,2504,401,2658,130,154
6587,levle2_161.jpg,fore,Unspecified,0.0,0,87,2688,263,2834,176,146
6588,levle2_161.jpg,fore,Unspecified,0.0,0,148,2497,302,2658,154,161
6589,levle2_161.jpg,fore,Unspecified,0.0,0,677,1018,761,1102,84,84
6590,levle1_539.jpg,fore,Unspecified,0.0,0,1995,803,2133,956,138,153
6591,levle1_539.jpg,fore,Unspecified,0.0,0,991,673,1114,811,123,138
6592,levle1_539.jpg,fore,Unspecified,0.0,0,1612,550,1719,642,107,92
6593,levle1_539.jpg,fore,Unspecified,0.0,0,2547,1524,2677,1684,130,160
6594,levle1_539.jpg,fore,Unspecified,0.0,0,585,2029,723,2137,138,108
6595,levle1_539.jpg,fore,Unspecified,0.0,0,708,2167,838,2297,130,130
6596,levle1_539.jpg,fore,Unspecified,0.0,0,2064,2405,2240,2535,176,130
6597,levle1_539.jpg,fore,Unspecified,0.0,0,2455,2175,2570,2313,115,138
6598,levle1_539.jpg,fore,Unspecified,0.0,0,2294,2313,2417,2428,123,115
6599,levle1_539.jpg,fore,Unspecified,0.0,0,2662,2259,2807,2382,145,123
6600,levle1_511.jpg,fore,Unspecified,0.0,0,2524,2167,2654,2313,130,146
6601,levle1_511.jpg,fore,Unspecified,0.0,0,2463,2336,2616,2512,153,176
6602,levle1_511.jpg,fore,Unspecified,0.0,0,1237,3064,1413,3217,176,153
6603,levle1_511.jpg,fore,Unspecified,0.0,0,1627,3056,1796,3202,169,146
6604,levle1_511.jpg,fore,Unspecified,0.0,0,1566,535,1704,681,138,146
6605,levle1_511.jpg,fore,Unspecified,0.0,0,1375,535,1474,650,99,115
6606,levle1_47.jpg,fore,Unspecified,0.0,0,1129,1225,1359,1470,230,245
6607,levle1_47.jpg,fore,Unspecified,0.0,0,2248,1102,2348,1255,100,153
6608,levle1_47.jpg,fore,Unspecified,0.0,0,1949,428,2102,581,153,153
6609,levle1_47.jpg,fore,Unspecified,0.0,0,2102,773,2271,972,169,199
6610,levle1_47.jpg,fore,Unspecified,0.0,0,846,2098,1076,2236,230,138
6611,levle1_47.jpg,fore,Unspecified,0.0,0,1076,2144,1168,2282,92,138
6612,levle1_47.jpg,fore,Unspecified,0.0,0,1030,2251,1183,2351,153,100
6613,levle1_47.jpg,fore,Unspecified,0.0,0,1183,2190,1290,2336,107,146
6614,levle1_47.jpg,fore,Unspecified,0.0,0,1191,2320,1321,2504,130,184
6615,levle1_47.jpg,fore,Unspecified,0.0,0,1443,2504,1620,2719,177,215
6616,levle1_277.jpg,fore,Unspecified,0.0,0,715,719,807,857,92,138
6617,levle1_277.jpg,fore,Unspecified,0.0,0,984,1225,1114,1347,130,122
6618,levle1_277.jpg,fore,Unspecified,0.0,0,670,2244,807,2412,137,168
6619,levle1_277.jpg,fore,Unspecified,0.0,0,440,2658,516,2780,76,122
6620,levle1_277.jpg,fore,Unspecified,0.0,0,547,2727,601,2872,54,145
6621,levle1_277.jpg,fore,Unspecified,0.0,0,608,2780,700,2903,92,123
6622,levle1_277.jpg,fore,Unspecified,0.0,0,731,2956,853,3163,122,207
6623,levle1_277.jpg,fore,Unspecified,0.0,0,915,3048,1037,3209,122,161
6624,levle1_277.jpg,fore,Unspecified,0.0,0,601,2466,715,2612,114,146
6625,levle1_277.jpg,fore,Unspecified,0.0,0,294,2274,401,2466,107,192
6626,levle1_277.jpg,fore,Unspecified,0.0,0,26,2183,164,2320,138,137
6627,levle1_263.jpg,fore,Unspecified,0.0,0,3524,1494,3639,1599,115,105
6628,levle1_263.jpg,fore,Unspecified,0.0,0,3349,1327,3454,1424,105,97
6629,levle1_263.jpg,fore,Unspecified,0.0,0,3296,1643,3410,1757,114,114
6630,levle1_263.jpg,fore,Unspecified,0.0,0,3244,1739,3393,1836,149,97
6631,levle1_263.jpg,fore,Unspecified,0.0,0,3279,1845,3367,1932,88,87
6632,levle1_263.jpg,fore,Unspecified,0.0,0,2525,2266,2630,2380,105,114
6633,levle1_263.jpg,fore,Unspecified,0.0,0,2639,2266,2779,2389,140,123
6634,levle1_263.jpg,fore,Unspecified,0.0,0,2849,2248,2963,2371,114,123
6635,levle1_263.jpg,fore,Unspecified,0.0,0,2981,1959,3156,2117,175,158
6636,levle1_505.jpg,fore,Unspecified,0.0,0,2072,1071,2164,1202,92,131
6637,levle1_505.jpg,fore,Unspecified,0.0,0,2133,1163,2217,1263,84,100
6638,levle1_505.jpg,fore,Unspecified,0.0,0,1811,642,1911,719,100,77
6639,levle1_505.jpg,fore,Unspecified,0.0,0,2348,1485,2478,1608,130,123
6640,levle1_505.jpg,fore,Unspecified,0.0,0,2348,1615,2447,1769,99,154
6641,levle1_505.jpg,fore,Unspecified,0.0,0,1827,2627,1942,2788,115,161
6642,levle1_505.jpg,fore,Unspecified,0.0,0,1443,2558,1574,2627,131,69
6643,levle1_505.jpg,fore,Unspecified,0.0,0,1382,3186,1489,3347,107,161
6644,levle1_505.jpg,fore,Unspecified,0.0,0,2118,2336,2263,2504,145,168
6645,levle1_53.jpg,fore,Unspecified,0.0,0,792,543,938,681,146,138
6646,levle1_53.jpg,fore,Unspecified,0.0,0,815,228,922,351,107,123
6647,levle1_53.jpg,fore,Unspecified,0.0,0,953,121,1137,282,184,161
6648,levle1_53.jpg,fore,Unspecified,0.0,0,1482,658,1612,826,130,168
6649,levle1_53.jpg,fore,Unspecified,0.0,0,1597,604,1696,773,99,169
6650,levle1_53.jpg,fore,Unspecified,0.0,0,1712,773,1934,964,222,191
6651,levle1_53.jpg,fore,Unspecified,0.0,0,1773,1202,1926,1378,153,176
6652,levle1_53.jpg,fore,Unspecified,0.0,0,1865,1684,2018,1807,153,123
6653,levle1_53.jpg,fore,Unspecified,0.0,0,1972,1784,2102,1945,130,161
6654,levle1_53.jpg,fore,Unspecified,0.0,0,1727,1815,1850,1930,123,115
6655,levle1_53.jpg,fore,Unspecified,0.0,0,1735,2175,1827,2320,92,145
6656,levle1_288.jpg,fore,Unspecified,0.0,0,899,1301,1022,1501,123,200
6657,levle1_288.jpg,fore,Unspecified,0.0,0,999,1968,1129,2091,130,123
6658,levle1_288.jpg,fore,Unspecified,0.0,0,1045,2083,1160,2221,115,138
6659,levle1_288.jpg,fore,Unspecified,0.0,0,815,2006,922,2160,107,154
6660,levle1_288.jpg,fore,Unspecified,0.0,0,1114,2251,1229,2458,115,207
6661,levle1_288.jpg,fore,Unspecified,0.0,0,1267,2068,1413,2175,146,107
6662,levle1_288.jpg,fore,Unspecified,0.0,0,1313,2221,1420,2336,107,115
6663,levle1_288.jpg,fore,Unspecified,0.0,0,1459,2328,1581,2504,122,176
6664,levle1_288.jpg,fore,Unspecified,0.0,0,1719,2765,1888,2941,169,176
6665,levle1_288.jpg,fore,Unspecified,0.0,0,1995,2926,2179,3117,184,191
6666,levle1_288.jpg,fore,Unspecified,0.0,0,2003,3079,2125,3186,122,107
6667,levle1_84.jpg,fore,Unspecified,0.0,0,2242,870,2384,1053,142,183
6668,levle1_84.jpg,fore,Unspecified,0.0,0,2068,1443,2201,1610,133,167
6669,levle1_84.jpg,fore,Unspecified,0.0,0,2326,1967,2450,2092,124,125
6670,levle1_84.jpg,fore,Unspecified,0.0,0,3223,2009,3348,2150,125,141
6671,levle1_84.jpg,fore,Unspecified,0.0,0,3115,2324,3223,2474,108,150
6672,levle1_84.jpg,fore,Unspecified,0.0,0,3024,2333,3115,2449,91,116
6673,levle1_84.jpg,fore,Unspecified,0.0,0,2808,2191,2966,2341,158,150
6674,levle1_84.jpg,fore,Unspecified,0.0,0,2808,2374,2941,2516,133,142
6675,levle1_84.jpg,fore,Unspecified,0.0,0,2907,122,3040,305,133,183
6676,levle1_84.jpg,fore,Unspecified,0.0,0,2758,562,2899,720,141,158
6677,levle1_84.jpg,fore,Unspecified,0.0,0,3182,1859,3290,1967,108,108
6678,levle1_84.jpg,fore,Unspecified,0.0,0,3373,2200,3456,2316,83,116
6679,levle1_84.jpg,fore,Unspecified,0.0,0,2899,2549,3074,2723,175,174
6680,levle1_90.jpg,fore,Unspecified,0.0,0,3148,1427,3323,1551,175,124
6681,levle1_90.jpg,fore,Unspecified,0.0,0,3148,1684,3265,1801,117,117
6682,levle1_90.jpg,fore,Unspecified,0.0,0,3572,1119,3763,1294,191,175
6683,levle1_90.jpg,fore,Unspecified,0.0,0,2542,986,2758,1169,216,183
6684,levle1_90.jpg,fore,Unspecified,0.0,0,1486,945,1669,1078,183,133
6685,levle1_90.jpg,fore,Unspecified,0.0,0,1536,712,1760,887,224,175
6686,levle1_90.jpg,fore,Unspecified,0.0,0,1204,695,1403,903,199,208
6687,levle1_90.jpg,fore,Unspecified,0.0,0,838,828,1021,1003,183,175
6688,levle1_90.jpg,fore,Unspecified,0.0,0,954,978,1096,1094,142,116
6689,levle1_90.jpg,fore,Unspecified,0.0,0,846,1069,1004,1244,158,175
6690,levle1_90.jpg,fore,Unspecified,0.0,0,904,1269,1096,1493,192,224
6691,levle1_90.jpg,fore,Unspecified,0.0,0,3273,1684,3464,1901,191,217
6692,levle1_91.jpg,fore,Unspecified,0.0,0,2650,2241,2866,2449,216,208
6693,levle1_91.jpg,fore,Unspecified,0.0,0,2567,2441,2708,2582,141,141
6694,levle1_91.jpg,fore,Unspecified,0.0,0,2326,2349,2492,2582,166,233
6695,levle1_91.jpg,fore,Unspecified,0.0,0,2467,1925,2641,2150,174,225
6696,levle1_91.jpg,fore,Unspecified,0.0,0,2974,2856,3107,3023,133,167
6697,levle1_91.jpg,fore,Unspecified,0.0,0,1802,2042,1943,2250,141,208
6698,levle1_85.jpg,fore,Unspecified,0.0,0,2907,903,3074,1011,167,108
6699,levle1_85.jpg,fore,Unspecified,0.0,0,3190,737,3290,887,100,150
6700,levle1_85.jpg,fore,Unspecified,0.0,0,2334,429,2442,571,108,142
6701,levle1_85.jpg,fore,Unspecified,0.0,0,3381,1676,3464,1809,83,133
6702,levle1_85.jpg,fore,Unspecified,0.0,0,3281,1884,3398,2042,117,158
6703,levle1_85.jpg,fore,Unspecified,0.0,0,3115,1975,3256,2125,141,150
6704,levle1_85.jpg,fore,Unspecified,0.0,0,2575,2225,2683,2374,108,149
6705,levle1_85.jpg,fore,Unspecified,0.0,0,2517,2391,2616,2524,99,133
6706,levle1_85.jpg,fore,Unspecified,0.0,0,2932,2191,3049,2324,117,133
6707,levle1_85.jpg,fore,Unspecified,0.0,0,2899,2349,3099,2432,200,83
6708,levle1_85.jpg,fore,Unspecified,0.0,0,2974,2524,3165,2615,191,91
6709,levle1_85.jpg,fore,Unspecified,0.0,0,2675,2524,2774,2607,99,83
6710,levle1_85.jpg,fore,Unspecified,0.0,0,2675,2607,2866,2715,191,108
6711,levle1_289.jpg,fore,Unspecified,0.0,0,1834,2267,2041,2405,207,138
6712,levle1_289.jpg,fore,Unspecified,0.0,0,1313,2351,1405,2497,92,146
6713,levle1_289.jpg,fore,Unspecified,0.0,0,1168,2251,1290,2428,122,177
6714,levle1_289.jpg,fore,Unspecified,0.0,0,1306,2190,1405,2343,99,153
6715,levle1_289.jpg,fore,Unspecified,0.0,0,884,2129,1022,2297,138,168
6716,levle1_289.jpg,fore,Unspecified,0.0,0,1129,2497,1382,2688,253,191
6717,levle1_289.jpg,fore,Unspecified,0.0,0,1459,3148,1574,3263,115,115
6718,levle1_289.jpg,fore,Unspecified,0.0,0,1689,2842,1819,2941,130,99
6719,levle1_289.jpg,fore,Unspecified,0.0,0,1811,2573,1903,2665,92,92
6720,levle1_289.jpg,fore,Unspecified,0.0,0,1827,3179,1911,3286,84,107
6721,levle1_262.jpg,fore,Unspecified,0.0,0,1858,1573,1954,1678,96,105
6722,levle1_262.jpg,fore,Unspecified,0.0,0,2068,1792,2165,1906,97,114
6723,levle1_262.jpg,fore,Unspecified,0.0,0,2174,1757,2261,1880,87,123
6724,levle1_262.jpg,fore,Unspecified,0.0,0,2472,1792,2586,1950,114,158
6725,levle1_262.jpg,fore,Unspecified,0.0,0,2375,1818,2454,1968,79,150
6726,levle1_262.jpg,fore,Unspecified,0.0,0,2349,2029,2454,2143,105,114
6727,levle1_262.jpg,fore,Unspecified,0.0,0,2332,2239,2402,2362,70,123
6728,levle1_262.jpg,fore,Unspecified,0.0,0,2630,2345,2744,2459,114,114
6729,levle1_262.jpg,fore,Unspecified,0.0,0,2726,2275,2858,2406,132,131
6730,levle1_262.jpg,fore,Unspecified,0.0,0,2902,2248,3033,2353,131,105
6731,levle1_52.jpg,fore,Unspecified,0.0,0,409,1493,539,1654,130,161
6732,levle1_52.jpg,fore,Unspecified,0.0,0,386,1156,547,1393,161,237
6733,levle1_52.jpg,fore,Unspecified,0.0,0,386,1723,539,1884,153,161
6734,levle1_52.jpg,fore,Unspecified,0.0,0,899,2290,968,2428,69,138
6735,levle1_52.jpg,fore,Unspecified,0.0,0,1106,2282,1221,2366,115,84
6736,levle1_52.jpg,fore,Unspecified,0.0,0,1030,2060,1160,2244,130,184
6737,levle1_52.jpg,fore,Unspecified,0.0,0,1283,2420,1382,2543,99,123
6738,levle1_52.jpg,fore,Unspecified,0.0,0,1145,3041,1382,3225,237,184
6739,levle1_504.jpg,fore,Unspecified,0.0,0,386,1087,524,1286,138,199
6740,levle1_504.jpg,fore,Unspecified,0.0,0,884,1064,1014,1209,130,145
6741,levle1_504.jpg,fore,Unspecified,0.0,0,1551,857,1627,995,76,138
6742,levle1_504.jpg,fore,Unspecified,0.0,0,1742,719,1873,903,131,184
6743,levle1_504.jpg,fore,Unspecified,0.0,0,447,2527,570,2665,123,138
6744,levle1_504.jpg,fore,Unspecified,0.0,0,815,2405,930,2520,115,115
6745,levle1_504.jpg,fore,Unspecified,0.0,0,1022,2451,1175,2612,153,161
6746,levle1_46.jpg,fore,Unspecified,0.0,0,662,1340,792,1470,130,130
6747,levle1_46.jpg,fore,Unspecified,0.0,0,792,1209,961,1332,169,123
6748,levle1_46.jpg,fore,Unspecified,0.0,0,884,1317,1014,1439,130,122
6749,levle1_46.jpg,fore,Unspecified,0.0,0,1543,734,1712,926,169,192
6750,levle1_46.jpg,fore,Unspecified,0.0,0,1719,834,1934,995,215,161
6751,levle1_46.jpg,fore,Unspecified,0.0,0,1574,474,1796,619,222,145
6752,levle1_46.jpg,fore,Unspecified,0.0,0,692,2152,853,2236,161,84
6753,levle1_46.jpg,fore,Unspecified,0.0,0,631,2229,769,2451,138,222
6754,levle1_46.jpg,fore,Unspecified,0.0,0,777,2259,861,2389,84,130
6755,levle1_46.jpg,fore,Unspecified,0.0,0,846,2206,961,2320,115,114
6756,levle1_46.jpg,fore,Unspecified,0.0,0,823,2412,984,2527,161,115
6757,levle1_46.jpg,fore,Unspecified,0.0,0,907,2527,1022,2704,115,177
6758,levle1_46.jpg,fore,Unspecified,0.0,0,1007,2328,1129,2443,122,115
6759,levle1_46.jpg,fore,Unspecified,0.0,0,1313,2244,1451,2405,138,161
6760,levle1_46.jpg,fore,Unspecified,0.0,0,1390,2451,1482,2573,92,122
6761,levle1_510.jpg,fore,Unspecified,0.0,0,1811,1263,1949,1416,138,153
6762,levle1_510.jpg,fore,Unspecified,0.0,0,1850,1669,2026,1799,176,130
6763,levle1_510.jpg,fore,Unspecified,0.0,0,984,880,1114,1056,130,176
6764,levle1_510.jpg,fore,Unspecified,0.0,0,1106,918,1267,1171,161,253
6765,levle1_510.jpg,fore,Unspecified,0.0,0,1221,466,1329,596,108,130
6766,levle1_510.jpg,fore,Unspecified,0.0,0,1405,2443,1581,2627,176,184
6767,levle1_510.jpg,fore,Unspecified,0.0,0,1106,2865,1221,3025,115,160
6768,levle1_510.jpg,fore,Unspecified,0.0,0,1214,2842,1313,2987,99,145
6769,levle1_510.jpg,fore,Unspecified,0.0,0,1359,3041,1443,3140,84,99
6770,levle1_510.jpg,fore,Unspecified,0.0,0,1459,3041,1589,3217,130,176
6771,levle1_510.jpg,fore,Unspecified,0.0,0,1627,3064,1773,3255,146,191
6772,levle1_510.jpg,fore,Unspecified,0.0,0,1911,3048,1995,3156,84,108
6773,levle1_276.jpg,fore,Unspecified,0.0,0,1321,2405,1428,2481,107,76
6774,levle1_276.jpg,fore,Unspecified,0.0,0,1344,2527,1466,2658,122,131
6775,levle1_276.jpg,fore,Unspecified,0.0,0,1237,2650,1306,2780,69,130
6776,levle1_276.jpg,fore,Unspecified,0.0,0,861,2037,984,2137,123,100
6777,levle1_276.jpg,fore,Unspecified,0.0,0,1091,2160,1191,2320,100,160
6778,levle1_276.jpg,fore,Unspecified,0.0,0,1221,2206,1283,2343,62,137
6779,levle1_538.jpg,fore,Unspecified,0.0,0,1091,1248,1183,1424,92,176
6780,levle1_538.jpg,fore,Unspecified,0.0,0,1237,1010,1390,1163,153,153
6781,levle1_538.jpg,fore,Unspecified,0.0,0,1459,1041,1543,1156,84,115
6782,levle1_538.jpg,fore,Unspecified,0.0,0,907,826,1053,964,146,138
6783,levle1_538.jpg,fore,Unspecified,0.0,0,915,2129,1014,2251,99,122
6784,levle1_538.jpg,fore,Unspecified,0.0,0,1781,2903,1865,3033,84,130
6785,levle1_538.jpg,fore,Unspecified,0.0,0,1980,2558,2118,2719,138,161
6786,levle1_538.jpg,fore,Unspecified,0.0,0,2156,2581,2263,2696,107,115
6787,levle1_538.jpg,fore,Unspecified,0.0,0,2378,2328,2516,2520,138,192
6788,levle1_538.jpg,fore,Unspecified,0.0,0,1321,474,1420,612,99,138
6789,levle2_160.jpg,fore,,,0,830,1654,899,1784,69,130
6790,levle2_160.jpg,fore,,,0,1635,2857,1788,2964,153,107
6791,levle2_160.jpg,fore,,,0,1627,3102,1712,3286,85,184
6792,levle2_160.jpg,fore,,,0,1773,3025,1888,3110,115,85
6793,levle2_160.jpg,fore,,,0,1949,2972,2110,3125,161,153
6794,levle2_160.jpg,fore,,,0,2110,2857,2271,2987,161,130
6795,levle2_160.jpg,fore,,,0,2539,2803,2616,2926,77,123
6796,levle2_160.jpg,fore,,,0,2348,2727,2532,2880,184,153
6797,levle2_160.jpg,fore,,,0,2417,2612,2532,2681,115,69
6798,levle2_160.jpg,fore,,,0,2555,2435,2769,2635,214,200
6799,levle2_160.jpg,fore,,,0,2647,1363,2754,1501,107,138
6800,levle2_160.jpg,fore,,,0,2647,1186,2746,1317,99,131
6801,levle2_160.jpg,fore,,,0,1543,1784,1673,1953,130,169
6802,levle2_160.jpg,fore,,,0,1681,1784,1842,1861,161,77
6803,levle2_160.jpg,fore,,,0,1689,1891,1819,2075,130,184
6804,levle2_160.jpg,fore,,,0,1604,2037,1719,2221,115,184
6805,levle2_160.jpg,fore,,,0,2348,2206,2463,2274,115,68
6806,levle2_160.jpg,fore,,,0,1727,2435,1850,2504,123,69
6807,levle2_160.jpg,fore,,,0,2072,2412,2187,2512,115,100
6808,levle2_160.jpg,fore,,,0,1988,2581,2102,2665,114,84
6809,levle2_174.jpg,fore,Unspecified,0.0,0,1137,1179,1152,1232,15,53
6810,levle2_174.jpg,fore,Unspecified,0.0,0,1060,1033,1137,1186,77,153
6811,levle2_174.jpg,fore,Unspecified,0.0,0,1191,1041,1321,1194,130,153
6812,levle2_174.jpg,fore,Unspecified,0.0,0,1122,1225,1367,1278,245,53
6813,levle2_174.jpg,fore,Unspecified,0.0,0,922,826,1030,979,108,153
6814,levle2_174.jpg,fore,Unspecified,0.0,0,1221,956,1397,1094,176,138
6815,levle2_174.jpg,fore,Unspecified,0.0,0,1045,750,1214,880,169,130
6816,levle2_174.jpg,fore,Unspecified,0.0,0,302,1753,440,1953,138,200
6817,levle2_174.jpg,fore,Unspecified,0.0,0,486,1792,685,1983,199,191
6818,levle2_174.jpg,fore,Unspecified,0.0,0,271,2160,363,2259,92,99
6819,levle2_174.jpg,fore,Unspecified,0.0,0,340,2244,447,2336,107,92
6820,levle2_174.jpg,fore,Unspecified,0.0,0,271,2527,401,2704,130,177
6821,levle2_174.jpg,fore,Unspecified,0.0,0,409,2412,478,2642,69,230
6822,levle2_174.jpg,fore,Unspecified,0.0,0,463,2244,562,2428,99,184
6823,levle2_174.jpg,fore,Unspecified,0.0,0,555,2313,647,2466,92,153
6824,levle2_174.jpg,fore,Unspecified,0.0,0,616,2428,731,2481,115,53
6825,levle2_174.jpg,fore,Unspecified,0.0,0,807,2290,907,2412,100,122
6826,levle2_174.jpg,fore,Unspecified,0.0,0,899,2114,999,2305,100,191
6827,levle2_174.jpg,fore,Unspecified,0.0,0,670,2098,792,2251,122,153
6828,levle2_174.jpg,fore,Unspecified,0.0,0,723,2504,899,2665,176,161
6829,levle2_174.jpg,fore,Unspecified,0.0,0,631,2619,823,2757,192,138
6830,levle2_174.jpg,fore,Unspecified,0.0,0,761,2796,953,2956,192,160
6831,levle2_174.jpg,fore,Unspecified,0.0,0,884,2964,1037,3094,153,130
6832,levle2_174.jpg,fore,Unspecified,0.0,0,1007,2979,1214,3125,207,146
6833,levle2_174.jpg,fore,Unspecified,0.0,0,547,2995,692,3140,145,145
6834,levle2_174.jpg,fore,Unspecified,0.0,0,754,2995,869,3064,115,69
6835,levle2_174.jpg,fore,Unspecified,0.0,0,1022,2596,1260,2780,238,184
6836,levle2_174.jpg,fore,Unspecified,0.0,0,677,3125,792,3232,115,107
6837,levle2_174.jpg,fore,Unspecified,0.0,0,715,3202,861,3301,146,99
6838,levle2_174.jpg,fore,Unspecified,0.0,0,838,3248,1030,3386,192,138
6839,levle2_148.jpg,fore,Unspecified,0.0,0,1850,1041,1972,1133,122,92
6840,levle2_148.jpg,fore,Unspecified,0.0,0,1030,1102,1129,1163,99,61
6841,levle2_148.jpg,fore,Unspecified,0.0,0,922,1010,1030,1087,108,77
6842,levle2_148.jpg,fore,Unspecified,0.0,0,723,1202,846,1286,123,84
6843,levle2_148.jpg,fore,Unspecified,0.0,0,784,1240,907,1355,123,115
6844,levle2_148.jpg,fore,Unspecified,0.0,0,555,1769,692,1853,137,84
6845,levle2_148.jpg,fore,Unspecified,0.0,0,424,2060,562,2152,138,92
6846,levle2_148.jpg,fore,Unspecified,0.0,0,378,2183,516,2336,138,153
6847,levle2_148.jpg,fore,Unspecified,0.0,0,516,2183,631,2313,115,130
6848,levle2_148.jpg,fore,Unspecified,0.0,0,654,2114,784,2244,130,130
6849,levle2_148.jpg,fore,Unspecified,0.0,0,769,2052,876,2175,107,123
6850,levle2_148.jpg,fore,Unspecified,0.0,0,915,2060,1045,2175,130,115
6851,levle2_148.jpg,fore,Unspecified,0.0,0,1137,1937,1298,2091,161,154
6852,levle2_148.jpg,fore,Unspecified,0.0,0,815,2152,922,2236,107,84
6853,levle2_148.jpg,fore,Unspecified,0.0,0,945,2290,1099,2382,154,92
6854,levle2_148.jpg,fore,Unspecified,0.0,0,838,2297,938,2405,100,108
6855,levle2_148.jpg,fore,Unspecified,0.0,0,807,2435,938,2573,131,138
6856,levle2_148.jpg,fore,Unspecified,0.0,0,1183,2144,1313,2236,130,92
6857,levle2_148.jpg,fore,Unspecified,0.0,0,1152,2229,1275,2336,123,107
6858,levle2_148.jpg,fore,Unspecified,0.0,0,1083,2474,1252,2627,169,153
6859,levle2_148.jpg,fore,Unspecified,0.0,0,1298,2336,1390,2443,92,107
6860,levle2_148.jpg,fore,Unspecified,0.0,0,1405,2320,1520,2428,115,108
6861,levle2_148.jpg,fore,Unspecified,0.0,0,1535,2880,1635,3048,100,168
6862,levle2_148.jpg,fore,Unspecified,0.0,0,1727,3010,1857,3117,130,107
6863,levle2_148.jpg,fore,Unspecified,0.0,0,1972,2811,2079,2918,107,107
6864,levle0_298.jpg,fore,Unspecified,0.0,0,1788,2037,1880,2213,92,176
6865,levle0_298.jpg,fore,Unspecified,0.0,0,1237,3048,1359,3186,122,138
6866,levle0_515.jpg,fore,Unspecified,0.0,0,1359,2060,1466,2236,107,176
6867,levle0_273.jpg,fore,Unspecified,0.0,0,1183,2796,1413,2918,230,122
6868,levle0_273.jpg,fore,Unspecified,0.0,0,1796,788,1988,987,192,199
6869,levle0_267.jpg,fore,Unspecified,0.0,0,1765,3171,1919,3317,154,146
6870,levle0_501.jpg,fore,Unspecified,0.0,0,823,2098,1007,2267,184,169
6871,levle0_529.jpg,fore,Unspecified,0.0,0,2003,1761,2164,1945,161,184
6872,levle2_17.jpg,fore,Unspecified,0.0,0,352,2,372,26,20,24
6873,levle2_17.jpg,fore,Unspecified,0.0,0,356,31,372,52,16,21
6874,levle2_17.jpg,fore,Unspecified,0.0,0,263,62,287,86,24,24
6875,levle2_17.jpg,fore,Unspecified,0.0,0,242,97,264,120,22,23
6876,levle2_17.jpg,fore,Unspecified,0.0,0,194,125,213,141,19,16
6877,levle2_17.jpg,fore,Unspecified,0.0,0,190,104,213,125,23,21
6878,levle2_17.jpg,fore,Unspecified,0.0,0,171,215,196,233,25,18
6879,levle2_17.jpg,fore,Unspecified,0.0,0,213,220,245,245,32,25
6880,levle2_17.jpg,fore,Unspecified,0.0,0,200,249,219,264,19,15
6881,levle2_17.jpg,fore,Unspecified,0.0,0,204,257,217,280,13,23
6882,levle2_17.jpg,fore,Unspecified,0.0,0,215,260,234,275,19,15
6883,levle2_17.jpg,fore,Unspecified,0.0,0,189,271,209,294,20,23
6884,levle2_17.jpg,fore,Unspecified,0.0,0,159,287,177,304,18,17
6885,levle2_17.jpg,fore,Unspecified,0.0,0,133,283,149,306,16,23
6886,levle2_17.jpg,fore,Unspecified,0.0,0,197,294,213,314,16,20
6887,levle2_17.jpg,fore,Unspecified,0.0,0,183,314,204,334,21,20
6888,levle2_17.jpg,fore,Unspecified,0.0,0,138,334,160,356,22,22
6889,levle2_17.jpg,fore,Unspecified,0.0,0,221,298,235,323,14,25
6890,levle2_17.jpg,fore,Unspecified,0.0,0,239,279,265,301,26,22
6891,levle2_17.jpg,fore,Unspecified,0.0,0,241,293,266,315,25,22
6892,levle2_17.jpg,fore,Unspecified,0.0,0,245,320,264,340,19,20
6893,levle2_17.jpg,fore,Unspecified,0.0,0,278,292,302,312,24,20
6894,levle2_17.jpg,fore,Unspecified,0.0,0,277,270,298,288,21,18
6895,levle2_17.jpg,fore,Unspecified,0.0,0,361,225,385,247,24,22
6896,levle2_17.jpg,fore,Unspecified,0.0,0,270,358,281,374,11,16
6897,levle2_17.jpg,fore,Unspecified,0.0,0,263,392,284,412,21,20
6898,levle2_17.jpg,fore,Unspecified,0.0,0,326,403,346,420,20,17
6899,levle2_17.jpg,fore,Unspecified,0.0,0,354,423,382,441,28,18
6900,levle2_17.jpg,fore,Unspecified,0.0,0,308,358,326,376,18,18
6901,levle2_17.jpg,fore,Unspecified,0.0,0,292,365,312,390,20,25
6902,levle2_17.jpg,fore,Unspecified,0.0,0,214,64,241,88,27,24
6903,levle0_5.jpg,fore,Unspecified,0.0,0,182,785,244,847,62,62
6904,levle0_461.jpg,fore,Unspecified,0.0,0,2034,1838,2179,2006,145,168
6905,levle0_461.jpg,fore,Unspecified,0.0,0,2317,872,2532,1056,215,184
6906,levle0_307.jpg,fore,Unspecified,0.0,0,2340,1838,2501,1976,161,138
6907,levle1_114.jpg,fore,Unspecified,0.0,0,3356,1028,3506,1186,150,158
6908,levle1_114.jpg,fore,Unspecified,0.0,0,2633,770,2708,895,75,125
6909,levle1_114.jpg,fore,Unspecified,0.0,0,3315,1468,3423,1618,108,150
6910,levle1_114.jpg,fore,Unspecified,0.0,0,3439,1693,3556,1851,117,158
6911,levle1_114.jpg,fore,Unspecified,0.0,0,2999,1884,3099,2009,100,125
6912,levle1_114.jpg,fore,Unspecified,0.0,0,2891,1801,2974,1950,83,149
6913,levle1_114.jpg,fore,Unspecified,0.0,0,2866,2316,3024,2482,158,166
6914,levle1_114.jpg,fore,Unspecified,0.0,0,2874,2640,2999,2765,125,125
6915,levle1_114.jpg,fore,Unspecified,0.0,0,3065,2549,3207,2632,142,83
6916,levle1_114.jpg,fore,Unspecified,0.0,0,3099,2632,3240,2740,141,108
6917,levle1_114.jpg,fore,Unspecified,0.0,0,3306,2432,3456,2541,150,109
6918,levle1_114.jpg,fore,Unspecified,0.0,0,3406,2524,3514,2632,108,108
6919,levle1_114.jpg,fore,Unspecified,0.0,0,3531,2474,3664,2624,133,150
6920,levle1_114.jpg,fore,Unspecified,0.0,0,3298,2233,3389,2399,91,166
6921,levle1_114.jpg,fore,Unspecified,0.0,0,3198,2258,3273,2399,75,141
6922,levle1_114.jpg,fore,Unspecified,0.0,0,3448,1418,3572,1576,124,158
6923,levle1_114.jpg,fore,Unspecified,0.0,0,2949,587,3074,729,125,142
6924,levle0_313.jpg,fore,Unspecified,0.0,0,1873,1079,2018,1194,145,115
6925,levle0_313.jpg,fore,Unspecified,0.0,0,1689,819,1888,926,199,107
6926,levle0_313.jpg,fore,Unspecified,0.0,0,1811,2443,1942,2612,131,169
6927,levle1_100.jpg,fore,Unspecified,0.0,0,2766,2333,2907,2499,141,166
6928,levle1_100.jpg,fore,Unspecified,0.0,0,2641,2532,2708,2624,67,92
6929,levle1_100.jpg,fore,Unspecified,0.0,0,2725,2541,2808,2640,83,99
6930,levle1_100.jpg,fore,Unspecified,0.0,0,2658,2624,2808,2723,150,99
6931,levle1_100.jpg,fore,Unspecified,0.0,0,2467,2449,2567,2599,100,150
6932,levle1_100.jpg,fore,Unspecified,0.0,0,2159,1734,2317,1859,158,125
6933,levle0_475.jpg,fore,Unspecified,0.0,0,524,2006,677,2167,153,161
6934,levle0_475.jpg,fore,Unspecified,0.0,0,1321,3225,1489,3378,168,153
6935,levle1_128.jpg,fore,Unspecified,0.0,0,2202,2474,2317,2596,115,122
6936,levle1_128.jpg,fore,Unspecified,0.0,0,2248,2397,2371,2497,123,100
6937,levle1_128.jpg,fore,Unspecified,0.0,0,2011,2320,2141,2474,130,154
6938,levle1_128.jpg,fore,Unspecified,0.0,0,2118,2734,2225,2842,107,108
6939,levle1_128.jpg,fore,Unspecified,0.0,0,1842,2895,1995,3048,153,153
6940,levle1_128.jpg,fore,Unspecified,0.0,0,1842,2734,1957,2865,115,131
6941,levle1_128.jpg,fore,Unspecified,0.0,0,2087,2911,2302,3025,215,114
6942,levle0_449.jpg,fore,,,0,2532,1363,2631,1508,99,145
6943,levle0_449.jpg,fore,,,0,2455,2811,2585,2972,130,161
6944,levle0_449.jpg,fore,,,0,1175,2911,1298,3117,123,206
6945,levle0_449.jpg,fore,,,0,1344,1378,1420,1462,76,84
6946,levle0_449.jpg,fore,,,0,1765,3048,1896,3156,131,108
6947,levle0_12.jpg,fore,Unspecified,0.0,0,219,499,238,508,19,9
6948,levle3_94.jpg,fore,,,0,3215,1676,3431,1817,216,141
6949,levle3_94.jpg,fore,,,0,3373,1709,3497,1792,124,83
6950,levle3_94.jpg,fore,,,0,3406,1518,3639,1660,233,142
6951,levle3_94.jpg,fore,,,0,3090,1834,3265,1959,175,125
6952,levle3_94.jpg,fore,,,0,3107,1984,3248,2125,141,141
6953,levle3_94.jpg,fore,,,0,3256,2017,3414,2167,158,150
6954,levle3_94.jpg,fore,,,0,3506,1792,3722,1917,216,125
6955,levle3_94.jpg,fore,,,0,2783,1709,2949,1867,166,158
6956,levle3_94.jpg,fore,,,0,2691,1759,2791,1909,100,150
6957,levle3_94.jpg,fore,,,0,2583,1792,2741,1959,158,167
6958,levle3_94.jpg,fore,,,0,2500,1959,2550,1992,50,33
6959,levle3_94.jpg,fore,,,0,2384,1842,2533,1967,149,125
6960,levle3_94.jpg,fore,,,0,2434,2100,2517,2158,83,58
6961,levle3_94.jpg,fore,,,0,2267,1975,2450,2100,183,125
6962,levle3_94.jpg,fore,,,0,2284,1801,2434,1934,150,133
6963,levle3_94.jpg,fore,,,0,2351,1676,2517,1784,166,108
6964,levle3_94.jpg,fore,,,0,2118,1518,2259,1676,141,158
6965,levle3_94.jpg,fore,,,0,2234,1394,2367,1560,133,166
6966,levle3_94.jpg,fore,,,0,2292,1352,2475,1485,183,133
6967,levle3_94.jpg,fore,,,0,2484,1319,2625,1410,141,91
6968,levle3_94.jpg,fore,,,0,2542,1443,2650,1510,108,67
6969,levle3_94.jpg,fore,,,0,2675,1385,2833,1510,158,125
6970,levle3_94.jpg,fore,,,0,2691,1510,2907,1626,216,116
6971,levle3_94.jpg,fore,,,0,3015,1394,3099,1493,84,99
6972,levle3_94.jpg,fore,,,0,3223,1136,3373,1310,150,174
6973,levle3_94.jpg,fore,,,0,3365,1094,3514,1194,149,100
6974,levle3_94.jpg,fore,,,0,1511,1809,1711,2034,200,225
6975,levle3_94.jpg,fore,,,0,1619,1693,1785,1817,166,124
6976,levle3_94.jpg,fore,,,0,1594,1485,1760,1635,166,150
6977,levle3_94.jpg,fore,,,0,1120,2233,1303,2333,183,100
6978,levle3_94.jpg,fore,,,0,663,2383,780,2507,117,124
6979,levle3_94.jpg,fore,,,0,871,2682,1012,2790,141,108
6980,levle3_94.jpg,fore,,,0,913,2067,1046,2200,133,133
6981,levle3_94.jpg,fore,,,0,1827,1385,1918,1560,91,175
6982,levle3_94.jpg,fore,,,0,1702,1261,1819,1369,117,108
6983,levle3_94.jpg,fore,,,0,1420,1585,1544,1701,124,116
6984,levle3_94.jpg,fore,,,0,1179,1585,1436,1684,257,99
6985,levle3_94.jpg,fore,,,0,697,2050,846,2167,149,117
6986,levle3_94.jpg,fore,,,0,713,2183,946,2291,233,108
6987,levle3_94.jpg,fore,,,0,755,2432,896,2599,141,167
6988,levle3_94.jpg,fore,,,0,929,2466,1137,2649,208,183
6989,levle3_94.jpg,fore,,,0,1029,2557,1237,2707,208,150
6990,levle3_94.jpg,fore,,,0,3015,1551,3148,1668,133,117
6991,levle3_94.jpg,fore,,,0,3148,1643,3265,1751,117,108
6992,levle3_94.jpg,fore,,,0,3290,1792,3464,1984,174,192
6993,levle3_94.jpg,fore,,,0,3406,1892,3589,2050,183,158
6994,levle3_94.jpg,fore,,,0,3739,2225,3755,2241,16,16
6995,levle3_94.jpg,fore,,,0,3198,670,3494,910,296,240
6996,levle3_94.jpg,fore,,,0,3674,1358,3906,1578,232,220
6997,levle3_94.jpg,fore,,,0,2626,1038,3026,1330,400,292
6998,levle3_94.jpg,fore,,,0,2174,2982,2346,3122,172,140
6999,levle3_94.jpg,fore,,,0,1090,1710,1366,1938,276,228
7000,levle3_94.jpg,fore,,,0,1322,1874,1550,2062,228,188
7001,levle3_94.jpg,fore,,,0,1170,2070,1418,2254,248,184
7002,levle3_94.jpg,fore,,,0,2758,670,3054,910,296,240
7003,levle3_94.jpg,fore,,,0,3034,874,3298,1106,264,232
7004,levle3_94.jpg,fore,,,0,3294,938,3534,1090,240,152
7005,levle3_94.jpg,fore,,,0,3582,1130,3834,1350,252,220
7006,levle2_7.jpg,fore,Unspecified,0.0,0,150,48,160,56,10,8
7007,levle2_7.jpg,fore,Unspecified,0.0,0,151,57,163,71,12,14
7008,levle2_7.jpg,fore,Unspecified,0.0,0,140,67,154,79,14,12
7009,levle2_7.jpg,fore,Unspecified,0.0,0,84,28,94,38,10,10
7010,levle2_7.jpg,fore,Unspecified,0.0,0,109,20,120,31,11,11
7011,levle2_7.jpg,fore,Unspecified,0.0,0,120,17,128,25,8,8
7012,levle2_7.jpg,fore,Unspecified,0.0,0,131,28,141,36,10,8
7013,levle2_7.jpg,fore,Unspecified,0.0,0,90,44,102,50,12,6
7014,levle2_7.jpg,fore,Unspecified,0.0,0,96,62,106,69,10,7
7015,levle2_7.jpg,fore,Unspecified,0.0,0,100,95,116,107,16,12
7016,levle2_7.jpg,fore,Unspecified,0.0,0,90,91,99,100,9,9
7017,levle2_7.jpg,fore,Unspecified,0.0,0,91,102,102,111,11,9
7018,levle2_7.jpg,fore,Unspecified,0.0,0,78,107,88,115,10,8
7019,levle2_7.jpg,fore,Unspecified,0.0,0,88,111,97,120,9,9
7020,levle2_7.jpg,fore,Unspecified,0.0,0,130,88,140,96,10,8
7021,levle2_7.jpg,fore,Unspecified,0.0,0,135,96,146,107,11,11
7022,levle2_7.jpg,fore,Unspecified,0.0,0,124,117,140,128,16,11
7023,levle2_7.jpg,fore,Unspecified,0.0,0,105,111,113,118,8,7
7024,levle2_7.jpg,fore,Unspecified,0.0,0,114,114,121,123,7,9
7025,levle2_7.jpg,fore,Unspecified,0.0,0,103,119,115,132,12,13
7026,levle2_7.jpg,fore,Unspecified,0.0,0,96,140,103,150,7,10
7027,levle2_7.jpg,fore,Unspecified,0.0,0,108,138,119,152,11,14
7028,levle2_7.jpg,fore,Unspecified,0.0,0,117,138,126,146,9,8
7029,levle2_7.jpg,fore,Unspecified,0.0,0,127,138,138,149,11,11
7030,levle2_7.jpg,fore,Unspecified,0.0,0,116,162,120,171,4,9
7031,levle2_7.jpg,fore,Unspecified,0.0,0,106,155,116,165,10,10
7032,levle2_7.jpg,fore,Unspecified,0.0,0,140,172,152,186,12,14
7033,levle2_7.jpg,fore,Unspecified,0.0,0,118,103,130,114,12,11
7034,levle2_7.jpg,fore,Unspecified,0.0,0,90,126,102,138,12,12
7035,levle2_7.jpg,fore,Unspecified,0.0,0,77,92,88,100,11,8
7036,levle2_7.jpg,fore,Unspecified,0.0,0,65,79,79,94,14,15
7037,levle2_7.jpg,fore,Unspecified,0.0,0,75,77,86,84,11,7
7038,levle2_7.jpg,fore,Unspecified,0.0,0,76,83,86,94,10,11
7039,levle2_7.jpg,fore,Unspecified,0.0,0,94,81,108,90,14,9
7040,levle2_7.jpg,fore,Unspecified,0.0,0,118,76,129,89,11,13
7041,levle2_7.jpg,fore,Unspecified,0.0,0,117,65,125,74,8,9
7042,levle2_7.jpg,fore,Unspecified,0.0,0,130,72,136,79,6,7
7043,levle2_7.jpg,fore,Unspecified,0.0,0,128,62,138,70,10,8
7044,levle2_7.jpg,fore,Unspecified,0.0,0,109,53,121,63,12,10
7045,levle2_7.jpg,fore,Unspecified,0.0,0,124,48,139,58,15,10
7046,levle2_7.jpg,fore,Unspecified,0.0,0,103,49,113,58,10,9
7047,levle2_7.jpg,fore,Unspecified,0.0,0,85,65,95,76,10,11
7048,levle3_80.jpg,fore,,,0,1443,627,1643,819,200,192
7049,levle3_80.jpg,fore,,,0,1329,819,1535,1025,206,206
7050,levle3_80.jpg,fore,,,0,1168,895,1290,1018,122,123
7051,levle3_80.jpg,fore,,,0,1076,765,1298,979,222,214
7052,levle3_80.jpg,fore,,,0,1175,550,1367,719,192,169
7053,levle3_80.jpg,fore,,,0,1191,366,1344,504,153,138
7054,levle3_80.jpg,fore,,,0,1352,274,1612,359,260,85
7055,levle3_80.jpg,fore,,,0,2217,887,2432,1018,215,131
7056,levle3_80.jpg,fore,,,0,2049,956,2248,1110,199,154
7057,levle3_80.jpg,fore,,,0,2202,1041,2332,1171,130,130
7058,levle3_80.jpg,fore,,,0,2164,619,2386,734,222,115
7059,levle3_80.jpg,fore,,,0,2240,1125,2417,1294,177,169
7060,levle3_80.jpg,fore,,,0,2164,1271,2302,1409,138,138
7061,levle3_80.jpg,fore,,,0,2509,1056,2585,1194,76,138
7062,levle3_80.jpg,fore,,,0,2401,1163,2608,1301,207,138
7063,levle3_80.jpg,fore,,,0,2394,1209,2547,1401,153,192
7064,levle3_80.jpg,fore,,,0,2478,1355,2585,1485,107,130
7065,levle3_80.jpg,fore,,,0,2555,1217,2677,1324,122,107
7066,levle3_80.jpg,fore,,,0,2608,1378,2754,1508,146,130
7067,levle3_80.jpg,fore,,,0,2700,1255,2846,1409,146,154
7068,levle3_80.jpg,fore,,,0,2601,972,2807,1209,206,237
7069,levle3_80.jpg,fore,,,0,2363,1585,2539,1692,176,107
7070,levle3_80.jpg,fore,,,0,2332,1769,2509,1899,177,130
7071,levle3_80.jpg,fore,,,0,2309,1930,2447,2075,138,145
7072,levle3_80.jpg,fore,,,0,2447,1914,2578,2022,131,108
7073,levle3_80.jpg,fore,,,0,2700,1822,2853,2029,153,207
7074,levle3_80.jpg,fore,,,0,2447,2014,2608,2167,161,153
7075,levle3_80.jpg,fore,,,0,2532,2160,2677,2320,145,160
7076,levle3_80.jpg,fore,,,0,2417,2328,2647,2451,230,123
7077,levle3_80.jpg,fore,,,0,2332,2550,2570,2765,238,215
7078,levle3_80.jpg,fore,,,0,2194,2236,2363,2382,169,146
7079,levle3_80.jpg,fore,,,0,2133,2328,2279,2504,146,176
7080,levle3_80.jpg,fore,,,0,2187,2068,2363,2267,176,199
7081,levle3_80.jpg,fore,,,0,2110,1838,2309,1999,199,161
7082,levle3_80.jpg,fore,,,0,1957,2014,2125,2175,168,161
7083,levle3_80.jpg,fore,,,0,1942,2144,2210,2320,268,176
7084,levle3_80.jpg,fore,,,0,1712,2244,1911,2343,199,99
7085,levle3_80.jpg,fore,,,0,1811,2075,1980,2244,169,169
7086,levle3_80.jpg,fore,,,0,1903,1899,2095,2091,192,192
7087,levle3_80.jpg,fore,,,0,1574,1930,1781,2144,207,214
7088,levle3_80.jpg,fore,,,0,1888,2389,2026,2558,138,169
7089,levle3_80.jpg,fore,,,0,1880,2627,1995,2803,115,176
7090,levle3_80.jpg,fore,,,0,2064,2604,2164,2734,100,130
7091,levle3_80.jpg,fore,,,0,1719,3087,1888,3255,169,168
7092,levle3_80.jpg,fore,,,0,1540,2415,1626,2525,86,110
7093,levle3_80.jpg,fore,,,0,1619,2739,1726,2905,107,166
7094,levle3_80.jpg,fore,,,0,2677,2484,2798,2594,121,110
7095,levle3_80.jpg,fore,,,0,2688,1498,2826,1653,138,155
7096,levle3_80.jpg,fore,,,0,1695,632,1874,767,179,135
7097,levle3_80.jpg,fore,,,0,2008,2460,2129,2574,121,114
7098,levle3_80.jpg,fore,,,0,1943,2874,2095,3022,152,148
7099,levle3_80.jpg,fore,,,0,1471,2874,1598,3005,127,131
7100,levle3_80.jpg,fore,,,0,1377,3029,1502,3181,125,152
7101,levle3_80.jpg,fore,,,0,1260,2826,1388,2974,128,148
7102,levle3_80.jpg,fore,,,0,2940,2170,3036,2305,96,135
7103,levle3_80.jpg,fore,,,0,2591,2015,2719,2153,128,138
7104,levle3_80.jpg,fore,,,0,2160,1767,2281,1877,121,110
7105,levle3_57.jpg,fore,,,0,190,143,212,159,22,16
7106,levle3_57.jpg,fore,,,0,258,169,276,187,18,18
7107,levle3_57.jpg,fore,,,0,251,246,266,259,15,13
7108,levle3_57.jpg,fore,,,0,203,251,223,271,20,20
7109,levle3_57.jpg,fore,,,0,178,233,203,252,25,19
7110,levle3_57.jpg,fore,,,0,166,242,182,262,16,20
7111,levle3_57.jpg,fore,,,0,153,256,168,276,15,20
7112,levle3_57.jpg,fore,,,0,165,266,182,281,17,15
7113,levle3_57.jpg,fore,,,0,134,276,155,294,21,18
7114,levle3_57.jpg,fore,,,0,117,239,153,270,36,31
7115,levle3_57.jpg,fore,,,0,84,176,108,201,24,25
7116,levle3_57.jpg,fore,,,0,157,183,178,210,21,27
7117,levle3_57.jpg,fore,,,0,86,150,107,172,21,22
7118,levle3_57.jpg,fore,,,0,45,141,69,163,24,22
7119,levle3_57.jpg,fore,,,0,59,88,83,107,24,19
7120,levle3_57.jpg,fore,,,0,84,70,110,95,26,25
7121,levle3_57.jpg,fore,,,0,72,32,103,64,31,32
7122,levle3_57.jpg,fore,,,0,146,36,170,62,24,26
7123,levle3_57.jpg,fore,,,0,232,212,258,235,26,23
7124,levle3_57.jpg,fore,,,0,184,173,211,197,27,24
7125,levle3_57.jpg,fore,,,0,128,201,142,218,14,17
7126,levle3_57.jpg,fore,,,0,104,214,114,226,10,12
7127,levle3_57.jpg,fore,,,0,75,230,101,253,26,23
7128,levle3_57.jpg,fore,,,0,144,2,170,23,26,21
7129,levle3_57.jpg,fore,,,0,36,205,50,224,14,19
7130,levle3_57.jpg,fore,,,0,21,199,37,219,16,20
7131,levle3_57.jpg,fore,,,0,25,185,40,197,15,12
7132,levle3_57.jpg,fore,,,0,30,168,53,188,23,20
7133,levle3_57.jpg,fore,,,0,128,127,142,139,14,12
7134,levle3_57.jpg,fore,,,0,151,146,166,161,15,15
7135,levle3_57.jpg,fore,,,0,120,173,138,187,18,14
7136,levle3_57.jpg,fore,,,0,88,213,100,226,12,13
7137,levle3_57.jpg,fore,,,0,69,206,84,218,15,12
7138,levle3_57.jpg,fore,,,0,148,217,160,231,12,14
7139,levle3_57.jpg,fore,,,0,154,233,169,246,15,13
7140,levle3_57.jpg,fore,,,0,240,153,257,165,17,12
7141,levle3_57.jpg,fore,,,0,235,162,250,177,15,15
7142,levle3_57.jpg,fore,,,0,237,179,248,194,11,15
7143,levle3_57.jpg,fore,,,0,247,181,258,193,11,12
7144,levle3_57.jpg,fore,,,0,309,162,321,175,12,13
7145,levle3_57.jpg,fore,,,0,213,149,231,165,18,16
7146,levle3_57.jpg,fore,,,0,106,141,120,154,14,13
7147,levle3_57.jpg,fore,,,0,96,124,112,142,16,18
7148,levle3_57.jpg,fore,,,0,66,124,80,137,14,13
7149,levle3_57.jpg,fore,,,0,75,260,87,275,12,15
7150,levle3_57.jpg,fore,,,0,87,264,99,275,12,11
7151,levle3_57.jpg,fore,,,0,95,270,109,286,14,16
7152,levle3_57.jpg,fore,,,0,112,271,130,287,18,16
7153,levle3_57.jpg,fore,,,0,174,283,190,299,16,16
7154,levle3_57.jpg,fore,,,0,189,272,200,288,11,16
7155,levle3_57.jpg,fore,,,0,199,274,211,289,12,15
7156,levle3_57.jpg,fore,,,0,274,218,290,233,16,15
7157,levle3_57.jpg,fore,,,0,238,243,250,257,12,14
7158,levle3_57.jpg,fore,,,0,221,285,249,300,28,15
7159,levle3_57.jpg,fore,,,0,280,169,298,185,18,16
7160,levle3_57.jpg,fore,,,0,291,153,302,166,11,13
7161,levle3_57.jpg,fore,,,0,130,143,145,157,15,14
7162,levle3_57.jpg,fore,,,0,133,159,148,173,15,14
7163,levle3_57.jpg,fore,,,0,74,106,93,121,19,15
7164,levle1_316.jpg,fore,Unspecified,0.0,0,1612,2443,1834,2665,222,222
7165,levle1_316.jpg,fore,Unspecified,0.0,0,1965,2336,2133,2481,168,145
7166,levle1_316.jpg,fore,Unspecified,0.0,0,2164,2504,2363,2757,199,253
7167,levle1_316.jpg,fore,Unspecified,0.0,0,1811,2826,1980,2979,169,153
7168,levle1_316.jpg,fore,Unspecified,0.0,0,2171,2297,2355,2428,184,131
7169,levle1_316.jpg,fore,Unspecified,0.0,0,2217,2137,2424,2336,207,199
7170,levle1_316.jpg,fore,Unspecified,0.0,0,2263,1807,2440,2014,177,207
7171,levle1_316.jpg,fore,Unspecified,0.0,0,1428,2251,1627,2420,199,169
7172,levle0_105.jpg,fore,Unspecified,0.0,0,1244,2773,1382,3002,138,229
7173,levle1_470.jpg,fore,Unspecified,0.0,0,593,2612,738,2734,145,122
7174,levle1_470.jpg,fore,Unspecified,0.0,0,769,2504,899,2635,130,131
7175,levle1_470.jpg,fore,Unspecified,0.0,0,677,2888,777,3056,100,168
7176,levle1_470.jpg,fore,Unspecified,0.0,0,1206,3087,1359,3286,153,199
7177,levle1_470.jpg,fore,Unspecified,0.0,0,670,2236,800,2405,130,169
7178,levle1_470.jpg,fore,Unspecified,0.0,0,524,2029,624,2152,100,123
7179,levle1_464.jpg,fore,Unspecified,0.0,0,1819,2573,1965,2711,146,138
7180,levle1_464.jpg,fore,Unspecified,0.0,0,1957,2696,2064,2796,107,100
7181,levle1_464.jpg,fore,Unspecified,0.0,0,2003,2466,2095,2635,92,169
7182,levle1_464.jpg,fore,Unspecified,0.0,0,2064,2405,2256,2612,192,207
7183,levle1_464.jpg,fore,Unspecified,0.0,0,2064,2773,2194,2857,130,84
7184,levle1_464.jpg,fore,Unspecified,0.0,0,2087,2857,2256,3010,169,153
7185,levle1_464.jpg,fore,Unspecified,0.0,0,2263,2788,2386,2987,123,199
7186,levle1_464.jpg,fore,Unspecified,0.0,0,2148,3071,2340,3217,192,146
7187,levle1_464.jpg,fore,Unspecified,0.0,0,2662,2451,2861,2619,199,168
7188,levle1_464.jpg,fore,Unspecified,0.0,0,2616,1386,2769,1508,153,122
7189,levle1_464.jpg,fore,Unspecified,0.0,0,2700,1225,2853,1393,153,168
7190,levle1_464.jpg,fore,Unspecified,0.0,0,2432,2121,2578,2259,146,138
7191,levle1_464.jpg,fore,Unspecified,0.0,0,2447,2328,2562,2504,115,176
7192,levle1_302.jpg,fore,Unspecified,0.0,0,1037,949,1183,1094,146,145
7193,levle1_302.jpg,fore,Unspecified,0.0,0,294,2566,424,2719,130,153
7194,levle1_302.jpg,fore,Unspecified,0.0,0,1313,2918,1413,3094,100,176
7195,levle1_302.jpg,fore,Unspecified,0.0,0,1520,2765,1673,2895,153,130
7196,levle1_302.jpg,fore,Unspecified,0.0,0,1405,2589,1512,2742,107,153
7197,levle1_302.jpg,fore,Unspecified,0.0,0,1451,3133,1543,3255,92,122
7198,levle1_302.jpg,fore,Unspecified,0.0,0,1666,3232,1765,3324,99,92
7199,levle1_302.jpg,fore,Unspecified,0.0,0,1857,3194,1988,3401,131,207
7200,levle1_302.jpg,fore,Unspecified,0.0,0,1681,3041,1827,3217,146,176
7201,levle0_111.jpg,fore,Unspecified,0.0,0,2532,1746,2654,1907,122,161
7202,levle0_111.jpg,fore,Unspecified,0.0,0,2447,1937,2570,2137,123,200
7203,levle0_111.jpg,fore,Unspecified,0.0,0,2003,2520,2179,2673,176,153
7204,levle3_43.jpg,fore,,,0,408,206,443,238,35,32
7205,levle3_43.jpg,fore,,,0,412,164,449,194,37,30
7206,levle3_43.jpg,fore,,,0,375,154,407,193,32,39
7207,levle3_43.jpg,fore,,,0,219,83,250,119,31,36
7208,levle3_43.jpg,fore,,,0,207,139,242,182,35,43
7209,levle3_43.jpg,fore,,,0,170,190,198,221,28,31
7210,levle3_43.jpg,fore,,,0,146,216,179,249,33,33
7211,levle3_43.jpg,fore,,,0,252,208,300,240,48,32
7212,levle3_43.jpg,fore,,,0,215,234,239,266,24,32
7213,levle3_43.jpg,fore,,,0,262,258,298,301,36,43
7214,levle3_43.jpg,fore,,,0,368,256,399,288,31,32
7215,levle3_43.jpg,fore,,,0,290,306,326,338,36,32
7216,levle3_43.jpg,fore,,,0,217,305,247,334,30,29
7217,levle3_43.jpg,fore,,,0,246,325,282,362,36,37
7218,levle3_43.jpg,fore,,,0,187,333,222,369,35,36
7219,levle3_43.jpg,fore,,,0,95,309,126,339,31,30
7220,levle3_43.jpg,fore,,,0,117,378,165,409,48,31
7221,levle3_43.jpg,fore,,,0,376,443,432,490,56,47
7222,levle3_43.jpg,fore,,,0,154,68,191,99,37,31
7223,levle3_43.jpg,fore,,,0,165,113,194,140,29,27
7224,levle3_43.jpg,fore,,,0,282,51,307,75,25,24
7225,levle3_43.jpg,fore,,,0,318,148,351,188,33,40
7226,levle3_43.jpg,fore,,,0,248,153,279,181,31,28
7227,levle3_43.jpg,fore,,,0,206,189,239,218,33,29
7228,levle3_43.jpg,fore,,,0,163,296,197,319,34,23
7229,levle3_43.jpg,fore,,,0,155,318,178,362,23,44
7230,levle3_43.jpg,fore,,,0,346,297,383,329,37,32
7231,levle3_43.jpg,fore,,,0,308,257,343,289,35,32
7232,levle3_43.jpg,fore,,,0,368,342,403,399,35,57
7233,levle3_43.jpg,fore,,,0,396,317,435,363,39,46
7234,levle3_43.jpg,fore,,,0,294,349,338,391,44,42
7235,levle3_43.jpg,fore,,,0,256,362,282,386,26,24
7236,levle3_43.jpg,fore,,,0,240,371,284,417,44,46
7237,levle3_43.jpg,fore,,,0,264,407,306,450,42,43
7238,levle3_43.jpg,fore,,,0,210,381,238,413,28,32
7239,levle3_43.jpg,fore,,,0,175,427,210,459,35,32
7240,levle3_43.jpg,fore,,,0,263,472,315,514,52,42
7241,levle3_43.jpg,fore,,,0,136,170,162,192,26,22
7242,levle3_43.jpg,fore,,,0,129,151,162,173,33,22
7243,levle3_43.jpg,fore,,,0,395,106,420,129,25,23
7244,levle3_43.jpg,fore,,,0,373,123,408,154,35,31
7245,levle3_43.jpg,fore,,,0,141,280,162,312,21,32
7246,levle3_43.jpg,fore,,,0,297,78,325,97,28,19
7247,levle3_43.jpg,fore,,,0,394,1,434,27,40,26
7248,levle3_43.jpg,fore,,,0,363,211,385,241,22,30
7249,levle3_43.jpg,fore,,,0,323,196,357,230,34,34
7250,levle3_43.jpg,fore,,,0,426,266,450,295,24,29
7251,levle3_43.jpg,fore,,,0,274,172,298,195,24,23
7252,levle3_43.jpg,fore,,,0,246,193,271,217,25,24
7253,levle3_43.jpg,fore,,,0,233,124,262,148,29,24
7254,levle3_43.jpg,fore,,,0,247,72,270,93,23,21
7255,levle3_43.jpg,fore,,,0,130,198,158,227,28,29
7256,levle3_43.jpg,fore,,,0,218,433,241,454,23,21
7257,levle3_43.jpg,fore,,,0,238,444,267,473,29,29
7258,levle3_43.jpg,fore,,,0,117,433,139,460,22,27
7259,levle3_43.jpg,fore,,,0,311,409,336,434,25,25
7260,levle3_43.jpg,fore,,,0,418,397,444,425,26,28
7261,levle3_43.jpg,fore,,,0,317,433,357,467,40,34
7262,levle3_43.jpg,fore,,,0,336,89,371,121,35,32
7263,levle3_43.jpg,fore,,,0,358,433,407,461,49,28
7264,levle3_43.jpg,fore,,,0,212,464,256,515,44,51
7265,levle0_139.jpg,fore,Unspecified,0.0,0,1643,2826,1781,2926,138,100
7266,levle0_139.jpg,fore,Unspecified,0.0,0,1489,2872,1612,3002,123,130
7267,levle1_458.jpg,fore,Unspecified,0.0,0,1160,1286,1290,1439,130,153
7268,levle1_458.jpg,fore,Unspecified,0.0,0,1198,1133,1336,1263,138,130
7269,levle1_458.jpg,fore,Unspecified,0.0,0,1283,1041,1436,1133,153,92
7270,levle1_458.jpg,fore,Unspecified,0.0,0,1060,1432,1160,1592,100,160
7271,levle1_458.jpg,fore,Unspecified,0.0,0,2164,2520,2256,2658,92,138
7272,levle1_458.jpg,fore,Unspecified,0.0,0,2256,2435,2348,2596,92,161
7273,levle1_458.jpg,fore,Unspecified,0.0,0,2501,2359,2578,2504,77,145
7274,levle1_458.jpg,fore,Unspecified,0.0,0,2555,2198,2677,2351,122,153
7275,levle1_458.jpg,fore,Unspecified,0.0,0,2578,2343,2670,2435,92,92
7276,levle1_458.jpg,fore,Unspecified,0.0,0,2424,2566,2616,2711,192,145
7277,levle3_47.jpg,fore,,,0,455,185,507,225,52,40
7278,levle3_47.jpg,fore,,,0,325,66,346,99,21,33
7279,levle3_47.jpg,fore,,,0,238,193,278,234,40,41
7280,levle3_47.jpg,fore,,,0,223,118,258,164,35,46
7281,levle3_47.jpg,fore,,,0,177,112,210,152,33,40
7282,levle3_47.jpg,fore,,,0,153,152,201,194,48,42
7283,levle3_47.jpg,fore,,,0,402,254,440,305,38,51
7284,levle3_47.jpg,fore,,,0,362,278,402,313,40,35
7285,levle3_47.jpg,fore,,,0,349,321,393,361,44,40
7286,levle3_47.jpg,fore,,,0,271,325,308,367,37,42
7287,levle3_47.jpg,fore,,,0,329,217,380,269,51,52
7288,levle3_47.jpg,fore,,,0,295,445,346,490,51,45
7289,levle3_47.jpg,fore,,,0,331,397,374,425,43,28
7290,levle3_47.jpg,fore,,,0,189,582,201,624,12,42
7291,levle3_47.jpg,fore,,,0,350,454,384,494,34,40
7292,levle3_47.jpg,fore,,,0,226,261,250,288,24,27
7293,levle3_47.jpg,fore,,,0,289,163,343,212,54,49
7294,levle3_47.jpg,fore,,,0,290,205,325,248,35,43
7295,levle3_47.jpg,fore,,,0,196,169,232,215,36,46
7296,levle3_47.jpg,fore,,,0,122,105,165,148,43,43
7297,levle3_47.jpg,fore,,,0,87,146,144,182,57,36
7298,levle3_47.jpg,fore,,,0,89,181,149,234,60,53
7299,levle3_47.jpg,fore,,,0,77,284,128,334,51,50
7300,levle3_47.jpg,fore,,,0,170,254,214,281,44,27
7301,levle3_47.jpg,fore,,,0,170,294,202,336,32,42
7302,levle3_47.jpg,fore,,,0,268,258,302,297,34,39
7303,levle3_47.jpg,fore,,,0,202,330,252,375,50,45
7304,levle3_47.jpg,fore,,,0,214,361,250,399,36,38
7305,levle3_47.jpg,fore,,,0,202,408,241,442,39,34
7306,levle3_47.jpg,fore,,,0,255,385,278,430,23,45
7307,levle3_47.jpg,fore,,,0,284,364,323,419,39,55
7308,levle3_47.jpg,fore,,,0,401,360,434,390,33,30
7309,levle3_47.jpg,fore,,,0,361,388,395,431,34,43
7310,levle3_47.jpg,fore,,,0,122,363,152,416,30,53
7311,levle3_47.jpg,fore,,,0,168,408,198,437,30,29
7312,levle3_47.jpg,fore,,,0,192,443,228,484,36,41
7313,levle3_47.jpg,fore,,,0,262,452,298,490,36,38
7314,levle3_47.jpg,fore,,,0,241,496,287,525,46,29
7315,levle3_47.jpg,fore,,,0,158,519,184,555,26,36
7316,levle3_47.jpg,fore,,,0,196,531,232,564,36,33
7317,levle3_47.jpg,fore,,,0,258,576,307,599,49,23
7318,levle3_47.jpg,fore,,,0,249,606,296,648,47,42
7319,levle3_47.jpg,fore,,,0,307,540,370,581,63,41
7320,levle3_47.jpg,fore,,,0,340,584,373,621,33,37
7321,levle3_47.jpg,fore,,,0,380,597,413,643,33,46
7322,levle3_47.jpg,fore,,,0,361,125,395,163,34,38
7323,levle3_47.jpg,fore,,,0,82,21,125,67,43,46
7324,levle3_47.jpg,fore,,,0,299,115,337,158,38,43
7325,levle3_47.jpg,fore,,,0,421,226,463,266,42,40
7326,levle3_47.jpg,fore,,,0,80,106,121,139,41,33
7327,levle3_47.jpg,fore,,,0,182,87,219,118,37,31
7328,levle3_47.jpg,fore,,,0,331,510,377,536,46,26
7329,levle3_47.jpg,fore,,,0,119,407,164,463,45,56
7330,levle3_47.jpg,fore,,,0,36,155,71,183,35,28
7331,levle3_47.jpg,fore,,,0,472,307,501,338,29,31
7332,levle3_47.jpg,fore,,,0,550,164,578,187,28,23
7333,levle3_47.jpg,fore,,,0,548,195,572,242,24,47
7334,levle3_47.jpg,fore,,,0,521,235,549,265,28,30
7335,levle3_47.jpg,fore,,,0,525,177,551,203,26,26
7336,levle3_47.jpg,fore,,,0,394,136,421,165,27,29
7337,levle3_47.jpg,fore,,,0,348,167,388,201,40,34
7338,levle3_47.jpg,fore,,,0,364,76,401,115,37,39
7339,levle1_306.jpg,fore,Unspecified,0.0,0,1535,2412,1635,2550,100,138
7340,levle1_306.jpg,fore,Unspecified,0.0,0,1466,2650,1574,2811,108,161
7341,levle1_306.jpg,fore,Unspecified,0.0,0,1260,2865,1359,3002,99,137
7342,levle1_306.jpg,fore,Unspecified,0.0,0,1528,2911,1658,3010,130,99
7343,levle1_306.jpg,fore,Unspecified,0.0,0,1788,3010,1896,3202,108,192
7344,levle1_306.jpg,fore,Unspecified,0.0,0,1528,3002,1666,3163,138,161
7345,levle1_306.jpg,fore,Unspecified,0.0,0,2049,826,2179,972,130,146
7346,levle0_115.jpg,fore,Unspecified,0.0,0,961,2091,1083,2267,122,176
7347,levle1_460.jpg,fore,Unspecified,0.0,0,2516,2412,2685,2566,169,154
7348,levle1_460.jpg,fore,Unspecified,0.0,0,2478,2244,2631,2351,153,107
7349,levle1_460.jpg,fore,Unspecified,0.0,0,2279,3033,2463,3171,184,138
7350,levle1_460.jpg,fore,Unspecified,0.0,0,1995,3048,2164,3209,169,161
7351,levle1_460.jpg,fore,Unspecified,0.0,0,1850,3133,2003,3286,153,153
7352,levle1_460.jpg,fore,Unspecified,0.0,0,1758,3002,1919,3087,161,85
7353,levle1_460.jpg,fore,Unspecified,0.0,0,1704,3209,1857,3355,153,146
7354,levle1_460.jpg,fore,Unspecified,0.0,0,1505,3056,1627,3202,122,146
7355,levle1_460.jpg,fore,Unspecified,0.0,0,1329,2987,1443,3125,114,138
7356,levle1_474.jpg,fore,Unspecified,0.0,0,1466,757,1528,910,62,153
7357,levle1_474.jpg,fore,Unspecified,0.0,0,1681,1370,1804,1470,123,100
7358,levle1_474.jpg,fore,Unspecified,0.0,0,1221,2382,1321,2504,100,122
7359,levle1_474.jpg,fore,Unspecified,0.0,0,1329,2489,1451,2550,122,61
7360,levle1_474.jpg,fore,Unspecified,0.0,0,1252,2566,1375,2650,123,84
7361,levle1_474.jpg,fore,Unspecified,0.0,0,1099,2466,1229,2596,130,130
7362,levle1_474.jpg,fore,Unspecified,0.0,0,807,2451,938,2573,131,122
7363,levle1_474.jpg,fore,Unspecified,0.0,0,823,2573,961,2665,138,92
7364,levle1_474.jpg,fore,Unspecified,0.0,0,999,2696,1145,2780,146,84
7365,levle1_474.jpg,fore,Unspecified,0.0,0,1145,2842,1229,2949,84,107
7366,levle1_474.jpg,fore,Unspecified,0.0,0,938,2803,1076,2949,138,146
7367,levle1_474.jpg,fore,Unspecified,0.0,0,1765,3033,1880,3140,115,107
7368,levle1_474.jpg,fore,Unspecified,0.0,0,1804,3156,1919,3240,115,84
7369,levle1_474.jpg,fore,Unspecified,0.0,0,1129,3156,1267,3286,138,130
7370,levle1_312.jpg,fore,Unspecified,0.0,0,263,1937,340,2160,77,223
7371,levle1_312.jpg,fore,Unspecified,0.0,0,478,1999,631,2221,153,222
7372,levle1_312.jpg,fore,Unspecified,0.0,0,1037,2114,1206,2267,169,153
7373,levle1_312.jpg,fore,Unspecified,0.0,0,394,2083,478,2259,84,176
7374,levle1_312.jpg,fore,Unspecified,0.0,0,532,2320,624,2458,92,138
7375,levle1_312.jpg,fore,Unspecified,0.0,0,493,2481,639,2612,146,131
7376,levle1_312.jpg,fore,Unspecified,0.0,0,516,2673,662,2803,146,130
7377,levle1_312.jpg,fore,Unspecified,0.0,0,677,2543,792,2704,115,161
7378,levle1_312.jpg,fore,Unspecified,0.0,0,509,2811,593,2941,84,130
7379,levle1_312.jpg,fore,Unspecified,0.0,0,769,2780,884,2972,115,192
7380,levle1_312.jpg,fore,Unspecified,0.0,0,1037,2788,1129,2949,92,161
7381,levle1_312.jpg,fore,Unspecified,0.0,0,1221,3163,1352,3324,131,161
7382,levle1_312.jpg,fore,Unspecified,0.0,0,861,2995,953,3125,92,130
7383,levle1_312.jpg,fore,Unspecified,0.0,0,1528,3087,1620,3217,92,130
7384,levle0_101.jpg,fore,Unspecified,0.0,0,1175,1002,1413,1186,238,184
7385,levle3_53.jpg,fore,,,0,305,412,350,453,45,41
7386,levle3_53.jpg,fore,,,0,216,361,251,404,35,43
7387,levle3_53.jpg,fore,,,0,392,277,447,302,55,25
7388,levle3_53.jpg,fore,,,0,511,487,551,529,40,42
7389,levle3_53.jpg,fore,,,0,439,487,499,534,60,47
7390,levle3_53.jpg,fore,,,0,286,455,332,491,46,36
7391,levle3_53.jpg,fore,,,0,294,488,354,546,60,58
7392,levle3_53.jpg,fore,,,0,298,372,341,412,43,40
7393,levle3_53.jpg,fore,,,0,262,331,306,372,44,41
7394,levle3_53.jpg,fore,,,0,242,302,289,346,47,44
7395,levle3_53.jpg,fore,,,0,291,263,344,337,53,74
7396,levle3_53.jpg,fore,,,0,168,289,233,350,65,61
7397,levle3_53.jpg,fore,,,0,222,202,263,246,41,44
7398,levle3_53.jpg,fore,,,0,302,223,347,260,45,37
7399,levle3_53.jpg,fore,,,0,355,234,392,280,37,46
7400,levle3_53.jpg,fore,,,0,428,225,467,276,39,51
7401,levle3_53.jpg,fore,,,0,404,173,482,216,78,43
7402,levle3_53.jpg,fore,,,0,305,176,363,230,58,54
7403,levle3_53.jpg,fore,,,0,276,145,317,182,41,37
7404,levle3_53.jpg,fore,,,0,435,124,470,150,35,26
7405,levle3_53.jpg,fore,,,0,415,95,477,141,62,46
7406,levle3_53.jpg,fore,,,0,153,17,217,61,64,44
7407,levle3_53.jpg,fore,,,0,162,89,213,135,51,46
7408,levle3_53.jpg,fore,,,0,399,317,455,363,56,46
7409,levle3_53.jpg,fore,,,0,487,142,516,165,29,23
7410,levle3_53.jpg,fore,,,0,469,143,494,165,25,22
7411,levle3_53.jpg,fore,,,0,539,96,569,121,30,25
7412,levle3_53.jpg,fore,,,0,459,416,489,437,30,21
7413,levle3_53.jpg,fore,,,0,462,567,495,597,33,30
7414,levle3_53.jpg,fore,,,0,371,498,410,520,39,22
7415,levle3_53.jpg,fore,,,0,343,327,373,349,30,22
7416,levle3_53.jpg,fore,,,0,312,343,345,374,33,31
7417,levle3_53.jpg,fore,,,0,347,355,387,391,40,36
7418,levle3_53.jpg,fore,,,0,387,365,429,403,42,38
7419,levle3_53.jpg,fore,,,0,337,290,371,316,34,26
7420,levle3_53.jpg,fore,,,0,481,270,513,297,32,27
7421,levle3_53.jpg,fore,,,0,496,184,530,218,34,34
7422,levle3_53.jpg,fore,,,0,325,51,362,77,37,26
7423,levle3_53.jpg,fore,,,0,211,34,239,63,28,29
7424,levle3_53.jpg,fore,,,0,210,10,253,30,43,20
7425,levle3_53.jpg,fore,,,0,264,102,309,125,45,23
7426,levle3_53.jpg,fore,,,0,212,122,244,146,32,24
7427,levle3_53.jpg,fore,,,0,274,189,296,243,22,54
7428,levle3_53.jpg,fore,,,0,206,253,249,289,43,36
7429,levle3_53.jpg,fore,,,0,257,255,291,278,34,23
7430,levle3_53.jpg,fore,,,0,185,349,218,381,33,32
7431,levle3_53.jpg,fore,,,0,400,529,425,550,25,21
7432,levle3_53.jpg,fore,,,0,497,448,532,474,35,26
7433,levle3_53.jpg,fore,,,0,527,465,566,498,39,33
7434,levle3_53.jpg,fore,,,0,462,14,494,43,32,29
7435,levle3_53.jpg,fore,,,0,309,108,335,140,26,32
7436,levle3_53.jpg,fore,,,0,371,197,398,223,27,26
7437,levle3_53.jpg,fore,,,0,398,149,427,180,29,31
7438,levle3_53.jpg,fore,,,0,389,237,423,268,34,31
7439,levle3_53.jpg,fore,,,0,340,120,367,154,27,34
7440,levle3_53.jpg,fore,,,0,374,319,405,345,31,26
7441,levle3_53.jpg,fore,,,0,364,442,397,472,33,30
7442,levle3_53.jpg,fore,,,0,368,401,398,442,30,41
7443,levle3_53.jpg,fore,,,0,596,146,632,170,36,24
7444,levle0_129.jpg,fore,Unspecified,0.0,0,2317,2014,2440,2144,123,130
7445,levle1_448.jpg,fore,Unspecified,0.0,0,968,1071,1129,1263,161,192
7446,levle1_448.jpg,fore,Unspecified,0.0,0,1152,1148,1252,1286,100,138
7447,levle1_448.jpg,fore,Unspecified,0.0,0,1367,1255,1535,1478,168,223
7448,levle1_448.jpg,fore,Unspecified,0.0,0,1788,328,1903,489,115,161
7449,levle1_448.jpg,fore,Unspecified,0.0,0,2562,857,2769,1025,207,168
7450,levle1_448.jpg,fore,Unspecified,0.0,0,2624,658,2762,796,138,138
7451,levle1_448.jpg,fore,Unspecified,0.0,0,1804,2489,1926,2612,122,123
7452,levle1_448.jpg,fore,Unspecified,0.0,0,1198,1968,1298,2175,100,207
7453,levle1_448.jpg,fore,Unspecified,0.0,0,1152,2213,1359,2351,207,138
7454,levle1_448.jpg,fore,Unspecified,0.0,0,1091,2029,1191,2206,100,177
7455,levle1_448.jpg,fore,Unspecified,0.0,0,976,2083,1099,2259,123,176
7456,levle1_448.jpg,fore,Unspecified,0.0,0,2309,3087,2440,3255,131,168
7457,levle1_448.jpg,fore,Unspecified,0.0,0,1995,3048,2095,3232,100,184
7458,levle3_84.jpg,fore,,,0,80,10,98,22,18,12
7459,levle3_84.jpg,fore,,,0,83,30,102,45,19,15
7460,levle3_84.jpg,fore,,,0,84,45,101,58,17,13
7461,levle3_84.jpg,fore,,,0,115,20,131,35,16,15
7462,levle3_84.jpg,fore,,,0,117,40,129,50,12,10
7463,levle3_84.jpg,fore,,,0,137,33,152,48,15,15
7464,levle3_84.jpg,fore,,,0,162,51,180,63,18,12
7465,levle3_84.jpg,fore,,,0,139,62,151,72,12,10
7466,levle3_84.jpg,fore,,,0,149,62,158,76,9,14
7467,levle3_84.jpg,fore,,,0,131,72,147,85,16,13
7468,levle3_84.jpg,fore,,,0,126,86,144,102,18,16
7469,levle3_84.jpg,fore,,,0,121,96,134,109,13,13
7470,levle3_84.jpg,fore,,,0,115,101,127,116,12,15
7471,levle3_84.jpg,fore,,,0,65,96,80,108,15,12
7472,levle3_84.jpg,fore,,,0,94,131,106,149,12,18
7473,levle3_84.jpg,fore,,,0,110,120,126,135,16,15
7474,levle3_84.jpg,fore,,,0,168,142,185,158,17,16
7475,levle3_84.jpg,fore,,,0,176,157,192,172,16,15
7476,levle3_84.jpg,fore,,,0,190,181,201,198,11,17
7477,levle3_84.jpg,fore,,,0,123,175,134,190,11,15
7478,levle3_84.jpg,fore,,,0,204,106,222,125,18,19
7479,levle3_84.jpg,fore,,,0,222,48,234,62,12,14
7480,levle3_84.jpg,fore,,,0,186,98,203,112,17,14
7481,levle3_84.jpg,fore,,,0,165,92,181,104,16,12
7482,levle3_84.jpg,fore,,,0,161,69,178,87,17,18
7483,levle3_84.jpg,fore,,,0,154,96,164,105,10,9
7484,levle3_84.jpg,fore,,,0,145,105,156,118,11,13
7485,levle3_84.jpg,fore,,,0,139,106,144,118,5,12
7486,levle3_84.jpg,fore,,,0,133,123,147,136,14,13
7487,levle3_84.jpg,fore,,,0,125,150,137,161,12,11
7488,levle3_84.jpg,fore,,,0,148,148,164,166,16,18
7489,levle3_84.jpg,fore,,,0,153,129,168,144,15,15
7490,levle3_84.jpg,fore,,,0,171,122,178,132,7,10
7491,levle3_84.jpg,fore,,,0,180,115,192,126,12,11
7492,levle3_84.jpg,fore,,,0,91,104,101,119,10,15
7493,levle3_84.jpg,fore,,,0,100,88,115,101,15,13
7494,levle3_84.jpg,fore,,,0,100,74,117,89,17,15
7495,levle3_84.jpg,fore,,,0,102,55,118,70,16,15
7496,levle3_84.jpg,fore,,,0,154,176,166,196,12,20
7497,levle3_84.jpg,fore,,,0,188,128,197,138,9,10
7498,levle3_84.jpg,fore,,,0,180,184,192,198,12,14
7499,levle3_84.jpg,fore,,,0,205,84,219,94,14,10
7500,levle3_84.jpg,fore,,,0,169,18,180,26,11,8
7501,levle3_84.jpg,fore,,,0,151,24,161,31,10,7
7502,levle3_84.jpg,fore,,,0,154,30,164,38,10,8
7503,levle3_84.jpg,fore,,,0,151,38,161,46,10,8
7504,levle3_84.jpg,fore,,,0,174,30,187,39,13,9
7505,levle3_84.jpg,fore,,,0,178,37,189,46,11,9
7506,levle3_84.jpg,fore,,,0,135,14,144,22,9,8
7507,levle3_84.jpg,fore,,,0,140,25,148,32,8,7
7508,levle3_84.jpg,fore,,,0,230,195,241,204,11,9
7509,levle3_84.jpg,fore,,,0,216,168,228,182,12,14
7510,levle3_84.jpg,fore,,,0,200,178,217,189,17,11
7511,levle3_84.jpg,fore,,,0,102,149,114,161,12,12
7512,levle3_84.jpg,fore,,,0,96,156,104,165,8,9
7513,levle3_84.jpg,fore,,,0,130,138,140,145,10,7
7514,levle3_84.jpg,fore,,,0,156,116,170,128,14,12
7515,levle3_84.jpg,fore,,,0,185,66,194,74,9,8
7516,levle3_84.jpg,fore,,,0,180,74,190,87,10,13
7517,levle3_84.jpg,fore,,,0,159,2,170,10,11,8
7518,levle3_84.jpg,fore,,,0,223,36,232,46,9,10
7519,levle3_84.jpg,fore,,,0,234,172,245,182,11,10
7520,levle3_84.jpg,fore,,,0,239,182,252,193,13,11
7521,levle2_3.jpg,fore,Unspecified,0.0,0,446,173,475,206,29,33
7522,levle2_3.jpg,fore,Unspecified,0.0,0,368,341,399,390,31,49
7523,levle2_3.jpg,fore,Unspecified,0.0,0,285,426,350,490,65,64
7524,levle2_3.jpg,fore,Unspecified,0.0,0,287,526,326,577,39,51
7525,levle2_3.jpg,fore,Unspecified,0.0,0,317,502,362,541,45,39
7526,levle2_3.jpg,fore,Unspecified,0.0,0,395,636,442,708,47,72
7527,levle2_3.jpg,fore,Unspecified,0.0,0,220,526,260,575,40,49
7528,levle2_3.jpg,fore,Unspecified,0.0,0,220,573,266,624,46,51
7529,levle2_3.jpg,fore,Unspecified,0.0,0,156,559,201,612,45,53
7530,levle2_3.jpg,fore,Unspecified,0.0,0,50,622,116,667,66,45
7531,levle2_3.jpg,fore,Unspecified,0.0,0,116,481,154,526,38,45
7532,levle2_3.jpg,fore,Unspecified,0.0,0,173,504,224,571,51,67
7533,levle2_3.jpg,fore,Unspecified,0.0,0,50,439,91,485,41,46
7534,levle2_3.jpg,fore,Unspecified,0.0,0,62,339,105,390,43,51
7535,levle2_3.jpg,fore,Unspecified,0.0,0,107,347,152,406,45,59
7536,levle2_3.jpg,fore,Unspecified,0.0,0,142,357,191,392,49,35
7537,levle2_3.jpg,fore,Unspecified,0.0,0,246,302,293,343,47,41
7538,levle2_3.jpg,fore,Unspecified,0.0,0,169,275,217,326,48,51
7539,levle2_3.jpg,fore,Unspecified,0.0,0,83,151,142,196,59,45
7540,levle2_3.jpg,fore,Unspecified,0.0,0,79,106,134,157,55,51
7541,levle2_3.jpg,fore,Unspecified,0.0,0,28,165,73,210,45,45
7542,levle2_3.jpg,fore,Unspecified,0.0,0,173,386,211,426,38,40
7543,levle2_3.jpg,fore,Unspecified,0.0,0,187,439,232,490,45,51
7544,levle2_3.jpg,fore,Unspecified,0.0,0,275,359,324,408,49,49
7545,levle2_3.jpg,fore,Unspecified,0.0,0,271,192,299,243,28,51
7546,levle2_3.jpg,fore,Unspecified,0.0,0,395,279,446,337,51,58
7547,levle2_3.jpg,fore,Unspecified,0.0,0,224,390,268,428,44,38
7548,levle2_3.jpg,fore,Unspecified,0.0,0,222,430,277,477,55,47
7549,levle2_3.jpg,fore,Unspecified,0.0,0,356,402,405,461,49,59
7550,levle2_3.jpg,fore,Unspecified,0.0,0,638,445,679,494,41,49
7551,levle3_90.jpg,fore,Unspecified,0.0,0,1926,589,2049,711,123,122
7552,levle3_90.jpg,fore,Unspecified,0.0,0,1681,343,1796,443,115,100
7553,levle3_90.jpg,fore,Unspecified,0.0,0,1214,489,1329,581,115,92
7554,levle3_90.jpg,fore,Unspecified,0.0,0,2294,949,2432,1094,138,145
7555,levle3_90.jpg,fore,Unspecified,0.0,0,2148,2428,2294,2520,146,92
7556,levle3_90.jpg,fore,Unspecified,0.0,0,1942,2612,2057,2750,115,138
7557,levle3_90.jpg,fore,Unspecified,0.0,0,1742,2604,1873,2704,131,100
7558,levle3_90.jpg,fore,Unspecified,0.0,0,1620,3125,1750,3240,130,115
7559,levle3_90.jpg,fore,Unspecified,0.0,0,1459,3194,1604,3324,145,130
7560,levle3_90.jpg,fore,Unspecified,0.0,0,1252,3117,1436,3317,184,200
7561,levle3_90.jpg,fore,Unspecified,0.0,0,1727,3301,1827,3386,100,85
7562,levle3_90.jpg,fore,Unspecified,0.0,0,1926,2742,2064,2918,138,176
7563,levle3_90.jpg,fore,Unspecified,0.0,0,2079,2880,2194,2987,115,107
7564,levle3_90.jpg,fore,Unspecified,0.0,0,1030,3064,1152,3171,122,107
7565,levle3_90.jpg,fore,Unspecified,0.0,0,2041,2489,2156,2635,115,146
7566,levle3_90.jpg,fore,Unspecified,0.0,0,2057,2734,2187,2803,130,69
7567,levle3_90.jpg,fore,Unspecified,0.0,0,2516,2412,2624,2550,108,138
7568,levle3_90.jpg,fore,Unspecified,0.0,0,2133,2972,2309,3048,176,76
7569,levle3_90.jpg,fore,Unspecified,0.0,0,2087,3041,2141,3194,54,153
7570,levle3_90.jpg,fore,Unspecified,0.0,0,1965,2911,2041,3010,76,99
7571,levle3_90.jpg,fore,Unspecified,0.0,0,1926,3048,2064,3179,138,131
7572,levle3_90.jpg,fore,Unspecified,0.0,0,1589,3018,1666,3087,77,69
7573,levle3_90.jpg,fore,Unspecified,0.0,0,1666,2987,1842,3163,176,176
7574,levle3_90.jpg,fore,Unspecified,0.0,0,1750,3148,1811,3240,61,92
7575,levle3_90.jpg,fore,Unspecified,0.0,0,1865,3209,1949,3317,84,108
7576,levle3_90.jpg,fore,Unspecified,0.0,0,1283,2527,1428,2627,145,100
7577,levle3_90.jpg,fore,Unspecified,0.0,0,777,2581,884,2696,107,115
7578,levle3_90.jpg,fore,Unspecified,0.0,0,830,2688,930,2803,100,115
7579,levle3_90.jpg,fore,Unspecified,0.0,0,1627,1041,1750,1133,123,92
7580,levle3_90.jpg,fore,Unspecified,0.0,0,1850,1010,1972,1148,122,138
7581,levle3_90.jpg,fore,Unspecified,0.0,0,1965,1071,2095,1271,130,200
7582,levle3_90.jpg,fore,Unspecified,0.0,0,2072,1248,2233,1424,161,176
7583,levle3_90.jpg,fore,Unspecified,0.0,0,2118,1125,2294,1255,176,130
7584,levle3_90.jpg,fore,Unspecified,0.0,0,2079,903,2210,1079,131,176
7585,levle3_90.jpg,fore,Unspecified,0.0,0,2049,773,2141,880,92,107
7586,levle3_90.jpg,fore,Unspecified,0.0,0,2156,673,2302,849,146,176
7587,levle3_90.jpg,fore,Unspecified,0.0,0,2141,872,2348,1010,207,138
7588,levle3_90.jpg,fore,Unspecified,0.0,0,1926,696,2110,895,184,199
7589,levle0_471.jpg,fore,Unspecified,0.0,0,332,2512,440,2619,108,107
7590,levle0_471.jpg,fore,Unspecified,0.0,0,677,2596,777,2696,100,100
7591,levle0_317.jpg,fore,Unspecified,0.0,0,692,2934,945,3071,253,137
7592,levle0_317.jpg,fore,Unspecified,0.0,0,1214,3102,1382,3278,168,176
7593,levle1_104.jpg,fore,Unspecified,0.0,0,3290,2341,3439,2524,149,183
7594,levle1_104.jpg,fore,Unspecified,0.0,0,2957,1959,3157,2083,200,124
7595,levle1_104.jpg,fore,Unspecified,0.0,0,2974,2092,3165,2150,191,58
7596,levle1_104.jpg,fore,Unspecified,0.0,0,2982,2175,3099,2291,117,116
7597,levle1_104.jpg,fore,Unspecified,0.0,0,2841,2732,2974,2865,133,133
7598,levle1_104.jpg,fore,Unspecified,0.0,0,3232,1909,3381,2083,149,174
7599,levle1_104.jpg,fore,Unspecified,0.0,0,2899,2299,3007,2441,108,142
7600,levle1_104.jpg,fore,Unspecified,0.0,0,3032,2349,3165,2491,133,142
7601,levle1_104.jpg,fore,Unspecified,0.0,0,3655,2715,3747,2806,92,91
7602,levle1_104.jpg,fore,Unspecified,0.0,0,3389,2748,3531,2873,142,125
7603,levle1_104.jpg,fore,Unspecified,0.0,0,3589,2516,3714,2649,125,133
7604,levle0_303.jpg,fore,Unspecified,0.0,0,2233,1707,2394,1891,161,184
7605,levle1_110.jpg,fore,Unspecified,0.0,0,1844,1676,1943,1743,99,67
7606,levle1_110.jpg,fore,Unspecified,0.0,0,1927,1768,2035,1901,108,133
7607,levle1_110.jpg,fore,Unspecified,0.0,0,2043,1792,2184,1909,141,117
7608,levle1_110.jpg,fore,Unspecified,0.0,0,2001,1909,2151,2042,150,133
7609,levle1_110.jpg,fore,Unspecified,0.0,0,2251,1892,2392,2042,141,150
7610,levle1_110.jpg,fore,Unspecified,0.0,0,2384,2391,2508,2499,124,108
7611,levle1_110.jpg,fore,Unspecified,0.0,0,2218,2557,2342,2649,124,92
7612,levle1_110.jpg,fore,Unspecified,0.0,0,2467,2740,2600,2865,133,125
7613,levle1_110.jpg,fore,Unspecified,0.0,0,2666,2865,2791,2998,125,133
7614,levle0_465.jpg,fore,Unspecified,0.0,0,984,941,1175,1194,191,253
7615,levle0_465.jpg,fore,Unspecified,0.0,0,892,1386,1045,1547,153,161
7616,levle0_16.jpg,fore,Unspecified,0.0,0,1329,2627,1489,2788,160,161
7617,levle1_138.jpg,fore,Unspecified,0.0,0,1336,3002,1420,3094,84,92
7618,levle1_138.jpg,fore,Unspecified,0.0,0,1512,3064,1612,3171,100,107
7619,levle1_138.jpg,fore,Unspecified,0.0,0,1773,3018,1865,3094,92,76
7620,levle1_138.jpg,fore,Unspecified,0.0,0,2539,2389,2631,2520,92,131
7621,levle1_138.jpg,fore,Unspecified,0.0,0,1727,3209,1834,3317,107,108
7622,levle1_138.jpg,fore,Unspecified,0.0,0,1850,3186,1942,3294,92,108
7623,levle1_138.jpg,fore,Unspecified,0.0,0,2011,3102,2079,3186,68,84
7624,levle1_138.jpg,fore,Unspecified,0.0,0,2317,3048,2401,3148,84,100
7625,levle0_459.jpg,fore,Unspecified,0.0,0,2493,987,2654,1248,161,261
7626,levle0_459.jpg,fore,Unspecified,0.0,0,2194,1324,2309,1493,115,169
7627,levle0_459.jpg,fore,Unspecified,0.0,0,2501,1363,2647,1524,146,161
7628,levle0_1.jpg,fore,Unspecified,0.0,0,394,933,493,1064,99,131
7629,levle0_1.jpg,fore,Unspecified,0.0,0,654,2160,754,2274,100,114
7630,levle0_1.jpg,fore,Unspecified,0.0,0,930,3079,1099,3179,169,100
7631,levle0_505.jpg,fore,Unspecified,0.0,0,2662,1033,2838,1140,176,107
7632,levle0_263.jpg,fore,Unspecified,0.0,0,1850,2029,1972,2206,122,177
7633,levle0_277.jpg,fore,Unspecified,0.0,0,1658,2198,1796,2343,138,145
7634,levle0_277.jpg,fore,Unspecified,0.0,0,1191,2213,1344,2351,153,138
7635,levle0_277.jpg,fore,Unspecified,0.0,0,961,2320,1083,2520,122,200
7636,levle0_511.jpg,fore,Unspecified,0.0,0,1206,2160,1390,2351,184,191
7637,levle2_13.jpg,fore,Unspecified,0.0,0,73,250,96,269,23,19
7638,levle2_13.jpg,fore,Unspecified,0.0,0,69,270,97,298,28,28
7639,levle2_13.jpg,fore,Unspecified,0.0,0,83,301,114,328,31,27
7640,levle2_13.jpg,fore,Unspecified,0.0,0,100,331,124,362,24,31
7641,levle2_13.jpg,fore,Unspecified,0.0,0,159,369,183,398,24,29
7642,levle2_13.jpg,fore,Unspecified,0.0,0,136,396,147,411,11,15
7643,levle2_13.jpg,fore,Unspecified,0.0,0,113,377,136,401,23,24
7644,levle2_13.jpg,fore,Unspecified,0.0,0,192,390,217,420,25,30
7645,levle2_13.jpg,fore,Unspecified,0.0,0,217,370,244,392,27,22
7646,levle2_13.jpg,fore,Unspecified,0.0,0,213,317,239,352,26,35
7647,levle2_13.jpg,fore,Unspecified,0.0,0,237,334,264,356,27,22
7648,levle2_13.jpg,fore,Unspecified,0.0,0,321,384,355,410,34,26
7649,levle2_13.jpg,fore,Unspecified,0.0,0,243,391,272,423,29,32
7650,levle2_13.jpg,fore,Unspecified,0.0,0,237,289,274,320,37,31
7651,levle2_13.jpg,fore,Unspecified,0.0,0,255,256,279,281,24,25
7652,levle2_13.jpg,fore,Unspecified,0.0,0,260,226,285,248,25,22
7653,levle2_13.jpg,fore,Unspecified,0.0,0,221,224,252,253,31,29
7654,levle2_13.jpg,fore,Unspecified,0.0,0,197,223,224,248,27,25
7655,levle2_13.jpg,fore,Unspecified,0.0,0,157,285,189,310,32,25
7656,levle2_13.jpg,fore,Unspecified,0.0,0,221,259,242,284,21,25
7657,levle2_13.jpg,fore,Unspecified,0.0,0,173,350,202,379,29,29
7658,levle2_13.jpg,fore,Unspecified,0.0,0,355,256,380,283,25,27
7659,levle2_13.jpg,fore,Unspecified,0.0,0,207,181,238,205,31,24
7660,levle2_13.jpg,fore,Unspecified,0.0,0,92,101,116,122,24,21
7661,levle2_13.jpg,fore,Unspecified,0.0,0,67,123,95,153,28,30
7662,levle2_13.jpg,fore,Unspecified,0.0,0,96,202,145,240,49,38
7663,levle2_170.jpg,fore,,,0,1106,780,1275,933,169,153
7664,levle2_170.jpg,fore,,,0,1865,803,2125,987,260,184
7665,levle2_170.jpg,fore,,,0,2003,1056,2194,1225,191,169
7666,levle2_170.jpg,fore,,,0,2263,1133,2394,1248,131,115
7667,levle2_170.jpg,fore,,,0,2317,1815,2447,2006,130,191
7668,levle2_170.jpg,fore,,,0,2148,2098,2325,2213,177,115
7669,levle2_170.jpg,fore,,,0,2041,2160,2233,2313,192,153
7670,levle2_170.jpg,fore,,,0,2171,2359,2386,2543,215,184
7671,levle2_170.jpg,fore,,,0,2057,2451,2210,2589,153,138
7672,levle2_170.jpg,fore,,,0,2079,2596,2233,2734,154,138
7673,levle2_170.jpg,fore,,,0,1865,2236,2049,2374,184,138
7674,levle2_170.jpg,fore,,,0,1712,2183,1911,2366,199,183
7675,levle2_170.jpg,fore,,,0,1673,2351,1834,2458,161,107
7676,levle2_170.jpg,fore,,,0,1788,2474,1919,2619,131,145
7677,levle2_170.jpg,fore,,,0,1834,2619,1995,2750,161,131
7678,levle2_170.jpg,fore,,,0,1804,2903,1942,3033,138,130
7679,levle2_170.jpg,fore,,,0,2087,2949,2240,3110,153,161
7680,levle2_170.jpg,fore,,,0,2455,2681,2631,2857,176,176
7681,levle2_170.jpg,fore,,,0,1627,2428,1842,2604,215,176
7682,levle2_170.jpg,fore,,,0,1512,2388,1636,2501,124,113
7683,levle2_170.jpg,fore,,,0,1440,2798,1616,2929,176,131
7684,levle2_164.jpg,fore,Unspecified,0.0,0,1543,627,1673,773,130,146
7685,levle2_164.jpg,fore,Unspecified,0.0,0,1957,474,2110,619,153,145
7686,levle2_164.jpg,fore,Unspecified,0.0,0,2363,1148,2516,1317,153,169
7687,levle2_164.jpg,fore,Unspecified,0.0,0,2394,1324,2532,1501,138,177
7688,levle2_164.jpg,fore,Unspecified,0.0,0,2639,1409,2800,1508,161,99
7689,levle2_164.jpg,fore,Unspecified,0.0,0,861,1937,1037,2106,176,169
7690,levle2_164.jpg,fore,Unspecified,0.0,0,2187,2045,2378,2221,191,176
7691,levle2_164.jpg,fore,Unspecified,0.0,0,2286,2351,2455,2420,169,69
7692,levle2_164.jpg,fore,Unspecified,0.0,0,2217,2397,2348,2504,131,107
7693,levle2_164.jpg,fore,Unspecified,0.0,0,1911,2650,2057,2842,146,192
7694,levle2_164.jpg,fore,Unspecified,0.0,0,2018,2535,2171,2658,153,123
7695,levle2_164.jpg,fore,Unspecified,0.0,0,2079,2704,2240,2819,161,115
7696,levle2_164.jpg,fore,Unspecified,0.0,0,2095,2819,2263,2903,168,84
7697,levle2_164.jpg,fore,Unspecified,0.0,0,1965,2956,2141,3087,176,131
7698,levle2_164.jpg,fore,Unspecified,0.0,0,2003,3110,2171,3232,168,122
7699,levle2_164.jpg,fore,Unspecified,0.0,0,2164,2956,2279,3094,115,138
7700,levle2_164.jpg,fore,Unspecified,0.0,0,2263,2949,2417,3117,154,168
7701,levle2_164.jpg,fore,Unspecified,0.0,0,2424,2949,2524,3102,100,153
7702,levle2_164.jpg,fore,Unspecified,0.0,0,2539,2872,2631,2972,92,100
7703,levle2_164.jpg,fore,Unspecified,0.0,0,2608,2742,2784,2918,176,176
7704,levle2_164.jpg,fore,Unspecified,0.0,0,2217,2512,2332,2619,115,107
7705,levle2_164.jpg,fore,Unspecified,0.0,0,2225,2589,2378,2688,153,99
7706,levle2_164.jpg,fore,Unspecified,0.0,0,2401,2604,2532,2704,131,100
7707,levle2_164.jpg,fore,Unspecified,0.0,0,2294,2688,2371,2765,77,77
7708,levle2_164.jpg,fore,Unspecified,0.0,0,2401,2704,2486,2773,85,69
7709,levle2_164.jpg,fore,Unspecified,0.0,0,2409,2788,2616,2903,207,115
7710,levle0_288.jpg,fore,Unspecified,0.0,0,1551,2497,1788,2688,237,191
7711,levle0_288.jpg,fore,Unspecified,0.0,0,1459,2213,1681,2435,222,222
7712,levle2_158.jpg,fore,Unspecified,0.0,0,2026,1432,2179,1516,153,84
7713,levle2_158.jpg,fore,Unspecified,0.0,0,1865,1087,1995,1194,130,107
7714,levle2_158.jpg,fore,Unspecified,0.0,0,2125,1225,2256,1317,131,92
7715,levle2_158.jpg,fore,Unspecified,0.0,0,2087,1056,2125,1209,38,153
7716,levle2_158.jpg,fore,Unspecified,0.0,0,1145,2221,1260,2320,115,99
7717,levle2_158.jpg,fore,Unspecified,0.0,0,1313,2320,1397,2405,84,85
7718,levle2_158.jpg,fore,Unspecified,0.0,0,1198,2420,1336,2527,138,107
7719,levle2_158.jpg,fore,Unspecified,0.0,0,1129,2558,1221,2665,92,107
7720,levle2_158.jpg,fore,Unspecified,0.0,0,1260,2543,1329,2688,69,145
7721,levle2_158.jpg,fore,Unspecified,0.0,0,1397,2527,1489,2681,92,154
7722,levle2_158.jpg,fore,Unspecified,0.0,0,1474,2466,1597,2566,123,100
7723,levle2_158.jpg,fore,Unspecified,0.0,0,869,2320,915,2474,46,154
7724,levle2_158.jpg,fore,Unspecified,0.0,0,922,2229,1022,2290,100,61
7725,levle2_158.jpg,fore,Unspecified,0.0,0,708,2190,846,2297,138,107
7726,levle2_158.jpg,fore,Unspecified,0.0,0,700,2543,830,2665,130,122
7727,levle2_158.jpg,fore,Unspecified,0.0,0,731,2665,884,2796,153,131
7728,levle2_158.jpg,fore,Unspecified,0.0,0,1099,3117,1244,3179,145,62
7729,levle2_158.jpg,fore,Unspecified,0.0,0,1045,3148,1206,3324,161,176
7730,levle2_158.jpg,fore,Unspecified,0.0,0,1819,2719,1942,2803,123,84
7731,levle2_158.jpg,fore,Unspecified,0.0,0,1643,2750,1758,2857,115,107
7732,levle2_158.jpg,fore,Unspecified,0.0,0,1581,2619,1696,2750,115,131
7733,levle2_158.jpg,fore,Unspecified,0.0,0,1283,3033,1397,3117,114,84
7734,levle2_158.jpg,fore,Unspecified,0.0,0,1443,3094,1589,3209,146,115
7735,levle2_158.jpg,fore,Unspecified,0.0,0,1604,3133,1735,3255,131,122
7736,levle2_158.jpg,fore,Unspecified,0.0,0,1773,3186,1903,3309,130,123
7737,levle2_158.jpg,fore,Unspecified,0.0,0,1758,3309,1865,3401,107,92
7738,levle2_158.jpg,fore,Unspecified,0.0,0,1397,3278,1512,3386,115,108
7739,levle2_158.jpg,fore,Unspecified,0.0,0,2194,1071,2263,1171,69,100
7740,levle2_158.jpg,fore,Unspecified,0.0,0,2156,964,2332,1056,176,92
7741,levle1_272.jpg,fore,Unspecified,0.0,0,731,2742,800,2888,69,146
7742,levle1_272.jpg,fore,Unspecified,0.0,0,838,2826,907,2949,69,123
7743,levle1_272.jpg,fore,Unspecified,0.0,0,509,2872,601,3002,92,130
7744,levle1_272.jpg,fore,Unspecified,0.0,0,892,2397,1037,2527,145,130
7745,levle1_272.jpg,fore,Unspecified,0.0,0,1030,2619,1129,2734,99,115
7746,levle1_272.jpg,fore,Unspecified,0.0,0,1405,3248,1528,3378,123,130
7747,levle1_514.jpg,fore,Unspecified,0.0,0,570,1309,700,1470,130,161
7748,levle1_514.jpg,fore,Unspecified,0.0,0,470,1393,601,1493,131,100
7749,levle1_514.jpg,fore,Unspecified,0.0,0,754,1156,876,1301,122,145
7750,levle1_514.jpg,fore,Unspecified,0.0,0,1405,842,1482,941,77,99
7751,levle1_514.jpg,fore,Unspecified,0.0,0,1551,887,1742,1071,191,184
7752,levle1_514.jpg,fore,Unspecified,0.0,0,1543,1309,1681,1462,138,153
7753,levle1_514.jpg,fore,Unspecified,0.0,0,1589,612,1750,780,161,168
7754,levle1_42.jpg,fore,Unspecified,0.0,0,1037,2328,1114,2435,77,107
7755,levle1_42.jpg,fore,Unspecified,0.0,0,1267,2267,1428,2366,161,99
7756,levle1_42.jpg,fore,Unspecified,0.0,0,1206,2374,1329,2497,123,123
7757,levle1_42.jpg,fore,Unspecified,0.0,0,1191,2466,1298,2604,107,138
7758,levle1_42.jpg,fore,Unspecified,0.0,0,1106,2512,1229,2665,123,153
7759,levle1_42.jpg,fore,Unspecified,0.0,0,1306,2642,1436,2796,130,154
7760,levle1_42.jpg,fore,Unspecified,0.0,0,1482,2267,1574,2443,92,176
7761,levle1_42.jpg,fore,Unspecified,0.0,0,1589,2359,1696,2520,107,161
7762,levle1_42.jpg,fore,Unspecified,0.0,0,1704,2397,1819,2558,115,161
7763,levle1_42.jpg,fore,Unspecified,0.0,0,1965,2206,2041,2359,76,153
7764,levle1_42.jpg,fore,Unspecified,0.0,0,1727,2045,1842,2167,115,122
7765,levle1_42.jpg,fore,Unspecified,0.0,0,838,1018,1014,1179,176,161
7766,levle1_500.jpg,fore,Unspecified,0.0,0,777,2895,907,3025,130,130
7767,levle1_500.jpg,fore,Unspecified,0.0,0,1911,2520,2018,2589,107,69
7768,levle1_500.jpg,fore,Unspecified,0.0,0,1030,3064,1129,3171,99,107
7769,levle1_500.jpg,fore,Unspecified,0.0,0,777,3025,922,3209,145,184
7770,levle1_500.jpg,fore,Unspecified,0.0,0,2079,2474,2194,2581,115,107
7771,levle1_500.jpg,fore,Unspecified,0.0,0,2210,2282,2309,2397,99,115
7772,levle1_56.jpg,fore,,,0,2493,1738,2647,1884,154,146
7773,levle1_56.jpg,fore,,,0,2125,2297,2286,2405,161,108
7774,levle1_56.jpg,fore,,,0,2141,2489,2302,2612,161,123
7775,levle1_56.jpg,fore,,,0,1926,2382,2072,2504,146,122
7776,levle1_56.jpg,fore,,,0,2003,2627,2164,2719,161,92
7777,levle1_56.jpg,fore,,,0,2034,2719,2179,2834,145,115
7778,levle1_56.jpg,fore,,,0,1880,2665,1972,2765,92,100
7779,levle1_56.jpg,fore,,,0,1919,2757,2041,2872,122,115
7780,levle1_56.jpg,fore,,,0,1880,2842,1988,2949,108,107
7781,levle1_56.jpg,fore,,,0,1781,2780,1949,2911,168,131
7782,levle1_56.jpg,fore,,,0,1650,2819,1796,2972,146,153
7783,levle1_56.jpg,fore,,,0,2578,1516,2670,1608,92,92
7784,levle1_56.jpg,fore,,,0,2248,1102,2363,1209,115,107
7785,levle1_56.jpg,fore,,,0,1528,819,1696,995,168,176
7786,levle1_56.jpg,fore,,,0,1329,796,1497,972,168,176
7787,levle1_56.jpg,fore,,,0,1160,1071,1267,1217,107,146
7788,levle1_56.jpg,fore,,,0,1152,834,1306,995,154,161
7789,levle1_56.jpg,fore,,,0,1290,520,1443,619,153,99
7790,levle1_56.jpg,fore,,,0,1405,612,1558,788,153,176
7791,levle1_56.jpg,fore,,,0,1551,558,1689,704,138,146
7792,levle1_266.jpg,fore,Unspecified,0.0,0,2060,2134,2121,2213,61,79
7793,levle1_266.jpg,fore,Unspecified,0.0,0,2112,2196,2191,2248,79,52
7794,levle1_266.jpg,fore,Unspecified,0.0,0,2121,2029,2200,2108,79,79
7795,levle1_266.jpg,fore,Unspecified,0.0,0,2209,2011,2288,2117,79,106
7796,levle1_266.jpg,fore,Unspecified,0.0,0,2323,1994,2384,2099,61,105
7797,levle1_266.jpg,fore,Unspecified,0.0,0,2270,2406,2384,2494,114,88
7798,levle1_528.jpg,fore,Unspecified,0.0,0,585,1562,723,1677,138,115
7799,levle1_528.jpg,fore,Unspecified,0.0,0,378,1439,470,1562,92,123
7800,levle1_528.jpg,fore,Unspecified,0.0,0,470,1386,547,1462,77,76
7801,levle1_528.jpg,fore,Unspecified,0.0,0,363,1807,516,1922,153,115
7802,levle1_528.jpg,fore,Unspecified,0.0,0,1727,1140,1873,1232,146,92
7803,levle1_528.jpg,fore,Unspecified,0.0,0,493,1508,585,1600,92,92
7804,levle1_81.jpg,fore,Unspecified,0.0,0,2292,1601,2450,1784,158,183
7805,levle1_81.jpg,fore,Unspecified,0.0,0,1952,2142,2168,2316,216,174
7806,levle1_81.jpg,fore,Unspecified,0.0,0,2409,2316,2658,2557,249,241
7807,levle1_81.jpg,fore,Unspecified,0.0,0,2774,2000,2982,2191,208,191
7808,levle1_81.jpg,fore,Unspecified,0.0,0,3473,1111,3672,1269,199,158
7809,levle1_81.jpg,fore,Unspecified,0.0,0,3315,803,3414,936,99,133
7810,levle1_81.jpg,fore,Unspecified,0.0,0,3248,1194,3423,1418,175,224
7811,levle1_81.jpg,fore,Unspecified,0.0,0,3481,887,3730,1069,249,182
7812,levle1_95.jpg,fore,Unspecified,0.0,0,1960,1161,2101,1261,141,100
7813,levle1_95.jpg,fore,Unspecified,0.0,0,2076,1502,2168,1618,92,116
7814,levle1_95.jpg,fore,Unspecified,0.0,0,2184,1477,2309,1585,125,108
7815,levle1_95.jpg,fore,Unspecified,0.0,0,2267,1660,2367,1817,100,157
7816,levle1_95.jpg,fore,Unspecified,0.0,0,2392,1693,2467,1809,75,116
7817,levle1_95.jpg,fore,Unspecified,0.0,0,2417,1169,2592,1344,175,175
7818,levle1_95.jpg,fore,Unspecified,0.0,0,1827,2108,1935,2275,108,167
7819,levle1_299.jpg,fore,Unspecified,0.0,0,248,1730,363,1876,115,146
7820,levle1_299.jpg,fore,Unspecified,0.0,0,417,2412,532,2589,115,177
7821,levle1_299.jpg,fore,Unspecified,0.0,0,371,2175,539,2313,168,138
7822,levle1_299.jpg,fore,Unspecified,0.0,0,478,2918,608,3156,130,238
7823,levle1_299.jpg,fore,Unspecified,0.0,0,769,2972,869,3110,100,138
7824,levle1_299.jpg,fore,Unspecified,0.0,0,562,2389,639,2550,77,161
7825,levle1_299.jpg,fore,Unspecified,0.0,0,1696,3010,1781,3102,85,92
7826,levle1_299.jpg,fore,Unspecified,0.0,0,1796,3156,1888,3278,92,122
7827,levle1_298.jpg,fore,Unspecified,0.0,0,1083,2152,1168,2259,85,107
7828,levle1_298.jpg,fore,Unspecified,0.0,0,1382,2198,1474,2374,92,176
7829,levle1_298.jpg,fore,Unspecified,0.0,0,1390,1907,1558,2098,168,191
7830,levle1_298.jpg,fore,Unspecified,0.0,0,1367,2412,1520,2604,153,192
7831,levle1_298.jpg,fore,Unspecified,0.0,0,830,2573,976,2742,146,169
7832,levle1_298.jpg,fore,Unspecified,0.0,0,286,2642,401,2857,115,215
7833,levle1_298.jpg,fore,Unspecified,0.0,0,715,2780,838,2849,123,69
7834,levle1_94.jpg,fore,Unspecified,0.0,0,2326,2075,2492,2250,166,175
7835,levle1_94.jpg,fore,Unspecified,0.0,0,2517,1909,2749,2083,232,174
7836,levle1_94.jpg,fore,Unspecified,0.0,0,2093,2017,2292,2175,199,158
7837,levle1_94.jpg,fore,Unspecified,0.0,0,2043,2233,2193,2424,150,191
7838,levle1_94.jpg,fore,Unspecified,0.0,0,2292,2349,2425,2482,133,133
7839,levle1_94.jpg,fore,Unspecified,0.0,0,2600,2266,2799,2466,199,200
7840,levle1_94.jpg,fore,Unspecified,0.0,0,2833,2291,2957,2499,124,208
7841,levle1_94.jpg,fore,Unspecified,0.0,0,2708,2732,2916,2906,208,174
7842,levle1_94.jpg,fore,Unspecified,0.0,0,2641,2931,2783,3072,142,141
7843,levle1_80.jpg,fore,Unspecified,0.0,0,2691,1892,2899,2083,208,191
7844,levle1_80.jpg,fore,Unspecified,0.0,0,2400,1809,2550,1950,150,141
7845,levle1_80.jpg,fore,Unspecified,0.0,0,2334,2042,2409,2183,75,141
7846,levle1_80.jpg,fore,Unspecified,0.0,0,2051,2017,2251,2158,200,141
7847,levle1_80.jpg,fore,Unspecified,0.0,0,2741,2491,2932,2682,191,191
7848,levle1_80.jpg,fore,Unspecified,0.0,0,2957,2324,3123,2507,166,183
7849,levle1_80.jpg,fore,Unspecified,0.0,0,1977,712,2060,911,83,199
7850,levle1_80.jpg,fore,Unspecified,0.0,0,1868,670,1943,779,75,109
7851,levle1_80.jpg,fore,Unspecified,0.0,0,3315,72,3522,272,207,200
7852,levle1_80.jpg,fore,Unspecified,0.0,0,3040,6,3281,172,241,166
7853,levle1_529.jpg,fore,Unspecified,0.0,0,532,1684,662,1838,130,154
7854,levle1_529.jpg,fore,Unspecified,0.0,0,409,1501,509,1623,100,122
7855,levle1_529.jpg,fore,Unspecified,0.0,0,340,1539,401,1646,61,107
7856,levle1_529.jpg,fore,Unspecified,0.0,0,156,1654,217,1753,61,99
7857,levle1_529.jpg,fore,Unspecified,0.0,0,248,1677,294,1853,46,176
7858,levle1_529.jpg,fore,Unspecified,0.0,0,309,1730,401,1799,92,69
7859,levle1_529.jpg,fore,Unspecified,0.0,0,1712,1202,1819,1317,107,115
7860,levle1_57.jpg,fore,Unspecified,0.0,0,1765,550,1980,688,215,138
7861,levle1_57.jpg,fore,Unspecified,0.0,0,1857,420,2034,535,177,115
7862,levle1_57.jpg,fore,Unspecified,0.0,0,1635,297,1719,420,84,123
7863,levle1_57.jpg,fore,Unspecified,0.0,0,1535,673,1719,803,184,130
7864,levle1_57.jpg,fore,Unspecified,0.0,0,2034,887,2187,1041,153,154
7865,levle1_57.jpg,fore,Unspecified,0.0,0,2148,1079,2325,1240,177,161
7866,levle1_57.jpg,fore,Unspecified,0.0,0,2041,727,2187,842,146,115
7867,levle1_57.jpg,fore,Unspecified,0.0,0,2225,619,2378,780,153,161
7868,levle1_57.jpg,fore,Unspecified,0.0,0,2256,834,2355,903,99,69
7869,levle1_57.jpg,fore,Unspecified,0.0,0,838,1240,1037,1416,199,176
7870,levle1_57.jpg,fore,Unspecified,0.0,0,777,1393,930,1516,153,123
7871,levle1_57.jpg,fore,Unspecified,0.0,0,616,1953,731,2068,115,115
7872,levle1_57.jpg,fore,Unspecified,0.0,0,800,1960,968,2106,168,146
7873,levle1_57.jpg,fore,Unspecified,0.0,0,846,2198,999,2320,153,122
7874,levle1_57.jpg,fore,Unspecified,0.0,0,876,2328,1022,2443,146,115
7875,levle1_57.jpg,fore,Unspecified,0.0,0,853,2443,1007,2573,154,130
7876,levle1_57.jpg,fore,Unspecified,0.0,0,838,2558,938,2665,100,107
7877,levle1_57.jpg,fore,Unspecified,0.0,0,1014,2581,1076,2665,62,84
7878,levle1_57.jpg,fore,Unspecified,0.0,0,1214,2934,1329,3064,115,130
7879,levle1_57.jpg,fore,Unspecified,0.0,0,1352,3025,1489,3133,137,108
7880,levle1_501.jpg,fore,Unspecified,0.0,0,547,2428,647,2627,100,199
7881,levle1_501.jpg,fore,Unspecified,0.0,0,692,2481,777,2604,85,123
7882,levle1_501.jpg,fore,Unspecified,0.0,0,800,2313,945,2481,145,168
7883,levle1_501.jpg,fore,Unspecified,0.0,0,961,2359,1068,2504,107,145
7884,levle1_501.jpg,fore,Unspecified,0.0,0,1221,2627,1329,2757,108,130
7885,levle1_501.jpg,fore,Unspecified,0.0,0,1007,2696,1137,2849,130,153
7886,levle1_267.jpg,fore,Unspecified,0.0,0,930,796,1053,995,123,199
7887,levle1_267.jpg,fore,Unspecified,0.0,0,493,1623,631,1753,138,130
7888,levle1_267.jpg,fore,Unspecified,0.0,0,539,1899,700,2175,161,276
7889,levle1_267.jpg,fore,Unspecified,0.0,0,194,2658,355,2826,161,168
7890,levle1_267.jpg,fore,Unspecified,0.0,0,991,2397,1091,2535,100,138
7891,levle1_267.jpg,fore,Unspecified,0.0,0,838,2834,984,2987,146,153
7892,levle1_273.jpg,fore,,,0,1873,2642,1988,2872,115,230
7893,levle1_273.jpg,fore,,,0,2202,2336,2332,2458,130,122
7894,levle1_273.jpg,fore,,,0,2294,2458,2455,2589,161,131
7895,levle1_273.jpg,fore,,,0,2340,2696,2501,2934,161,238
7896,levle1_273.jpg,fore,,,0,2509,2681,2677,2888,168,207
7897,levle1_273.jpg,fore,,,0,2629,2998,2784,3129,155,131
7898,levle1_43.jpg,fore,Unspecified,0.0,0,2118,2022,2256,2160,138,138
7899,levle1_43.jpg,fore,Unspecified,0.0,0,1942,1884,2087,2075,145,191
7900,levle1_43.jpg,fore,Unspecified,0.0,0,1949,2137,2102,2221,153,84
7901,levle1_43.jpg,fore,Unspecified,0.0,0,1857,2244,1934,2351,77,107
7902,levle1_43.jpg,fore,Unspecified,0.0,0,1719,2152,1804,2274,85,122
7903,levle1_43.jpg,fore,Unspecified,0.0,0,1949,2290,2041,2374,92,84
7904,levle1_43.jpg,fore,Unspecified,0.0,0,1451,2274,1558,2389,107,115
7905,levle1_43.jpg,fore,Unspecified,0.0,0,1428,2382,1558,2504,130,122
7906,levle1_43.jpg,fore,Unspecified,0.0,0,1275,2274,1405,2397,130,123
7907,levle1_43.jpg,fore,Unspecified,0.0,0,1574,2558,1689,2681,115,123
7908,levle1_515.jpg,fore,Unspecified,0.0,0,240,1462,440,1569,200,107
7909,levle1_515.jpg,fore,Unspecified,0.0,0,233,1608,401,1784,168,176
7910,levle1_515.jpg,fore,Unspecified,0.0,0,26,1707,133,1784,107,77
7911,levle1_515.jpg,fore,Unspecified,0.0,0,79,1899,225,2060,146,161
7912,levle1_515.jpg,fore,Unspecified,0.0,0,532,1884,708,2052,176,168
7913,levle1_515.jpg,fore,Unspecified,0.0,0,340,2098,532,2267,192,169
7914,levle1_515.jpg,fore,Unspecified,0.0,0,432,2382,524,2535,92,153
7915,levle1_515.jpg,fore,Unspecified,0.0,0,585,2244,715,2435,130,191
7916,levle1_515.jpg,fore,Unspecified,0.0,0,723,2458,792,2604,69,146
7917,levle1_515.jpg,fore,Unspecified,0.0,0,800,2443,915,2612,115,169
7918,levle1_515.jpg,fore,Unspecified,0.0,0,922,2757,1045,2826,123,69
7919,levle1_515.jpg,fore,Unspecified,0.0,0,999,3025,1122,3163,123,138
7920,levle1_515.jpg,fore,Unspecified,0.0,0,792,2972,945,3117,153,145
7921,levle1_515.jpg,fore,Unspecified,0.0,0,1474,3248,1650,3401,176,153
7922,levle2_159.jpg,fore,Unspecified,0.0,0,1137,1899,1275,1991,138,92
7923,levle2_159.jpg,fore,Unspecified,0.0,0,1137,1799,1237,1861,100,62
7924,levle2_159.jpg,fore,Unspecified,0.0,0,1152,1569,1214,1631,62,62
7925,levle2_159.jpg,fore,Unspecified,0.0,0,1045,1638,1160,1692,115,54
7926,levle2_159.jpg,fore,Unspecified,0.0,0,1022,1707,1160,1815,138,108
7927,levle2_159.jpg,fore,Unspecified,0.0,0,823,1194,953,1263,130,69
7928,levle2_159.jpg,fore,Unspecified,0.0,0,823,1010,945,1102,122,92
7929,levle2_159.jpg,fore,Unspecified,0.0,0,861,1094,945,1186,84,92
7930,levle2_159.jpg,fore,Unspecified,0.0,0,2034,2336,2125,2466,91,130
7931,levle2_159.jpg,fore,Unspecified,0.0,0,2102,2274,2294,2443,192,169
7932,levle2_159.jpg,fore,Unspecified,0.0,0,2079,2497,2240,2650,161,153
7933,levle2_159.jpg,fore,Unspecified,0.0,0,2417,2374,2578,2504,161,130
7934,levle2_159.jpg,fore,Unspecified,0.0,0,1773,2405,1873,2489,100,84
7935,levle2_159.jpg,fore,Unspecified,0.0,0,1704,2520,1827,2658,123,138
7936,levle2_159.jpg,fore,Unspecified,0.0,0,1566,2596,1727,2688,161,92
7937,levle2_159.jpg,fore,Unspecified,0.0,0,1834,2688,1911,2811,77,123
7938,levle2_159.jpg,fore,Unspecified,0.0,0,1627,2719,1765,2826,138,107
7939,levle2_159.jpg,fore,Unspecified,0.0,0,1535,2727,1635,2819,100,92
7940,levle2_159.jpg,fore,Unspecified,0.0,0,1397,2688,1497,2826,100,138
7941,levle2_159.jpg,fore,Unspecified,0.0,0,1689,2849,1842,2926,153,77
7942,levle2_159.jpg,fore,Unspecified,0.0,0,1673,2918,1827,2987,154,69
7943,levle2_159.jpg,fore,Unspecified,0.0,0,1650,3301,1804,3393,154,92
7944,levle2_159.jpg,fore,Unspecified,0.0,0,1581,3202,1719,3309,138,107
7945,levle2_159.jpg,fore,Unspecified,0.0,0,1543,3110,1666,3209,123,99
7946,levle2_159.jpg,fore,Unspecified,0.0,0,1428,3271,1520,3393,92,122
7947,levle2_159.jpg,fore,Unspecified,0.0,0,1942,3194,2072,3332,130,138
7948,levle2_159.jpg,fore,Unspecified,0.0,0,1781,3202,1911,3301,130,99
7949,levle2_159.jpg,fore,Unspecified,0.0,0,2486,2834,2562,2949,76,115
7950,levle0_289.jpg,fore,Unspecified,0.0,0,938,2160,1114,2290,176,130
7951,levle0_289.jpg,fore,Unspecified,0.0,0,884,2259,1030,2489,146,230
7952,levle2_165.jpg,fore,,,0,1214,3048,1352,3240,138,192
7953,levle2_165.jpg,fore,,,0,1160,2826,1267,2972,107,146
7954,levle2_165.jpg,fore,,,0,938,2888,1129,3087,191,199
7955,levle2_165.jpg,fore,,,0,976,2734,1114,2888,138,154
7956,levle2_165.jpg,fore,,,0,1129,2719,1145,2734,16,15
7957,levle2_165.jpg,fore,,,0,1007,2550,1137,2750,130,200
7958,levle2_165.jpg,fore,,,0,922,2481,1030,2619,108,138
7959,levle2_165.jpg,fore,,,0,991,2412,1152,2558,161,146
7960,levle2_165.jpg,fore,,,0,1083,2167,1260,2351,177,184
7961,levle2_165.jpg,fore,,,0,715,2236,938,2451,223,215
7962,levle2_165.jpg,fore,,,0,754,2198,830,2267,76,69
7963,levle2_165.jpg,fore,,,0,440,2811,685,2956,245,145
7964,levle2_165.jpg,fore,,,0,608,2022,807,2236,199,214
7965,levle2_165.jpg,fore,,,0,585,1815,807,2052,222,237
7966,levle2_165.jpg,fore,,,0,348,1891,509,2052,161,161
7967,levle2_165.jpg,fore,,,0,286,1707,440,1907,154,200
7968,levle2_165.jpg,fore,,,0,470,1661,746,1907,276,246
7969,levle2_165.jpg,fore,,,0,926,1036,1040,1150,114,114
7970,levle2_165.jpg,fore,,,0,388,1381,540,1488,152,107
7971,levle2_165.jpg,fore,,,0,1112,2394,1215,2508,103,114
7972,levle2_165.jpg,fore,,,0,936,2212,1074,2329,138,117
7973,levle2_171.jpg,fore,Unspecified,0.0,0,1397,650,1551,803,154,153
7974,levle2_171.jpg,fore,Unspecified,0.0,0,1719,757,1765,803,46,46
7975,levle2_171.jpg,fore,Unspecified,0.0,0,1643,650,1796,788,153,138
7976,levle2_171.jpg,fore,Unspecified,0.0,0,493,2336,631,2481,138,145
7977,levle2_171.jpg,fore,Unspecified,0.0,0,777,2589,899,2765,122,176
7978,levle2_171.jpg,fore,Unspecified,0.0,0,861,2604,991,2750,130,146
7979,levle2_171.jpg,fore,Unspecified,0.0,0,976,2589,1083,2719,107,130
7980,levle2_171.jpg,fore,Unspecified,0.0,0,1014,2420,1168,2581,154,161
7981,levle2_171.jpg,fore,Unspecified,0.0,0,999,2313,1145,2428,146,115
7982,levle2_171.jpg,fore,Unspecified,0.0,0,1221,2412,1382,2573,161,161
7983,levle2_171.jpg,fore,Unspecified,0.0,0,692,2428,869,2566,177,138
7984,levle2_171.jpg,fore,Unspecified,0.0,0,784,2290,953,2458,169,168
7985,levle2_171.jpg,fore,Unspecified,0.0,0,692,2788,800,2918,108,130
7986,levle2_171.jpg,fore,Unspecified,0.0,0,815,2757,961,2888,146,131
7987,levle2_171.jpg,fore,Unspecified,0.0,0,1306,2711,1474,2857,168,146
7988,levle2_171.jpg,fore,Unspecified,0.0,0,1191,2911,1359,2995,168,84
7989,levle2_171.jpg,fore,Unspecified,0.0,0,1206,3048,1352,3140,146,92
7990,levle2_171.jpg,fore,Unspecified,0.0,0,708,2964,892,3110,184,146
7991,levle2_171.jpg,fore,Unspecified,0.0,0,800,3125,907,3202,107,77
7992,levle2_171.jpg,fore,Unspecified,0.0,0,823,3209,999,3355,176,146
7993,levle2_171.jpg,fore,Unspecified,0.0,0,493,3064,685,3209,192,145
7994,levle2_12.jpg,fore,Unspecified,0.0,0,359,298,380,314,21,16
7995,levle2_12.jpg,fore,Unspecified,0.0,0,349,305,370,328,21,23
7996,levle2_12.jpg,fore,Unspecified,0.0,0,352,274,374,295,22,21
7997,levle2_12.jpg,fore,Unspecified,0.0,0,327,251,349,282,22,31
7998,levle2_12.jpg,fore,Unspecified,0.0,0,300,299,322,320,22,21
7999,levle2_12.jpg,fore,Unspecified,0.0,0,265,315,289,346,24,31
8000,levle2_12.jpg,fore,Unspecified,0.0,0,264,282,289,312,25,30
8001,levle2_12.jpg,fore,Unspecified,0.0,0,162,295,189,323,27,28
8002,levle2_12.jpg,fore,Unspecified,0.0,0,197,301,221,329,24,28
8003,levle2_12.jpg,fore,Unspecified,0.0,0,217,346,240,364,23,18
8004,levle2_12.jpg,fore,Unspecified,0.0,0,187,263,210,281,23,18
8005,levle2_12.jpg,fore,Unspecified,0.0,0,179,216,206,255,27,39
8006,levle2_12.jpg,fore,Unspecified,0.0,0,193,188,232,211,39,23
8007,levle2_12.jpg,fore,Unspecified,0.0,0,246,205,270,231,24,26
8008,levle2_12.jpg,fore,Unspecified,0.0,0,276,209,300,229,24,20
8009,levle2_12.jpg,fore,Unspecified,0.0,0,302,221,319,242,17,21
8010,levle2_12.jpg,fore,Unspecified,0.0,0,384,220,401,242,17,22
8011,levle2_12.jpg,fore,Unspecified,0.0,0,372,186,397,207,25,21
8012,levle2_12.jpg,fore,Unspecified,0.0,0,404,201,428,228,24,27
8013,levle2_12.jpg,fore,Unspecified,0.0,0,422,161,449,189,27,28
8014,levle2_12.jpg,fore,Unspecified,0.0,0,305,120,342,145,37,25
8015,levle2_12.jpg,fore,Unspecified,0.0,0,375,132,399,156,24,24
8016,levle2_12.jpg,fore,Unspecified,0.0,0,255,141,292,178,37,37
8017,levle2_12.jpg,fore,Unspecified,0.0,0,261,79,293,106,32,27
8018,levle2_12.jpg,fore,Unspecified,0.0,0,174,72,204,92,30,20
8019,levle2_12.jpg,fore,Unspecified,0.0,0,140,52,167,75,27,23
8020,levle2_12.jpg,fore,Unspecified,0.0,0,124,72,160,98,36,26
8021,levle2_12.jpg,fore,Unspecified,0.0,0,160,45,190,62,30,17
8022,levle2_12.jpg,fore,Unspecified,0.0,0,196,105,224,125,28,20
8023,levle2_12.jpg,fore,Unspecified,0.0,0,100,94,137,123,37,29
8024,levle2_12.jpg,fore,Unspecified,0.0,0,117,161,144,179,27,18
8025,levle2_12.jpg,fore,Unspecified,0.0,0,121,185,129,194,8,9
8026,levle2_12.jpg,fore,Unspecified,0.0,0,105,163,124,190,19,27
8027,levle2_12.jpg,fore,Unspecified,0.0,0,109,227,125,262,16,35
8028,levle2_12.jpg,fore,Unspecified,0.0,0,154,229,179,263,25,34
8029,levle2_12.jpg,fore,Unspecified,0.0,0,142,141,174,171,32,30
8030,levle2_12.jpg,fore,Unspecified,0.0,0,409,79,432,102,23,23
8031,levle2_12.jpg,fore,Unspecified,0.0,0,372,90,415,126,43,36
8032,levle2_12.jpg,fore,Unspecified,0.0,0,316,319,341,339,25,20
8033,levle2_12.jpg,fore,Unspecified,0.0,0,177,156,213,194,36,38
8034,levle2_12.jpg,fore,Unspecified,0.0,0,27,159,69,194,42,35
8035,levle0_276.jpg,fore,Unspecified,0.0,0,2539,2336,2685,2535,146,199
8036,levle0_276.jpg,fore,Unspecified,0.0,0,1696,2573,1827,2742,131,169
8037,levle0_276.jpg,fore,Unspecified,0.0,0,2256,2305,2394,2458,138,153
8038,levle0_510.jpg,fore,Unspecified,0.0,0,463,2167,539,2359,76,192
8039,levle0_510.jpg,fore,Unspecified,0.0,0,830,2880,1068,3056,238,176
8040,levle0_504.jpg,fore,Unspecified,0.0,0,1083,1179,1237,1386,154,207
8041,levle0_504.jpg,fore,Unspecified,0.0,0,2286,1209,2394,1370,108,161
8042,levle0_504.jpg,fore,Unspecified,0.0,0,2171,895,2317,1048,146,153
8043,levle0_504.jpg,fore,Unspecified,0.0,0,869,2045,1007,2221,138,176
8044,levle0_0.jpg,fore,Unspecified,0.0,0,223,290,251,306,28,16
8045,levle0_0.jpg,fore,Unspecified,0.0,0,217,250,239,276,22,26
8046,levle0_0.jpg,fore,Unspecified,0.0,0,186,514,209,536,23,22
8047,levle0_458.jpg,fore,Unspecified,0.0,0,1865,1048,2110,1309,245,261
8048,levle0_17.jpg,fore,Unspecified,0.0,0,285,90,313,126,28,36
8049,levle0_17.jpg,fore,Unspecified,0.0,0,338,148,379,190,41,42
8050,levle0_17.jpg,fore,Unspecified,0.0,0,304,255,330,288,26,33
8051,levle0_17.jpg,fore,Unspecified,0.0,0,289,199,328,237,39,38
8052,levle1_139.jpg,fore,Unspecified,0.0,0,2034,1317,2141,1462,107,145
8053,levle1_139.jpg,fore,Unspecified,0.0,0,2164,2083,2286,2175,122,92
8054,levle1_139.jpg,fore,Unspecified,0.0,0,2102,2213,2240,2320,138,107
8055,levle1_139.jpg,fore,Unspecified,0.0,0,2463,2075,2631,2206,168,131
8056,levle1_139.jpg,fore,Unspecified,0.0,0,2087,2382,2210,2466,123,84
8057,levle1_139.jpg,fore,Unspecified,0.0,0,1857,2681,2003,2796,146,115
8058,levle1_139.jpg,fore,Unspecified,0.0,0,1834,2811,1934,2926,100,115
8059,levle1_139.jpg,fore,Unspecified,0.0,0,1214,3133,1329,3263,115,130
8060,levle1_139.jpg,fore,Unspecified,0.0,0,1298,2987,1405,3133,107,146
8061,levle1_111.jpg,fore,Unspecified,0.0,0,3606,2117,3739,2283,133,166
8062,levle1_111.jpg,fore,Unspecified,0.0,0,3398,2067,3556,2200,158,133
8063,levle1_111.jpg,fore,Unspecified,0.0,0,3747,1759,3938,1859,191,100
8064,levle1_111.jpg,fore,Unspecified,0.0,0,3522,2250,3705,2366,183,116
8065,levle1_111.jpg,fore,Unspecified,0.0,0,3464,2358,3606,2457,142,99
8066,levle1_111.jpg,fore,Unspecified,0.0,0,3281,2183,3406,2341,125,158
8067,levle1_111.jpg,fore,Unspecified,0.0,0,3439,2632,3597,2765,158,133
8068,levle1_111.jpg,fore,Unspecified,0.0,0,3414,2191,3556,2308,142,117
8069,levle0_302.jpg,fore,Unspecified,0.0,0,1627,2244,1781,2428,154,184
8070,levle0_302.jpg,fore,Unspecified,0.0,0,2355,711,2555,887,200,176
8071,levle0_470.jpg,fore,Unspecified,0.0,0,1497,3294,1666,3432,169,138
8072,levle0_470.jpg,fore,Unspecified,0.0,0,2018,1087,2118,1301,100,214
8073,levle1_105.jpg,fore,Unspecified,0.0,0,1927,1809,2035,1950,108,141
8074,levle1_105.jpg,fore,Unspecified,0.0,0,1694,1950,1777,2142,83,192
8075,levle1_105.jpg,fore,Unspecified,0.0,0,1735,1768,1844,1917,109,149
8076,levle1_105.jpg,fore,Unspecified,0.0,0,2159,1751,2309,1892,150,141
8077,levle1_105.jpg,fore,Unspecified,0.0,0,2118,1934,2226,2083,108,149
8078,levle1_105.jpg,fore,Unspecified,0.0,0,2334,1984,2467,2133,133,149
8079,levle1_105.jpg,fore,Unspecified,0.0,0,1769,1485,1893,1660,124,175
8080,levle0_316.jpg,fore,Unspecified,0.0,0,662,573,807,704,145,131
8081,levle3_91.jpg,fore,,,0,2725,1493,2932,1743,207,250
8082,levle3_91.jpg,fore,,,0,2941,1610,3157,1809,216,199
8083,levle3_91.jpg,fore,,,0,2683,1851,2874,2058,191,207
8084,levle3_91.jpg,fore,,,0,2193,1909,2417,2108,224,199
8085,levle3_91.jpg,fore,,,0,1835,936,2043,1119,208,183
8086,levle3_91.jpg,fore,,,0,2459,2158,2592,2324,133,166
8087,levle3_91.jpg,fore,,,0,2700,2117,2949,2349,249,232
8088,levle3_91.jpg,fore,,,0,2991,2050,3223,2299,232,249
8089,levle3_91.jpg,fore,,,0,2991,2574,3115,2765,124,191
8090,levle3_91.jpg,fore,,,0,3356,2142,3655,2341,299,199
8091,levle3_91.jpg,fore,,,0,3356,2308,3581,2590,225,282
8092,levle3_91.jpg,fore,,,0,3489,2748,3730,3014,241,266
8093,levle3_91.jpg,fore,,,0,3988,2266,4196,2457,208,191
8094,levle3_91.jpg,fore,,,0,3672,2441,3813,2682,141,241
8095,levle3_91.jpg,fore,,,0,3847,2582,4088,2773,241,191
8096,levle3_91.jpg,fore,,,0,3847,2798,4071,3014,224,216
8097,levle3_91.jpg,fore,,,0,3306,2906,3398,3023,92,117
8098,levle3_91.jpg,fore,,,0,3024,2715,3273,2898,249,183
8099,levle3_91.jpg,fore,,,0,2666,2466,2932,2698,266,232
8100,levle3_91.jpg,fore,,,0,2816,2333,3065,2532,249,199
8101,levle3_91.jpg,fore,,,0,3290,1851,3531,2034,241,183
8102,levle3_91.jpg,fore,,,0,2400,2466,2575,2640,175,174
8103,levle3_91.jpg,fore,,,0,1810,2025,1935,2258,125,233
8104,levle3_91.jpg,fore,,,0,2134,2092,2143,2100,9,8
8105,levle3_91.jpg,fore,,,0,2026,1950,2226,2266,200,316
8106,levle3_91.jpg,fore,,,0,2284,1369,2500,1635,216,266
8107,levle3_91.jpg,fore,,,0,2085,1169,2218,1286,133,117
8108,levle3_91.jpg,fore,,,0,2907,1177,3115,1443,208,266
8109,levle3_91.jpg,fore,,,0,3107,1452,3323,1576,216,124
8110,levle3_91.jpg,fore,,,0,3173,1186,3531,1360,358,174
8111,levle3_91.jpg,fore,,,0,2808,945,3024,1103,216,158
8112,levle3_91.jpg,fore,,,0,2375,828,2633,928,258,100
8113,levle3_91.jpg,fore,,,0,2417,546,2616,787,199,241
8114,levle3_91.jpg,fore,,,0,2101,513,2375,837,274,324
8115,levle3_91.jpg,fore,,,0,1328,463,1802,837,474,374
8116,levle3_91.jpg,fore,,,0,3190,155,3414,371,224,216
8117,levle3_91.jpg,fore,,,0,3032,604,3240,853,208,249
8118,levle3_91.jpg,fore,,,0,2641,30,2999,346,358,316
8119,levle3_91.jpg,fore,,,0,2454,1054,2682,1206,228,152
8120,levle3_91.jpg,fore,,,0,2174,1658,2450,1882,276,224
8121,levle3_91.jpg,fore,,,0,3838,730,4022,974,184,244
8122,levle3_91.jpg,fore,,,0,4342,2342,4522,2546,180,204
8123,levle3_91.jpg,fore,,,0,3742,2018,3918,2178,176,160
8124,levle3_91.jpg,fore,,,0,1742,1394,1898,1554,156,160
8125,levle3_91.jpg,fore,,,0,1626,1794,1838,2030,212,236
8126,levle3_91.jpg,fore,,,0,2254,2202,2526,2438,272,236
8127,levle3_91.jpg,fore,,,0,2638,1174,2834,1374,196,200
8128,levle3_91.jpg,fore,,,0,1270,930,1454,1178,184,248
8129,levle3_91.jpg,fore,,,0,1898,2182,2042,2314,144,132
8130,levle3_91.jpg,fore,,,0,3478,1766,3742,1982,264,216
8131,levle3_91.jpg,fore,,,0,2102,818,2314,994,212,176
8132,levle3_91.jpg,fore,,,0,2450,1510,2610,1678,160,168
8133,levle3_91.jpg,fore,,,0,2558,1390,2762,1558,204,168
8134,levle3_91.jpg,fore,,,0,2886,1850,3102,2054,216,204
8135,levle3_91.jpg,fore,,,0,3102,2250,3318,2406,216,156
8136,levle3_91.jpg,fore,,,0,4046,2802,4218,2962,172,160
8137,levle3_85.jpg,fore,,,0,122,25,143,41,21,16
8138,levle3_85.jpg,fore,,,0,168,10,191,27,23,17
8139,levle3_85.jpg,fore,,,0,228,35,248,51,20,16
8140,levle3_85.jpg,fore,,,0,199,49,214,62,15,13
8141,levle3_85.jpg,fore,,,0,208,75,225,97,17,22
8142,levle3_85.jpg,fore,,,0,183,79,209,98,26,19
8143,levle3_85.jpg,fore,,,0,164,77,183,89,19,12
8144,levle3_85.jpg,fore,,,0,135,73,149,84,14,11
8145,levle3_85.jpg,fore,,,0,120,86,134,105,14,19
8146,levle3_85.jpg,fore,,,0,99,126,118,140,19,14
8147,levle3_85.jpg,fore,,,0,169,164,184,185,15,21
8148,levle3_85.jpg,fore,,,0,180,151,200,177,20,26
8149,levle3_85.jpg,fore,,,0,157,57,179,71,22,14
8150,levle3_85.jpg,fore,,,0,174,117,196,135,22,18
8151,levle3_85.jpg,fore,,,0,120,2,136,15,16,13
8152,levle3_85.jpg,fore,,,0,148,2,166,16,18,14
8153,levle3_85.jpg,fore,,,0,137,14,152,28,15,14
8154,levle3_85.jpg,fore,,,0,155,19,170,35,15,16
8155,levle3_85.jpg,fore,,,0,187,30,205,46,18,16
8156,levle3_85.jpg,fore,,,0,159,35,184,51,25,16
8157,levle3_85.jpg,fore,,,0,139,40,157,59,18,19
8158,levle3_85.jpg,fore,,,0,127,49,146,69,19,20
8159,levle3_85.jpg,fore,,,0,104,49,130,71,26,22
8160,levle3_85.jpg,fore,,,0,84,86,108,105,24,19
8161,levle3_85.jpg,fore,,,0,105,75,128,95,23,20
8162,levle3_85.jpg,fore,,,0,221,48,251,69,30,21
8163,levle3_85.jpg,fore,,,0,196,24,231,54,35,30
8164,levle3_85.jpg,fore,,,0,226,2,245,20,19,18
8165,levle3_85.jpg,fore,,,0,268,38,290,59,22,21
8166,levle3_85.jpg,fore,,,0,121,105,137,121,16,16
8167,levle3_85.jpg,fore,,,0,151,133,176,150,25,17
8168,levle3_85.jpg,fore,,,0,147,147,162,162,15,15
8169,levle3_85.jpg,fore,,,0,129,147,157,169,28,22
8170,levle3_85.jpg,fore,,,0,116,148,139,169,23,21
8171,levle3_85.jpg,fore,,,0,81,148,99,164,18,16
8172,levle3_85.jpg,fore,,,0,56,164,77,177,21,13
8173,levle3_85.jpg,fore,,,0,97,191,116,203,19,12
8174,levle3_85.jpg,fore,,,0,130,175,150,203,20,28
8175,levle3_85.jpg,fore,,,0,151,170,166,188,15,18
8176,levle3_85.jpg,fore,,,0,164,199,184,218,20,19
8177,levle3_85.jpg,fore,,,0,28,90,43,105,15,15
8178,levle3_85.jpg,fore,,,0,42,96,58,113,16,17
8179,levle3_85.jpg,fore,,,0,77,54,96,70,19,16
8180,levle3_85.jpg,fore,,,0,98,6,108,17,10,11
8181,levle3_85.jpg,fore,,,0,92,28,108,42,16,14
8182,levle3_85.jpg,fore,,,0,59,97,71,111,12,14
8183,levle3_85.jpg,fore,,,0,85,108,104,124,19,16
8184,levle3_85.jpg,fore,,,0,48,147,63,158,15,11
8185,levle3_85.jpg,fore,,,0,114,171,129,185,15,14
8186,levle3_85.jpg,fore,,,0,106,168,116,180,10,12
8187,levle3_85.jpg,fore,,,0,228,98,239,112,11,14
8188,levle3_85.jpg,fore,,,0,183,1,204,9,21,8
8189,levle3_85.jpg,fore,,,0,228,187,244,201,16,14
8190,levle3_85.jpg,fore,,,0,204,207,221,219,17,12
8191,levle3_85.jpg,fore,,,0,29,172,42,185,13,13
8192,levle3_85.jpg,fore,,,0,60,188,72,201,12,13
8193,levle3_85.jpg,fore,,,0,90,202,107,215,17,13
8194,levle3_85.jpg,fore,,,0,131,209,145,219,14,10
8195,levle3_85.jpg,fore,,,0,188,66,203,80,15,14
8196,levle2_2.jpg,fore,,,0,123,379,140,404,17,25
8197,levle2_2.jpg,fore,,,0,180,379,203,401,23,22
8198,levle2_2.jpg,fore,,,0,222,359,247,393,25,34
8199,levle2_2.jpg,fore,,,0,246,413,264,428,18,15
8200,levle2_2.jpg,fore,,,0,260,361,270,388,10,27
8201,levle2_2.jpg,fore,,,0,273,387,286,409,13,22
8202,levle2_2.jpg,fore,,,0,178,408,197,424,19,16
8203,levle2_2.jpg,fore,,,0,174,423,199,443,25,20
8204,levle2_2.jpg,fore,,,0,195,428,227,461,32,33
8205,levle2_2.jpg,fore,,,0,134,393,170,419,36,26
8206,levle2_2.jpg,fore,,,0,154,369,179,392,25,23
8207,levle2_2.jpg,fore,,,0,177,355,201,380,24,25
8208,levle2_2.jpg,fore,,,0,125,495,165,526,40,31
8209,levle2_2.jpg,fore,,,0,119,108,144,133,25,25
8210,levle2_2.jpg,fore,,,0,122,64,149,108,27,44
8211,levle2_2.jpg,fore,,,0,105,28,131,60,26,32
8212,levle2_2.jpg,fore,,,0,221,124,256,158,35,34
8213,levle2_2.jpg,fore,,,0,238,156,279,203,41,47
8214,levle2_2.jpg,fore,,,0,103,268,124,288,21,20
8215,levle2_2.jpg,fore,,,0,185,482,204,503,19,21
8216,levle2_2.jpg,fore,,,0,192,467,218,489,26,22
8217,levle1_449.jpg,fore,Unspecified,0.0,0,1773,374,1850,458,77,84
8218,levle1_449.jpg,fore,Unspecified,0.0,0,861,1133,968,1340,107,207
8219,levle1_449.jpg,fore,Unspecified,0.0,0,1122,1953,1267,2114,145,161
8220,levle1_449.jpg,fore,Unspecified,0.0,0,922,2006,1037,2160,115,154
8221,levle1_449.jpg,fore,Unspecified,0.0,0,754,2267,938,2382,184,115
8222,levle1_449.jpg,fore,Unspecified,0.0,0,869,2405,999,2596,130,191
8223,levle1_449.jpg,fore,Unspecified,0.0,0,1183,2175,1451,2389,268,214
8224,levle1_449.jpg,fore,Unspecified,0.0,0,1528,2941,1673,3094,145,153
8225,levle0_128.jpg,fore,Unspecified,0.0,0,2708,1723,2823,1914,115,191
8226,levle0_128.jpg,fore,Unspecified,0.0,0,2210,1524,2355,1631,145,107
8227,levle0_128.jpg,fore,Unspecified,0.0,0,2417,1669,2570,1868,153,199
8228,levle0_128.jpg,fore,Unspecified,0.0,0,2317,2175,2447,2290,130,115
8229,levle0_128.jpg,fore,Unspecified,0.0,0,2378,1876,2532,1983,154,107
8230,levle1_475.jpg,fore,Unspecified,0.0,0,1988,696,2148,834,160,138
8231,levle1_475.jpg,fore,Unspecified,0.0,0,1037,2374,1137,2481,100,107
8232,levle1_475.jpg,fore,Unspecified,0.0,0,1129,2428,1275,2573,146,145
8233,levle1_475.jpg,fore,Unspecified,0.0,0,907,2290,1022,2351,115,61
8234,levle1_475.jpg,fore,Unspecified,0.0,0,754,2420,930,2642,176,222
8235,levle1_475.jpg,fore,Unspecified,0.0,0,984,2527,1145,2765,161,238
8236,levle1_475.jpg,fore,Unspecified,0.0,0,1145,2658,1275,2842,130,184
8237,levle1_475.jpg,fore,Unspecified,0.0,0,1290,2512,1436,2711,146,199
8238,levle1_475.jpg,fore,Unspecified,0.0,0,838,2719,984,2895,146,176
8239,levle1_475.jpg,fore,Unspecified,0.0,0,1014,2987,1152,3117,138,130
8240,levle1_475.jpg,fore,Unspecified,0.0,0,1727,3048,1896,3202,169,154
8241,levle3_52.jpg,fore,,,0,152,35,195,80,43,45
8242,levle3_52.jpg,fore,,,0,201,8,260,67,59,59
8243,levle3_52.jpg,fore,,,0,164,133,205,184,41,51
8244,levle3_52.jpg,fore,,,0,350,288,401,320,51,32
8245,levle3_52.jpg,fore,,,0,264,451,330,504,66,53
8246,levle3_52.jpg,fore,,,0,228,553,283,598,55,45
8247,levle3_52.jpg,fore,,,0,146,524,179,575,33,51
8248,levle3_52.jpg,fore,,,0,175,596,222,641,47,45
8249,levle3_52.jpg,fore,,,0,62,412,113,463,51,51
8250,levle3_52.jpg,fore,,,0,181,263,281,296,100,33
8251,levle3_52.jpg,fore,,,0,173,208,213,243,40,35
8252,levle3_52.jpg,fore,,,0,58,302,95,343,37,41
8253,levle3_52.jpg,fore,,,0,109,426,162,488,53,62
8254,levle3_52.jpg,fore,,,0,330,302,368,349,38,47
8255,levle3_52.jpg,fore,,,0,360,332,389,373,29,41
8256,levle3_52.jpg,fore,,,0,248,412,299,437,51,25
8257,levle3_52.jpg,fore,,,0,324,404,360,463,36,59
8258,levle3_52.jpg,fore,,,0,364,398,381,445,17,47
8259,levle3_52.jpg,fore,,,0,338,481,385,526,47,45
8260,levle3_52.jpg,fore,,,0,315,518,342,559,27,41
8261,levle3_52.jpg,fore,,,0,230,500,291,551,61,51
8262,levle3_52.jpg,fore,,,0,322,133,360,192,38,59
8263,levle3_52.jpg,fore,,,0,368,137,395,190,27,53
8264,levle3_52.jpg,fore,,,0,368,49,413,114,45,65
8265,levle3_52.jpg,fore,,,0,297,102,336,141,39,39
8266,levle3_52.jpg,fore,,,0,262,151,277,171,15,20
8267,levle3_52.jpg,fore,,,0,222,180,283,224,61,44
8268,levle3_52.jpg,fore,,,0,277,2,352,75,75,73
8269,levle3_52.jpg,fore,,,0,164,163,181,180,17,17
8270,levle3_52.jpg,fore,,,0,109,104,160,153,51,49
8271,levle3_52.jpg,fore,,,0,354,226,424,277,70,51
8272,levle3_52.jpg,fore,,,0,133,497,177,529,44,32
8273,levle3_52.jpg,fore,,,0,193,436,224,472,31,36
8274,levle3_52.jpg,fore,,,0,244,365,281,395,37,30
8275,levle3_52.jpg,fore,,,0,182,318,223,354,41,36
8276,levle3_52.jpg,fore,,,0,260,309,299,342,39,33
8277,levle3_52.jpg,fore,,,0,303,268,340,294,37,26
8278,levle3_52.jpg,fore,,,0,301,187,341,216,40,29
8279,levle3_52.jpg,fore,,,0,173,104,210,140,37,36
8280,levle3_52.jpg,fore,,,0,206,119,240,153,34,34
8281,levle3_52.jpg,fore,,,0,245,122,272,161,27,39
8282,levle3_52.jpg,fore,,,0,62,482,105,515,43,33
8283,levle3_52.jpg,fore,,,0,171,507,211,535,40,28
8284,levle3_52.jpg,fore,,,0,176,540,220,571,44,31
8285,levle3_52.jpg,fore,,,0,277,560,313,588,36,28
8286,levle3_52.jpg,fore,,,0,283,518,318,564,35,46
8287,levle3_52.jpg,fore,,,0,388,448,425,477,37,29
8288,levle3_52.jpg,fore,,,0,404,417,439,451,35,34
8289,levle3_52.jpg,fore,,,0,387,349,429,392,42,43
8290,levle3_52.jpg,fore,,,0,264,220,299,274,35,54
8291,levle3_52.jpg,fore,,,0,289,149,318,177,29,28
8292,levle3_52.jpg,fore,,,0,1,585,29,619,28,34
8293,levle0_100.jpg,fore,Unspecified,0.0,0,2570,2075,2677,2206,107,131
8294,levle0_100.jpg,fore,Unspecified,0.0,0,2455,2451,2593,2627,138,176
8295,levle1_313.jpg,fore,Unspecified,0.0,0,1781,2259,1934,2397,153,138
8296,levle1_313.jpg,fore,Unspecified,0.0,0,1842,2543,2041,2635,199,92
8297,levle1_313.jpg,fore,Unspecified,0.0,0,2187,2535,2325,2673,138,138
8298,levle1_313.jpg,fore,Unspecified,0.0,0,2156,2412,2248,2504,92,92
8299,levle1_313.jpg,fore,Unspecified,0.0,0,2401,2259,2539,2397,138,138
8300,levle1_313.jpg,fore,Unspecified,0.0,0,1957,2052,2087,2221,130,169
8301,levle1_313.jpg,fore,Unspecified,0.0,0,2524,2497,2693,2665,169,168
8302,levle1_313.jpg,fore,Unspecified,0.0,0,1972,2964,2087,3110,115,146
8303,levle1_313.jpg,fore,Unspecified,0.0,0,2187,2857,2340,3010,153,153
8304,levle1_313.jpg,fore,Unspecified,0.0,0,1528,2872,1689,3033,161,161
8305,levle1_313.jpg,fore,Unspecified,0.0,0,1267,3041,1497,3232,230,191
8306,levle0_114.jpg,fore,Unspecified,0.0,0,930,2558,1076,2750,146,192
8307,levle0_114.jpg,fore,Unspecified,0.0,0,424,2098,555,2305,131,207
8308,levle0_114.jpg,fore,Unspecified,0.0,0,647,2282,761,2428,114,146
8309,levle1_307.jpg,fore,Unspecified,0.0,0,1037,2359,1168,2435,131,76
8310,levle1_307.jpg,fore,Unspecified,0.0,0,1014,2512,1137,2627,123,115
8311,levle1_307.jpg,fore,Unspecified,0.0,0,1551,2895,1643,3002,92,107
8312,levle1_307.jpg,fore,Unspecified,0.0,0,1758,1002,1834,1064,76,62
8313,levle1_307.jpg,fore,Unspecified,0.0,0,1620,727,1804,849,184,122
8314,levle1_307.jpg,fore,Unspecified,0.0,0,1474,834,1574,941,100,107
8315,levle3_46.jpg,fore,,,0,458,375,497,434,39,59
8316,levle3_46.jpg,fore,,,0,373,379,405,416,32,37
8317,levle3_46.jpg,fore,,,0,322,298,356,337,34,39
8318,levle3_46.jpg,fore,,,0,262,175,299,228,37,53
8319,levle3_46.jpg,fore,,,0,238,228,277,267,39,39
8320,levle3_46.jpg,fore,,,0,232,288,273,335,41,47
8321,levle3_46.jpg,fore,,,0,111,288,164,314,53,26
8322,levle3_46.jpg,fore,,,0,187,208,222,255,35,47
8323,levle3_46.jpg,fore,,,0,181,116,222,165,41,49
8324,levle3_46.jpg,fore,,,0,403,473,430,506,27,33
8325,levle3_46.jpg,fore,,,0,434,492,462,532,28,40
8326,levle3_46.jpg,fore,,,0,413,559,436,592,23,33
8327,levle3_46.jpg,fore,,,0,405,628,436,685,31,57
8328,levle3_46.jpg,fore,,,0,399,694,413,712,14,18
8329,levle3_46.jpg,fore,,,0,385,659,413,696,28,37
8330,levle3_46.jpg,fore,,,0,305,624,346,661,41,37
8331,levle3_46.jpg,fore,,,0,297,673,334,730,37,57
8332,levle3_46.jpg,fore,,,0,332,679,385,743,53,64
8333,levle3_46.jpg,fore,,,0,211,559,250,612,39,53
8334,levle3_46.jpg,fore,,,0,177,592,234,669,57,77
8335,levle3_46.jpg,fore,,,0,424,749,466,794,42,45
8336,levle3_46.jpg,fore,,,0,409,355,444,398,35,43
8337,levle3_46.jpg,fore,,,0,421,147,460,198,39,51
8338,levle3_46.jpg,fore,,,0,395,208,460,261,65,53
8339,levle3_46.jpg,fore,,,0,405,277,464,343,59,66
8340,levle3_46.jpg,fore,,,0,511,314,558,398,47,84
8341,levle3_46.jpg,fore,,,0,224,337,271,381,47,44
8342,levle3_46.jpg,fore,,,0,67,96,126,153,59,57
8343,levle3_46.jpg,fore,,,0,191,155,240,194,49,39
8344,levle3_46.jpg,fore,,,0,95,549,138,585,43,36
8345,levle3_46.jpg,fore,,,0,356,439,399,483,43,44
8346,levle3_46.jpg,fore,,,0,513,728,546,802,33,74
8347,levle3_46.jpg,fore,,,0,479,534,515,592,36,58
8348,levle3_46.jpg,fore,,,0,358,202,393,234,35,32
8349,levle3_46.jpg,fore,,,0,376,179,404,204,28,25
8350,levle3_46.jpg,fore,,,0,404,125,437,154,33,29
8351,levle3_46.jpg,fore,,,0,196,42,224,68,28,26
8352,levle3_46.jpg,fore,,,0,255,571,285,604,30,33
8353,levle3_46.jpg,fore,,,0,223,398,251,440,28,42
8354,levle3_46.jpg,fore,,,0,223,440,262,468,39,28
8355,levle3_46.jpg,fore,,,0,249,392,278,424,29,32
8356,levle3_46.jpg,fore,,,0,98,324,128,350,30,26
8357,levle3_46.jpg,fore,,,0,256,114,288,147,32,33
8358,levle3_46.jpg,fore,,,0,158,73,197,105,39,32
8359,levle3_46.jpg,fore,,,0,211,70,241,99,30,29
8360,levle3_46.jpg,fore,,,0,317,198,354,245,37,47
8361,levle3_46.jpg,fore,,,0,304,252,346,289,42,37
8362,levle3_46.jpg,fore,,,0,95,502,125,534,30,32
8363,levle3_46.jpg,fore,,,0,312,128,356,172,44,44
8364,levle3_46.jpg,fore,,,0,309,93,351,133,42,40
8365,levle3_46.jpg,fore,,,0,494,161,533,204,39,43
8366,levle3_46.jpg,fore,,,0,481,273,528,313,47,40
8367,levle3_46.jpg,fore,,,0,247,481,277,521,30,40
8368,levle3_46.jpg,fore,,,0,341,507,378,543,37,36
8369,levle3_46.jpg,fore,,,0,145,335,181,375,36,40
8370,levle3_46.jpg,fore,,,0,153,426,196,465,43,39
8371,levle3_46.jpg,fore,,,0,240,535,272,563,32,28
8372,levle3_46.jpg,fore,,,0,239,647,267,682,28,35
8373,levle1_461.jpg,fore,Unspecified,0.0,0,930,2351,1099,2527,169,176
8374,levle1_461.jpg,fore,Unspecified,0.0,0,286,1646,401,1769,115,123
8375,levle1_461.jpg,fore,Unspecified,0.0,0,401,1707,532,1830,131,123
8376,levle1_461.jpg,fore,Unspecified,0.0,0,378,2152,509,2259,131,107
8377,levle1_461.jpg,fore,Unspecified,0.0,0,325,2006,470,2137,145,131
8378,levle1_461.jpg,fore,Unspecified,0.0,0,95,1953,240,2068,145,115
8379,levle1_461.jpg,fore,Unspecified,0.0,0,570,2512,738,2750,168,238
8380,levle1_461.jpg,fore,Unspecified,0.0,0,616,2251,792,2458,176,207
8381,levle1_461.jpg,fore,Unspecified,0.0,0,784,2451,915,2627,131,176
8382,levle1_461.jpg,fore,Unspecified,0.0,0,945,589,1114,757,169,168
8383,levle1_461.jpg,fore,Unspecified,0.0,0,1451,650,1581,750,130,100
8384,levle1_461.jpg,fore,Unspecified,0.0,0,1735,1186,1880,1332,145,146
8385,levle1_461.jpg,fore,Unspecified,0.0,0,1842,918,2011,1163,169,245
8386,levle1_311.jpg,fore,Unspecified,0.0,0,1873,1891,2034,2037,161,146
8387,levle1_311.jpg,fore,Unspecified,0.0,0,1988,2267,2125,2451,137,184
8388,levle1_311.jpg,fore,Unspecified,0.0,0,2202,2198,2371,2336,169,138
8389,levle1_311.jpg,fore,Unspecified,0.0,0,2194,2305,2363,2443,169,138
8390,levle1_311.jpg,fore,Unspecified,0.0,0,2141,2642,2256,2750,115,108
8391,levle1_311.jpg,fore,Unspecified,0.0,0,2440,2075,2593,2229,153,154
8392,levle1_311.jpg,fore,Unspecified,0.0,0,1712,2688,1880,2819,168,131
8393,levle1_311.jpg,fore,Unspecified,0.0,0,1942,2872,2049,3025,107,153
8394,levle1_311.jpg,fore,Unspecified,0.0,0,2018,2796,2156,3002,138,206
8395,levle1_311.jpg,fore,Unspecified,0.0,0,1198,3048,1329,3140,131,92
8396,levle1_311.jpg,fore,Unspecified,0.0,0,1436,3225,1627,3340,191,115
8397,levle1_311.jpg,fore,Unspecified,0.0,0,2225,2865,2424,2949,199,84
8398,levle0_102.jpg,fore,Unspecified,0.0,0,1643,2267,1811,2397,168,130
8399,levle0_102.jpg,fore,Unspecified,0.0,0,1995,2144,2148,2274,153,130
8400,levle0_102.jpg,fore,Unspecified,0.0,0,2240,1677,2394,1861,154,184
8401,levle3_50.jpg,fore,,,0,273,90,295,121,22,31
8402,levle3_50.jpg,fore,,,0,155,119,177,138,22,19
8403,levle3_50.jpg,fore,,,0,164,142,180,164,16,22
8404,levle3_50.jpg,fore,,,0,212,59,244,78,32,19
8405,levle3_50.jpg,fore,,,0,187,76,211,106,24,30
8406,levle3_50.jpg,fore,,,0,175,64,194,99,19,35
8407,levle3_50.jpg,fore,,,0,317,171,338,196,21,25
8408,levle3_50.jpg,fore,,,0,295,183,313,205,18,22
8409,levle3_50.jpg,fore,,,0,258,158,279,185,21,27
8410,levle3_50.jpg,fore,,,0,331,225,350,248,19,23
8411,levle3_50.jpg,fore,,,0,368,226,387,255,19,29
8412,levle3_50.jpg,fore,,,0,277,247,301,271,24,24
8413,levle3_50.jpg,fore,,,0,252,310,273,329,21,19
8414,levle3_50.jpg,fore,,,0,302,359,325,379,23,20
8415,levle3_50.jpg,fore,,,0,289,385,307,411,18,26
8416,levle3_50.jpg,fore,,,0,351,351,383,374,32,23
8417,levle3_50.jpg,fore,,,0,279,383,293,400,14,17
8418,levle3_50.jpg,fore,,,0,213,328,238,356,25,28
8419,levle3_50.jpg,fore,,,0,153,285,181,312,28,27
8420,levle3_50.jpg,fore,,,0,63,264,99,292,36,28
8421,levle3_50.jpg,fore,,,0,108,319,136,346,28,27
8422,levle3_50.jpg,fore,,,0,123,102,141,118,18,16
8423,levle3_50.jpg,fore,,,0,221,98,248,125,27,27
8424,levle3_50.jpg,fore,,,0,255,126,277,148,22,22
8425,levle3_50.jpg,fore,,,0,225,28,261,51,36,23
8426,levle3_50.jpg,fore,,,0,284,61,317,88,33,27
8427,levle3_50.jpg,fore,,,0,340,163,361,187,21,24
8428,levle3_50.jpg,fore,,,0,307,207,328,232,21,25
8429,levle3_50.jpg,fore,,,0,318,278,349,301,31,23
8430,levle3_50.jpg,fore,,,0,407,190,425,221,18,31
8431,levle3_50.jpg,fore,,,0,276,331,300,353,24,22
8432,levle3_50.jpg,fore,,,0,254,360,276,390,22,30
8433,levle3_50.jpg,fore,,,0,336,373,349,386,13,13
8434,levle3_50.jpg,fore,,,0,323,398,330,405,7,7
8435,levle3_50.jpg,fore,,,0,308,374,332,402,24,28
8436,levle3_50.jpg,fore,,,0,150,313,177,337,27,24
8437,levle3_50.jpg,fore,,,0,134,199,152,224,18,25
8438,levle3_50.jpg,fore,,,0,190,154,214,184,24,30
8439,levle3_50.jpg,fore,,,0,223,139,243,157,20,18
8440,levle3_50.jpg,fore,,,0,192,109,211,129,19,20
8441,levle3_50.jpg,fore,,,0,301,312,319,329,18,17
8442,levle3_50.jpg,fore,,,0,260,393,278,408,18,15
8443,levle3_50.jpg,fore,,,0,66,296,92,313,26,17
8444,levle3_50.jpg,fore,,,0,300,89,322,110,22,21
8445,levle3_50.jpg,fore,,,0,329,56,357,83,28,27
8446,levle3_50.jpg,fore,,,0,275,220,299,244,24,24
8447,levle3_50.jpg,fore,,,0,345,116,369,145,24,29
8448,levle3_50.jpg,fore,,,0,278,23,299,45,21,22
8449,levle3_50.jpg,fore,,,0,239,83,270,105,31,22
8450,levle3_50.jpg,fore,,,0,273,5,300,26,27,21
8451,levle3_50.jpg,fore,,,0,320,349,345,371,25,22
8452,levle3_50.jpg,fore,,,0,304,253,327,280,23,27
8453,levle1_477.jpg,fore,Unspecified,0.0,0,1873,2719,2018,2834,145,115
8454,levle1_477.jpg,fore,Unspecified,0.0,0,2064,2397,2179,2497,115,100
8455,levle1_477.jpg,fore,Unspecified,0.0,0,2348,2343,2463,2489,115,146
8456,levle1_477.jpg,fore,Unspecified,0.0,0,1604,2313,1712,2489,108,176
8457,levle1_477.jpg,fore,Unspecified,0.0,0,1313,1301,1505,1508,192,207
8458,levle1_477.jpg,fore,Unspecified,0.0,0,2248,1064,2371,1278,123,214
8459,levle1_477.jpg,fore,Unspecified,0.0,0,1804,2412,1972,2527,168,115
8460,levle1_477.jpg,fore,Unspecified,0.0,0,1819,2527,2011,2604,192,77
8461,levle1_477.jpg,fore,Unspecified,0.0,0,1719,2382,1819,2512,100,130
8462,levle1_477.jpg,fore,Unspecified,0.0,0,2095,2504,2187,2612,92,108
8463,levle1_477.jpg,fore,Unspecified,0.0,0,1122,2934,1290,3110,168,176
8464,levle1_477.jpg,fore,Unspecified,0.0,0,1007,2979,1122,3079,115,100
8465,levle1_463.jpg,fore,Unspecified,0.0,0,1275,1999,1420,2106,145,107
8466,levle1_463.jpg,fore,Unspecified,0.0,0,1214,2964,1336,3079,122,115
8467,levle1_463.jpg,fore,Unspecified,0.0,0,1083,3010,1275,3163,192,153
8468,levle1_463.jpg,fore,Unspecified,0.0,0,2279,2727,2440,2880,161,153
8469,levle3_44.jpg,fore,,,0,367,281,404,313,37,32
8470,levle3_44.jpg,fore,,,0,354,253,384,276,30,23
8471,levle3_44.jpg,fore,,,0,342,313,356,344,14,31
8472,levle3_44.jpg,fore,,,0,310,278,332,311,22,33
8473,levle3_44.jpg,fore,,,0,294,262,310,288,16,26
8474,levle3_44.jpg,fore,,,0,258,276,278,303,20,27
8475,levle3_44.jpg,fore,,,0,171,341,196,355,25,14
8476,levle3_44.jpg,fore,,,0,293,350,314,371,21,21
8477,levle3_44.jpg,fore,,,0,271,363,291,388,20,25
8478,levle3_44.jpg,fore,,,0,372,370,395,393,23,23
8479,levle3_44.jpg,fore,,,0,389,335,412,371,23,36
8480,levle3_44.jpg,fore,,,0,405,370,422,394,17,24
8481,levle3_44.jpg,fore,,,0,272,115,301,147,29,32
8482,levle3_44.jpg,fore,,,0,324,113,351,142,27,29
8483,levle3_44.jpg,fore,,,0,318,16,348,55,30,39
8484,levle3_44.jpg,fore,,,0,405,103,424,128,19,25
8485,levle3_44.jpg,fore,,,0,439,123,462,150,23,27
8486,levle3_44.jpg,fore,,,0,358,16,397,57,39,41
8487,levle3_44.jpg,fore,,,0,359,5,384,23,25,18
8488,levle3_44.jpg,fore,,,0,352,137,387,162,35,25
8489,levle3_44.jpg,fore,,,0,333,168,357,204,24,36
8490,levle3_44.jpg,fore,,,0,268,220,299,254,31,34
8491,levle3_44.jpg,fore,,,0,276,189,299,222,23,33
8492,levle3_44.jpg,fore,,,0,464,171,487,201,23,30
8493,levle3_44.jpg,fore,,,0,252,170,281,204,29,34
8494,levle3_44.jpg,fore,,,0,225,164,252,195,27,31
8495,levle3_44.jpg,fore,,,0,209,140,237,167,28,27
8496,levle3_44.jpg,fore,,,0,185,56,203,84,18,28
8497,levle3_44.jpg,fore,,,0,199,60,236,89,37,29
8498,levle3_44.jpg,fore,,,0,184,162,207,191,23,29
8499,levle3_44.jpg,fore,,,0,198,187,225,210,27,23
8500,levle3_44.jpg,fore,,,0,231,206,250,227,19,21
8501,levle3_44.jpg,fore,,,0,251,227,274,261,23,34
8502,levle3_44.jpg,fore,,,0,214,271,240,297,26,26
8503,levle3_44.jpg,fore,,,0,213,241,244,275,31,34
8504,levle3_44.jpg,fore,,,0,125,223,162,265,37,42
8505,levle3_44.jpg,fore,,,0,264,331,289,359,25,28
8506,levle3_44.jpg,fore,,,0,416,32,451,66,35,34
8507,levle3_44.jpg,fore,,,0,93,264,124,300,31,36
8508,levle3_44.jpg,fore,,,0,166,100,192,128,26,28
8509,levle3_44.jpg,fore,,,0,259,32,283,57,24,25
8510,levle3_44.jpg,fore,,,0,325,62,360,93,35,31
8511,levle3_44.jpg,fore,,,0,351,54,380,84,29,30
8512,levle3_44.jpg,fore,,,0,394,3,422,23,28,20
8513,levle3_44.jpg,fore,,,0,219,327,261,361,42,34
8514,levle3_44.jpg,fore,,,0,135,291,159,315,24,24
8515,levle3_44.jpg,fore,,,0,137,319,160,345,23,26
8516,levle3_44.jpg,fore,,,0,432,212,455,236,23,24
8517,levle3_44.jpg,fore,,,0,454,213,476,236,22,23
8518,levle3_44.jpg,fore,,,0,391,75,421,100,30,25
8519,levle3_44.jpg,fore,,,0,373,108,399,136,26,28
8520,levle3_44.jpg,fore,,,0,282,169,317,196,35,27
8521,levle3_44.jpg,fore,,,0,318,145,349,169,31,24
8522,levle1_305.jpg,fore,Unspecified,0.0,0,532,696,647,826,115,130
8523,levle1_305.jpg,fore,Unspecified,0.0,0,217,1117,325,1240,108,123
8524,levle1_305.jpg,fore,Unspecified,0.0,0,401,1937,547,2129,146,192
8525,levle1_305.jpg,fore,Unspecified,0.0,0,171,1968,271,2106,100,138
8526,levle1_305.jpg,fore,Unspecified,0.0,0,715,2704,861,2903,146,199
8527,levle1_305.jpg,fore,Unspecified,0.0,0,1650,3033,1788,3202,138,169
8528,levle1_305.jpg,fore,Unspecified,0.0,0,1482,2780,1612,2911,130,131
8529,levle0_116.jpg,fore,Unspecified,0.0,0,1589,2911,1658,2995,69,84
8530,levle0_116.jpg,fore,Unspecified,0.0,0,1466,2351,1543,2420,77,69
8531,levle1_339.jpg,fore,Unspecified,0.0,0,1344,2642,1482,2788,138,146
8532,levle1_339.jpg,fore,Unspecified,0.0,0,1589,2704,1850,2888,261,184
8533,levle1_339.jpg,fore,Unspecified,0.0,0,1811,2964,1911,3071,100,107
8534,levle1_339.jpg,fore,Unspecified,0.0,0,1704,3064,1804,3163,100,99
8535,levle1_339.jpg,fore,Unspecified,0.0,0,1880,3079,1980,3194,100,115
8536,levle1_339.jpg,fore,Unspecified,0.0,0,2034,3087,2156,3209,122,122
8537,levle3_78.jpg,fore,,,0,192,199,204,208,12,9
8538,levle3_78.jpg,fore,,,0,46,366,71,381,25,15
8539,levle3_78.jpg,fore,,,0,134,390,149,408,15,18
8540,levle3_78.jpg,fore,,,0,137,371,151,385,14,14
8541,levle3_78.jpg,fore,,,0,160,373,171,387,11,14
8542,levle3_78.jpg,fore,,,0,171,369,185,381,14,12
8543,levle3_78.jpg,fore,,,0,150,357,159,368,9,11
8544,levle3_78.jpg,fore,,,0,163,343,177,353,14,10
8545,levle3_78.jpg,fore,,,0,141,337,153,356,12,19
8546,levle3_78.jpg,fore,,,0,128,320,141,333,13,13
8547,levle3_78.jpg,fore,,,0,147,310,160,334,13,24
8548,levle3_78.jpg,fore,,,0,130,308,141,316,11,8
8549,levle3_78.jpg,fore,,,0,161,300,177,317,16,17
8550,levle3_78.jpg,fore,,,0,167,316,183,333,16,17
8551,levle3_78.jpg,fore,,,0,160,275,181,292,21,17
8552,levle3_78.jpg,fore,,,0,142,265,159,281,17,16
8553,levle3_78.jpg,fore,,,0,119,261,143,275,24,14
8554,levle3_78.jpg,fore,,,0,128,250,140,257,12,7
8555,levle3_78.jpg,fore,,,0,143,228,160,241,17,13
8556,levle3_78.jpg,fore,,,0,109,240,122,256,13,16
8557,levle3_78.jpg,fore,,,0,184,269,199,291,15,22
8558,levle3_78.jpg,fore,,,0,193,246,212,257,19,11
8559,levle3_78.jpg,fore,,,0,218,249,231,262,13,13
8560,levle3_78.jpg,fore,,,0,200,258,217,274,17,16
8561,levle3_78.jpg,fore,,,0,203,273,224,284,21,11
8562,levle3_78.jpg,fore,,,0,198,286,217,303,19,17
8563,levle3_78.jpg,fore,,,0,180,299,207,324,27,25
8564,levle3_78.jpg,fore,,,0,171,246,190,257,19,11
8565,levle3_78.jpg,fore,,,0,178,209,193,228,15,19
8566,levle3_78.jpg,fore,,,0,199,212,213,227,14,15
8567,levle3_78.jpg,fore,,,0,202,224,219,242,17,18
8568,levle3_78.jpg,fore,,,0,211,196,229,212,18,16
8569,levle3_78.jpg,fore,,,0,214,185,238,201,24,16
8570,levle3_78.jpg,fore,,,0,207,174,231,192,24,18
8571,levle3_78.jpg,fore,,,0,190,170,213,192,23,22
8572,levle3_78.jpg,fore,,,0,185,151,210,170,25,19
8573,levle3_78.jpg,fore,,,0,192,132,215,145,23,13
8574,levle3_78.jpg,fore,,,0,196,119,219,129,23,10
8575,levle3_78.jpg,fore,,,0,206,143,228,168,22,25
8576,levle3_78.jpg,fore,,,0,154,137,178,145,24,8
8577,levle3_78.jpg,fore,,,0,136,83,169,110,33,27
8578,levle3_78.jpg,fore,,,0,148,116,170,134,22,18
8579,levle3_78.jpg,fore,,,0,89,104,114,123,25,19
8580,levle3_78.jpg,fore,,,0,87,81,112,105,25,24
8581,levle3_78.jpg,fore,,,0,106,67,129,84,23,17
8582,levle3_78.jpg,fore,,,0,143,64,166,83,23,19
8583,levle3_78.jpg,fore,,,0,65,164,89,182,24,18
8584,levle3_78.jpg,fore,,,0,62,145,83,163,21,18
8585,levle3_78.jpg,fore,,,0,109,301,125,315,16,14
8586,levle3_78.jpg,fore,,,0,66,297,81,310,15,13
8587,levle3_78.jpg,fore,,,0,85,361,97,372,12,11
8588,levle3_78.jpg,fore,,,0,78,405,92,419,14,14
8589,levle3_78.jpg,fore,,,0,119,372,132,390,13,18
8590,levle3_78.jpg,fore,,,0,109,401,123,413,14,12
8591,levle3_78.jpg,fore,,,0,185,367,203,384,18,17
8592,levle3_78.jpg,fore,,,0,213,332,227,346,14,14
8593,levle3_78.jpg,fore,,,0,208,348,220,363,12,15
8594,levle3_78.jpg,fore,,,0,243,293,255,307,12,14
8595,levle3_78.jpg,fore,,,0,52,86,68,99,16,13
8596,levle3_78.jpg,fore,,,0,117,285,131,302,14,17
8597,levle3_78.jpg,fore,,,0,135,296,152,308,17,12
8598,levle3_78.jpg,fore,,,0,157,247,169,259,12,12
8599,levle3_78.jpg,fore,,,0,162,260,178,273,16,13
8600,levle3_78.jpg,fore,,,0,224,263,237,280,13,17
8601,levle3_93.jpg,fore,Unspecified,0.0,0,1145,662,1253,787,108,125
8602,levle3_93.jpg,fore,Unspecified,0.0,0,1096,488,1253,571,157,83
8603,levle3_93.jpg,fore,Unspecified,0.0,0,1004,554,1112,670,108,116
8604,levle3_93.jpg,fore,Unspecified,0.0,0,813,646,963,779,150,133
8605,levle3_93.jpg,fore,Unspecified,0.0,0,771,828,921,945,150,117
8606,levle3_93.jpg,fore,Unspecified,0.0,0,722,1003,879,1169,157,166
8607,levle3_93.jpg,fore,Unspecified,0.0,0,963,970,1104,1119,141,149
8608,levle3_93.jpg,fore,Unspecified,0.0,0,1062,779,1270,953,208,174
8609,levle3_93.jpg,fore,Unspecified,0.0,0,1129,1153,1278,1302,149,149
8610,levle3_93.jpg,fore,Unspecified,0.0,0,1154,953,1270,1061,116,108
8611,levle3_93.jpg,fore,Unspecified,0.0,0,1436,1044,1553,1211,117,167
8612,levle3_93.jpg,fore,Unspecified,0.0,0,1278,1186,1445,1385,167,199
8613,levle3_93.jpg,fore,Unspecified,0.0,0,1420,1527,1536,1660,116,133
8614,levle3_93.jpg,fore,Unspecified,0.0,0,1428,1610,1594,1743,166,133
8615,levle3_93.jpg,fore,Unspecified,0.0,0,1686,1502,1860,1701,174,199
8616,levle3_93.jpg,fore,Unspecified,0.0,0,2367,1452,2467,1593,100,141
8617,levle3_93.jpg,fore,Unspecified,0.0,0,2434,1352,2583,1535,149,183
8618,levle3_93.jpg,fore,Unspecified,0.0,0,2459,1261,2700,1344,241,83
8619,levle3_93.jpg,fore,Unspecified,0.0,0,2500,1119,2675,1286,175,167
8620,levle3_93.jpg,fore,Unspecified,0.0,0,2899,1211,3157,1435,258,224
8621,levle3_93.jpg,fore,Unspecified,0.0,0,2733,1227,2874,1352,141,125
8622,levle3_93.jpg,fore,Unspecified,0.0,0,2542,1402,2716,1510,174,108
8623,levle3_93.jpg,fore,Unspecified,0.0,0,2375,1551,2550,1701,175,150
8624,levle3_93.jpg,fore,Unspecified,0.0,0,2716,1593,2866,1709,150,116
8625,levle3_93.jpg,fore,Unspecified,0.0,0,2467,1660,2708,1851,241,191
8626,levle3_93.jpg,fore,Unspecified,0.0,0,2874,1651,3074,1842,200,191
8627,levle3_93.jpg,fore,Unspecified,0.0,0,3032,1651,3223,1792,191,141
8628,levle3_93.jpg,fore,Unspecified,0.0,0,3215,1643,3365,1759,150,116
8629,levle3_93.jpg,fore,Unspecified,0.0,0,3281,1792,3423,1942,142,150
8630,levle3_93.jpg,fore,Unspecified,0.0,0,3423,1394,3606,1510,183,116
8631,levle3_93.jpg,fore,Unspecified,0.0,0,3489,1177,3672,1352,183,175
8632,levle3_93.jpg,fore,Unspecified,0.0,0,3356,920,3630,1194,274,274
8633,levle3_93.jpg,fore,Unspecified,0.0,0,3630,903,3822,1111,192,208
8634,levle3_93.jpg,fore,Unspecified,0.0,0,3157,936,3398,1128,241,192
8635,levle3_93.jpg,fore,Unspecified,0.0,0,3198,712,3423,911,225,199
8636,levle3_93.jpg,fore,Unspecified,0.0,0,4021,695,4221,887,200,192
8637,levle3_93.jpg,fore,Unspecified,0.0,0,4013,945,4146,1128,133,183
8638,levle3_93.jpg,fore,Unspecified,0.0,0,3763,1086,3988,1302,225,216
8639,levle3_93.jpg,fore,Unspecified,0.0,0,4013,1352,4179,1535,166,183
8640,levle3_93.jpg,fore,Unspecified,0.0,0,3655,1601,3913,1768,258,167
8641,levle3_93.jpg,fore,Unspecified,0.0,0,3581,1801,3772,1884,191,83
8642,levle3_93.jpg,fore,Unspecified,0.0,0,3672,1992,3830,2175,158,183
8643,levle3_93.jpg,fore,Unspecified,0.0,0,3448,2183,3664,2374,216,191
8644,levle3_93.jpg,fore,Unspecified,0.0,0,3497,1975,3689,2158,192,183
8645,levle3_93.jpg,fore,Unspecified,0.0,0,3157,2200,3340,2366,183,166
8646,levle3_93.jpg,fore,Unspecified,0.0,0,3830,1319,4029,1535,199,216
8647,levle3_93.jpg,fore,Unspecified,0.0,0,3664,1377,3830,1535,166,158
8648,levle3_93.jpg,fore,Unspecified,0.0,0,3298,1618,3473,1826,175,208
8649,levle3_93.jpg,fore,Unspecified,0.0,0,4046,1527,4287,1668,241,141
8650,levle3_93.jpg,fore,Unspecified,0.0,0,3980,1709,4246,1901,266,192
8651,levle3_93.jpg,fore,Unspecified,0.0,0,3855,2058,4004,2308,149,250
8652,levle3_93.jpg,fore,Unspecified,0.0,0,4021,2275,4179,2507,158,232
8653,levle3_93.jpg,fore,Unspecified,0.0,0,2517,1917,2666,2042,149,125
8654,levle3_93.jpg,fore,Unspecified,0.0,0,2700,1817,2907,2017,207,200
8655,levle3_93.jpg,fore,Unspecified,0.0,0,2816,2034,3040,2233,224,199
8656,levle3_93.jpg,fore,Unspecified,0.0,0,2783,1410,2957,1618,174,208
8657,levle3_93.jpg,fore,Unspecified,0.0,0,1827,1651,1977,1876,150,225
8658,levle3_93.jpg,fore,Unspecified,0.0,0,1985,1909,2143,2025,158,116
8659,levle3_93.jpg,fore,Unspecified,0.0,0,1569,1360,1769,1543,200,183
8660,levle3_93.jpg,fore,Unspecified,0.0,0,1337,1418,1536,1560,199,142
8661,levle3_93.jpg,fore,Unspecified,0.0,0,1478,1136,1702,1319,224,183
8662,levle2_0.jpg,fore,Unspecified,0.0,0,322,239,344,277,22,38
8663,levle2_0.jpg,fore,Unspecified,0.0,0,315,300,348,328,33,28
8664,levle2_0.jpg,fore,Unspecified,0.0,0,370,396,403,424,33,28
8665,levle2_0.jpg,fore,Unspecified,0.0,0,315,371,338,398,23,27
8666,levle2_0.jpg,fore,Unspecified,0.0,0,226,298,264,341,38,43
8667,levle2_0.jpg,fore,Unspecified,0.0,0,287,437,315,471,28,34
8668,levle2_0.jpg,fore,Unspecified,0.0,0,297,469,328,504,31,35
8669,levle2_0.jpg,fore,Unspecified,0.0,0,348,498,377,534,29,36
8670,levle2_0.jpg,fore,Unspecified,0.0,0,344,536,373,567,29,31
8671,levle2_0.jpg,fore,Unspecified,0.0,0,238,563,279,598,41,35
8672,levle2_0.jpg,fore,Unspecified,0.0,0,162,543,205,577,43,34
8673,levle2_0.jpg,fore,Unspecified,0.0,0,426,483,456,518,30,35
8674,levle2_0.jpg,fore,Unspecified,0.0,0,415,571,440,604,25,33
8675,levle2_0.jpg,fore,Unspecified,0.0,0,434,687,458,728,24,41
8676,levle2_0.jpg,fore,Unspecified,0.0,0,383,767,415,810,32,43
8677,levle2_0.jpg,fore,Unspecified,0.0,0,317,694,342,724,25,30
8678,levle2_0.jpg,fore,Unspecified,0.0,0,358,343,387,383,29,40
8679,levle2_0.jpg,fore,Unspecified,0.0,0,181,490,234,534,53,44
8680,levle2_0.jpg,fore,Unspecified,0.0,0,319,649,350,687,31,38
8681,levle2_0.jpg,fore,Unspecified,0.0,0,262,653,293,694,31,41
8682,levle2_0.jpg,fore,Unspecified,0.0,0,215,651,262,692,47,41
8683,levle2_0.jpg,fore,Unspecified,0.0,0,260,755,307,800,47,45
8684,levle2_0.jpg,fore,Unspecified,0.0,0,187,775,215,802,28,27
8685,levle2_0.jpg,fore,Unspecified,0.0,0,187,806,228,849,41,43
8686,levle2_0.jpg,fore,Unspecified,0.0,0,154,728,201,763,47,35
8687,levle2_0.jpg,fore,Unspecified,0.0,0,303,842,350,865,47,23
8688,levle3_87.jpg,fore,,,0,394,852,422,888,28,36
8689,levle3_87.jpg,fore,,,0,375,795,411,827,36,32
8690,levle3_87.jpg,fore,,,0,388,703,434,743,46,40
8691,levle3_87.jpg,fore,,,0,453,627,504,675,51,48
8692,levle3_87.jpg,fore,,,0,422,623,458,671,36,48
8693,levle3_87.jpg,fore,,,0,613,617,653,661,40,44
8694,levle3_87.jpg,fore,,,0,567,621,605,659,38,38
8695,levle3_87.jpg,fore,,,0,493,583,542,623,49,40
8696,levle3_87.jpg,fore,,,0,523,463,561,501,38,38
8697,levle3_87.jpg,fore,,,0,516,488,556,541,40,53
8698,levle3_87.jpg,fore,,,0,582,522,588,530,6,8
8699,levle3_87.jpg,fore,,,0,565,499,586,532,21,33
8700,levle3_87.jpg,fore,,,0,569,497,622,537,53,40
8701,levle3_87.jpg,fore,,,0,624,444,651,505,27,61
8702,levle3_87.jpg,fore,,,0,569,265,599,303,30,38
8703,levle3_87.jpg,fore,,,0,521,244,559,292,38,48
8704,levle3_87.jpg,fore,,,0,525,210,567,255,42,45
8705,levle3_87.jpg,fore,,,0,159,244,213,288,54,44
8706,levle3_87.jpg,fore,,,0,445,109,519,162,74,53
8707,levle3_87.jpg,fore,,,0,468,692,491,728,23,36
8708,levle3_87.jpg,fore,,,0,458,732,514,783,56,51
8709,levle3_87.jpg,fore,,,0,542,722,590,762,48,40
8710,levle3_87.jpg,fore,,,0,487,530,533,579,46,49
8711,levle3_87.jpg,fore,,,0,481,212,525,267,44,55
8712,levle3_87.jpg,fore,,,0,230,120,277,156,47,36
8713,levle3_87.jpg,fore,,,0,230,170,300,204,70,34
8714,levle3_87.jpg,fore,,,0,207,204,266,259,59,55
8715,levle3_87.jpg,fore,,,0,201,341,216,351,15,10
8716,levle3_87.jpg,fore,,,0,155,305,211,356,56,51
8717,levle3_87.jpg,fore,,,0,405,577,447,608,42,31
8718,levle3_87.jpg,fore,,,0,523,623,573,661,50,38
8719,levle3_87.jpg,fore,,,0,533,545,582,593,49,48
8720,levle3_87.jpg,fore,,,0,462,831,504,875,42,44
8721,levle3_87.jpg,fore,,,0,56,182,88,214,32,32
8722,levle3_87.jpg,fore,,,0,47,231,81,257,34,26
8723,levle3_87.jpg,fore,,,0,135,232,163,263,28,31
8724,levle3_87.jpg,fore,,,0,88,237,122,274,34,37
8725,levle3_87.jpg,fore,,,0,266,25,328,60,62,35
8726,levle3_87.jpg,fore,,,0,343,152,373,191,30,39
8727,levle3_87.jpg,fore,,,0,424,76,472,113,48,37
8728,levle3_87.jpg,fore,,,0,471,61,518,100,47,39
8729,levle3_87.jpg,fore,,,0,141,557,174,588,33,31
8730,levle3_87.jpg,fore,,,0,137,718,172,761,35,43
8731,levle3_87.jpg,fore,,,0,232,845,269,871,37,26
8732,levle3_87.jpg,fore,,,0,335,899,364,924,29,25
8733,levle3_87.jpg,fore,,,0,396,753,422,791,26,38
8734,levle3_87.jpg,fore,,,0,347,684,389,741,42,57
8735,levle3_87.jpg,fore,,,0,527,657,560,693,33,36
8736,levle3_87.jpg,fore,,,0,473,473,508,502,35,29
8737,levle3_87.jpg,fore,,,0,369,474,404,507,35,33
8738,levle3_87.jpg,fore,,,0,426,506,472,538,46,32
8739,levle3_87.jpg,fore,,,0,310,498,359,540,49,42
8740,levle3_87.jpg,fore,,,0,256,543,283,573,27,30
8741,levle3_87.jpg,fore,,,0,209,261,256,291,47,30
8742,levle3_87.jpg,fore,,,0,277,253,323,286,46,33
8743,levle1_488.jpg,fore,Unspecified,0.0,0,700,1478,815,1585,115,107
8744,levle1_488.jpg,fore,Unspecified,0.0,0,409,1646,516,1861,107,215
8745,levle1_488.jpg,fore,Unspecified,0.0,0,516,1715,654,1830,138,115
8746,levle1_488.jpg,fore,Unspecified,0.0,0,761,2175,907,2259,146,84
8747,levle1_488.jpg,fore,Unspecified,0.0,0,593,2274,692,2489,99,215
8748,levle1_488.jpg,fore,Unspecified,0.0,0,884,2259,1083,2405,199,146
8749,levle1_488.jpg,fore,Unspecified,0.0,0,846,2397,991,2474,145,77
8750,levle1_488.jpg,fore,Unspecified,0.0,0,876,2481,976,2558,100,77
8751,levle1_488.jpg,fore,Unspecified,0.0,0,1030,2497,1191,2566,161,69
8752,levle1_488.jpg,fore,Unspecified,0.0,0,1045,2581,1114,2696,69,115
8753,levle1_488.jpg,fore,Unspecified,0.0,0,1152,2566,1329,2696,177,130
8754,levle1_488.jpg,fore,Unspecified,0.0,0,1436,2244,1574,2405,138,161
8755,levle1_488.jpg,fore,Unspecified,0.0,0,1275,2198,1428,2336,153,138
8756,levle0_466.jpg,fore,Unspecified,0.0,0,991,2014,1283,2206,292,192
8757,levle0_300.jpg,fore,Unspecified,0.0,0,1528,2566,1712,2757,184,191
8758,levle1_113.jpg,fore,Unspecified,0.0,0,2633,1651,2783,1734,150,83
8759,levle1_113.jpg,fore,Unspecified,0.0,0,2525,1925,2691,2092,166,167
8760,levle1_113.jpg,fore,Unspecified,0.0,0,2675,2100,2799,2241,124,141
8761,levle1_113.jpg,fore,Unspecified,0.0,0,3015,1784,3123,1934,108,150
8762,levle1_113.jpg,fore,Unspecified,0.0,0,3439,1452,3572,1560,133,108
8763,levle1_113.jpg,fore,Unspecified,0.0,0,3506,1842,3614,2042,108,200
8764,levle1_113.jpg,fore,Unspecified,0.0,0,3240,1601,3365,1776,125,175
8765,levle1_113.jpg,fore,Unspecified,0.0,0,3157,1651,3290,1859,133,208
8766,levle0_314.jpg,fore,Unspecified,0.0,0,1597,2987,1704,3087,107,100
8767,levle0_314.jpg,fore,Unspecified,0.0,0,723,650,830,780,107,130
8768,levle1_107.jpg,fore,Unspecified,0.0,0,3215,1768,3365,1909,150,141
8769,levle1_107.jpg,fore,Unspecified,0.0,0,3082,2599,3182,2698,100,99
8770,levle1_107.jpg,fore,Unspecified,0.0,0,3290,2640,3398,2782,108,142
8771,levle1_107.jpg,fore,Unspecified,0.0,0,3514,2640,3622,2765,108,125
8772,levle1_107.jpg,fore,Unspecified,0.0,0,2675,770,2799,887,124,117
8773,levle1_107.jpg,fore,Unspecified,0.0,0,2824,662,2991,779,167,117
8774,levle1_107.jpg,fore,Unspecified,0.0,0,2658,978,2774,1094,116,116
8775,levle0_328.jpg,fore,Unspecified,0.0,0,2470,2121,2631,2343,161,222
8776,levle0_328.jpg,fore,Unspecified,0.0,0,1673,2926,1865,3110,192,184
8777,levle0_15.jpg,fore,Unspecified,0.0,0,1474,2688,1574,2765,100,77
8778,levle0_2.jpg,fore,Unspecified,0.0,0,2570,2313,2746,2474,176,161
8779,levle0_2.jpg,fore,Unspecified,0.0,0,2233,2842,2409,2979,176,137
8780,levle0_2.jpg,fore,Unspecified,0.0,0,2187,2979,2363,3133,176,154
8781,levle0_499.jpg,fore,Unspecified,0.0,0,1206,2972,1413,3148,207,176
8782,levle0_512.jpg,fore,Unspecified,0.0,0,2202,2106,2478,2351,276,245
8783,levle2_38.jpg,fore,,,0,2279,933,2447,1041,168,108
8784,levle2_38.jpg,fore,,,0,2463,1102,2608,1179,145,77
8785,levle2_38.jpg,fore,,,0,2493,1232,2624,1363,131,131
8786,levle2_38.jpg,fore,,,0,2501,1393,2685,1554,184,161
8787,levle2_38.jpg,fore,,,0,2363,1248,2509,1416,146,168
8788,levle2_38.jpg,fore,,,0,2248,1853,2432,2022,184,169
8789,levle2_38.jpg,fore,,,0,2279,1999,2417,2167,138,168
8790,levle2_38.jpg,fore,,,0,2486,2045,2631,2183,145,138
8791,levle2_38.jpg,fore,,,0,2463,2221,2631,2366,168,145
8792,levle2_38.jpg,fore,,,0,1765,2206,1903,2420,138,214
8793,levle2_38.jpg,fore,,,0,1911,2259,2064,2405,153,146
8794,levle2_38.jpg,fore,,,0,2095,2297,2217,2481,122,184
8795,levle2_38.jpg,fore,,,0,2187,2297,2355,2451,168,154
8796,levle2_38.jpg,fore,,,0,2079,2474,2248,2627,169,153
8797,levle2_38.jpg,fore,,,0,2624,1554,2769,1638,145,84
8798,levle2_38.jpg,fore,,,0,2601,1646,2769,1907,168,261
8799,levle2_38.jpg,fore,,,0,1804,872,1911,964,107,92
8800,levle2_38.jpg,fore,,,0,1214,819,1344,964,130,145
8801,levle2_38.jpg,fore,,,0,1451,366,1727,612,276,246
8802,levle2_38.jpg,fore,,,0,1313,359,1451,481,138,122
8803,levle2_38.jpg,fore,,,0,2371,746,2481,846,110,100
8804,levle0_274.jpg,fore,Unspecified,0.0,0,1198,711,1321,842,123,131
8805,levle0_274.jpg,fore,Unspecified,0.0,0,1965,1301,2072,1424,107,123
8806,levle0_260.jpg,fore,Unspecified,0.0,0,2953,2359,3106,2481,153,122
8807,levle0_506.jpg,fore,Unspecified,0.0,0,807,1638,1037,1807,230,169
8808,levle0_506.jpg,fore,Unspecified,0.0,0,2210,1018,2348,1179,138,161
8809,levle0_506.jpg,fore,Unspecified,0.0,0,2194,2596,2302,2727,108,131
8810,levle0_506.jpg,fore,Unspecified,0.0,0,991,3064,1076,3194,85,130
8811,levle0_506.jpg,fore,Unspecified,0.0,0,240,2589,394,2773,154,184
8812,levle0_248.jpg,fore,Unspecified,0.0,0,1014,2819,1175,2972,161,153
8813,levle0_248.jpg,fore,Unspecified,0.0,0,1068,2987,1267,3140,199,153
8814,levle2_10.jpg,fore,Unspecified,0.0,0,529,321,585,358,56,37
8815,levle2_10.jpg,fore,Unspecified,0.0,0,442,326,481,377,39,51
8816,levle2_10.jpg,fore,Unspecified,0.0,0,391,292,422,331,31,39
8817,levle2_10.jpg,fore,Unspecified,0.0,0,259,221,315,277,56,56
8818,levle2_10.jpg,fore,Unspecified,0.0,0,581,253,627,282,46,29
8819,levle2_10.jpg,fore,Unspecified,0.0,0,583,282,617,321,34,39
8820,levle2_10.jpg,fore,Unspecified,0.0,0,403,628,449,657,46,29
8821,levle2_10.jpg,fore,Unspecified,0.0,0,525,613,573,657,48,44
8822,levle2_10.jpg,fore,Unspecified,0.0,0,549,679,600,740,51,61
8823,levle2_10.jpg,fore,Unspecified,0.0,0,600,660,651,694,51,34
8824,levle2_10.jpg,fore,Unspecified,0.0,0,724,618,775,669,51,51
8825,levle2_10.jpg,fore,Unspecified,0.0,0,588,716,634,757,46,41
8826,levle2_10.jpg,fore,Unspecified,0.0,0,564,740,603,784,39,44
8827,levle2_10.jpg,fore,Unspecified,0.0,0,500,735,542,764,42,29
8828,levle2_10.jpg,fore,Unspecified,0.0,0,673,767,719,806,46,39
8829,levle2_10.jpg,fore,Unspecified,0.0,0,393,723,442,772,49,49
8830,levle2_10.jpg,fore,Unspecified,0.0,0,452,786,495,842,43,56
8831,levle2_10.jpg,fore,Unspecified,0.0,0,393,801,444,845,51,44
8832,levle2_10.jpg,fore,Unspecified,0.0,0,461,918,508,949,47,31
8833,levle2_10.jpg,fore,Unspecified,0.0,0,537,930,595,983,58,53
8834,levle2_10.jpg,fore,Unspecified,0.0,0,471,755,517,794,46,39
8835,levle2_10.jpg,fore,Unspecified,0.0,0,381,119,415,173,34,54
8836,levle2_10.jpg,fore,Unspecified,0.0,0,342,151,379,214,37,63
8837,levle2_10.jpg,fore,Unspecified,0.0,0,427,97,469,146,42,49
8838,levle2_167.jpg,fore,Unspecified,0.0,0,2394,2665,2440,2696,46,31
8839,levle2_167.jpg,fore,Unspecified,0.0,0,2194,2673,2317,2803,123,130
8840,levle2_167.jpg,fore,Unspecified,0.0,0,2187,2527,2263,2612,76,85
8841,levle2_167.jpg,fore,Unspecified,0.0,0,2279,2566,2432,2665,153,99
8842,levle2_167.jpg,fore,Unspecified,0.0,0,2432,2589,2578,2696,146,107
8843,levle2_167.jpg,fore,Unspecified,0.0,0,2386,2734,2524,2895,138,161
8844,levle2_167.jpg,fore,Unspecified,0.0,0,2148,2842,2348,2941,200,99
8845,levle2_167.jpg,fore,Unspecified,0.0,0,1865,2857,2011,2956,146,99
8846,levle2_167.jpg,fore,Unspecified,0.0,0,1934,2987,2095,3087,161,100
8847,levle2_167.jpg,fore,Unspecified,0.0,0,2011,2665,2148,2811,137,146
8848,levle2_167.jpg,fore,Unspecified,0.0,0,1811,2535,1949,2658,138,123
8849,levle2_167.jpg,fore,Unspecified,0.0,0,1934,2405,2110,2581,176,176
8850,levle2_167.jpg,fore,Unspecified,0.0,0,2156,2389,2279,2489,123,100
8851,levle2_167.jpg,fore,Unspecified,0.0,0,2179,2221,2317,2374,138,153
8852,levle2_167.jpg,fore,Unspecified,0.0,0,2041,2137,2141,2198,100,61
8853,levle2_167.jpg,fore,Unspecified,0.0,0,2148,1907,2294,2052,146,145
8854,levle2_167.jpg,fore,Unspecified,0.0,0,2501,1684,2624,1799,123,115
8855,levle2_167.jpg,fore,Unspecified,0.0,0,2555,1232,2693,1378,138,146
8856,levle2_167.jpg,fore,Unspecified,0.0,0,2325,1163,2539,1355,214,192
8857,levle2_167.jpg,fore,Unspecified,0.0,0,2302,1018,2470,1148,168,130
8858,levle2_167.jpg,fore,Unspecified,0.0,0,2325,627,2455,734,130,107
8859,levle2_167.jpg,fore,Unspecified,0.0,0,1965,313,2102,451,137,138
8860,levle2_173.jpg,fore,Unspecified,0.0,0,2202,681,2325,826,123,145
8861,levle2_173.jpg,fore,Unspecified,0.0,0,1267,834,1436,895,169,61
8862,levle2_173.jpg,fore,Unspecified,0.0,0,271,1700,424,1830,153,130
8863,levle2_173.jpg,fore,Unspecified,0.0,0,509,1746,624,1876,115,130
8864,levle2_173.jpg,fore,Unspecified,0.0,0,692,2037,876,2198,184,161
8865,levle2_173.jpg,fore,Unspecified,0.0,0,830,2198,938,2313,108,115
8866,levle2_173.jpg,fore,Unspecified,0.0,0,570,2274,685,2389,115,115
8867,levle2_173.jpg,fore,Unspecified,0.0,0,409,2229,562,2374,153,145
8868,levle2_173.jpg,fore,Unspecified,0.0,0,217,2297,371,2405,154,108
8869,levle2_173.jpg,fore,Unspecified,0.0,0,532,2596,608,2688,76,92
8870,levle2_173.jpg,fore,Unspecified,0.0,0,624,2543,754,2658,130,115
8871,levle2_173.jpg,fore,Unspecified,0.0,0,746,2803,846,2872,100,69
8872,levle2_173.jpg,fore,Unspecified,0.0,0,838,2750,991,2895,153,145
8873,levle2_173.jpg,fore,Unspecified,0.0,0,1283,2742,1420,2803,137,61
8874,levle2_173.jpg,fore,Unspecified,0.0,0,1397,2612,1551,2696,154,84
8875,levle2_173.jpg,fore,Unspecified,0.0,0,662,2888,792,3010,130,122
8876,levle2_173.jpg,fore,Unspecified,0.0,0,807,2888,915,3018,108,130
8877,levle2_173.jpg,fore,Unspecified,0.0,0,440,2934,692,3156,252,222
8878,levle2_173.jpg,fore,Unspecified,0.0,0,692,3117,938,3340,246,223
8879,levle2_173.jpg,fore,Unspecified,0.0,0,1068,910,1168,1148,100,238
8880,levle2_173.jpg,fore,Unspecified,0.0,0,1145,857,1359,1079,214,222
8881,levle1_265.jpg,fore,Unspecified,0.0,0,2463,1836,2542,1915,79,79
8882,levle1_265.jpg,fore,Unspecified,0.0,0,2542,1266,2682,1397,140,131
8883,levle1_265.jpg,fore,Unspecified,0.0,0,2463,1275,2516,1345,53,70
8884,levle1_265.jpg,fore,Unspecified,0.0,0,2533,1573,2603,1652,70,79
8885,levle1_265.jpg,fore,Unspecified,0.0,0,2402,1196,2481,1283,79,87
8886,levle1_265.jpg,fore,Unspecified,0.0,0,2463,1915,2603,2011,140,96
8887,levle1_55.jpg,fore,Unspecified,0.0,0,164,2052,302,2190,138,138
8888,levle1_55.jpg,fore,Unspecified,0.0,0,302,2152,378,2305,76,153
8889,levle1_55.jpg,fore,Unspecified,0.0,0,501,2481,654,2558,153,77
8890,levle1_55.jpg,fore,Unspecified,0.0,0,562,2619,708,2765,146,146
8891,levle1_55.jpg,fore,Unspecified,0.0,0,823,2497,1007,2619,184,122
8892,levle1_55.jpg,fore,Unspecified,0.0,0,938,2627,1106,2727,168,100
8893,levle1_55.jpg,fore,Unspecified,0.0,0,869,2734,976,2834,107,100
8894,levle1_55.jpg,fore,Unspecified,0.0,0,991,2895,1175,3033,184,138
8895,levle1_55.jpg,fore,Unspecified,0.0,0,1604,2865,1742,2964,138,99
8896,levle1_503.jpg,fore,Unspecified,0.0,0,1206,903,1375,1048,169,145
8897,levle1_503.jpg,fore,Unspecified,0.0,0,1535,504,1719,627,184,123
8898,levle1_503.jpg,fore,Unspecified,0.0,0,2210,1232,2386,1378,176,146
8899,levle1_503.jpg,fore,Unspecified,0.0,0,2248,842,2401,949,153,107
8900,levle1_503.jpg,fore,Unspecified,0.0,0,2248,2428,2371,2535,123,107
8901,levle1_503.jpg,fore,Unspecified,0.0,0,2202,2520,2340,2642,138,122
8902,levle1_503.jpg,fore,Unspecified,0.0,0,1850,2673,1942,2788,92,115
8903,levle1_503.jpg,fore,Unspecified,0.0,0,1834,3018,1957,3225,123,207
8904,levle1_41.jpg,fore,Unspecified,0.0,0,1850,2075,1957,2206,107,131
8905,levle1_41.jpg,fore,Unspecified,0.0,0,1620,1922,1804,2075,184,153
8906,levle1_41.jpg,fore,Unspecified,0.0,0,2034,1822,2125,1914,91,92
8907,levle1_41.jpg,fore,Unspecified,0.0,0,1696,2305,1811,2420,115,115
8908,levle1_41.jpg,fore,Unspecified,0.0,0,1566,2297,1727,2451,161,154
8909,levle1_41.jpg,fore,Unspecified,0.0,0,1436,2206,1604,2374,168,168
8910,levle1_41.jpg,fore,Unspecified,0.0,0,1099,2213,1260,2374,161,161
8911,levle1_41.jpg,fore,Unspecified,0.0,0,976,2374,1122,2474,146,100
8912,levle1_41.jpg,fore,Unspecified,0.0,0,1060,2504,1191,2642,131,138
8913,levle1_41.jpg,fore,Unspecified,0.0,0,1206,2397,1390,2566,184,169
8914,levle1_41.jpg,fore,Unspecified,0.0,0,1298,2604,1420,2734,122,130
8915,levle1_517.jpg,fore,Unspecified,0.0,0,761,1232,930,1393,169,161
8916,levle1_517.jpg,fore,Unspecified,0.0,0,968,995,1106,1148,138,153
8917,levle1_517.jpg,fore,Unspecified,0.0,0,853,1853,1037,2052,184,199
8918,levle1_517.jpg,fore,Unspecified,0.0,0,624,1631,800,1807,176,176
8919,levle1_517.jpg,fore,Unspecified,0.0,0,792,2190,922,2336,130,146
8920,levle1_517.jpg,fore,Unspecified,0.0,0,654,2696,807,2849,153,153
8921,levle1_517.jpg,fore,Unspecified,0.0,0,692,2566,838,2665,146,99
8922,levle1_517.jpg,fore,Unspecified,0.0,0,892,2888,1030,3064,138,176
8923,levle1_517.jpg,fore,Unspecified,0.0,0,302,2366,447,2497,145,131
8924,levle1_271.jpg,fore,Unspecified,0.0,0,1873,2389,1949,2535,76,146
8925,levle1_271.jpg,fore,Unspecified,0.0,0,2164,1922,2302,2052,138,130
8926,levle1_271.jpg,fore,Unspecified,0.0,0,2670,1815,2830,1930,160,115
8927,levle1_271.jpg,fore,Unspecified,0.0,0,2570,2075,2662,2221,92,146
8928,levle1_271.jpg,fore,Unspecified,0.0,0,2501,1853,2631,1999,130,146
8929,levle1_271.jpg,fore,Unspecified,0.0,0,2486,1424,2570,1539,84,115
8930,levle1_271.jpg,fore,Unspecified,0.0,0,2585,1547,2708,1692,123,145
8931,levle1_271.jpg,fore,Unspecified,0.0,0,2164,1447,2340,1562,176,115
8932,levle1_259.jpg,fore,Unspecified,0.0,0,2998,889,3112,1011,114,122
8933,levle1_259.jpg,fore,Unspecified,0.0,0,3358,1950,3446,2038,88,88
8934,levle1_259.jpg,fore,Unspecified,0.0,0,3419,2090,3489,2178,70,88
8935,levle1_259.jpg,fore,Unspecified,0.0,0,3691,2134,3788,2222,97,88
8936,levle1_259.jpg,fore,Unspecified,0.0,0,3849,1590,3963,1722,114,132
8937,levle1_259.jpg,fore,Unspecified,0.0,0,3744,1669,3849,1783,105,114
8938,levle1_259.jpg,fore,Unspecified,0.0,0,3709,1906,3867,2020,158,114
8939,levle1_69.jpg,fore,Unspecified,0.0,0,1129,1018,1275,1140,146,122
8940,levle1_69.jpg,fore,Unspecified,0.0,0,1099,1148,1267,1271,168,123
8941,levle1_69.jpg,fore,Unspecified,0.0,0,1443,665,1558,834,115,169
8942,levle1_69.jpg,fore,Unspecified,0.0,0,616,1968,746,2114,130,146
8943,levle1_69.jpg,fore,Unspecified,0.0,0,807,2213,892,2359,85,146
8944,levle1_69.jpg,fore,Unspecified,0.0,0,838,2405,945,2520,107,115
8945,levle1_69.jpg,fore,Unspecified,0.0,0,1275,2297,1428,2397,153,100
8946,levle1_69.jpg,fore,Unspecified,0.0,0,1520,2320,1635,2389,115,69
8947,levle1_69.jpg,fore,Unspecified,0.0,0,1451,2405,1589,2550,138,145
8948,levle1_96.jpg,fore,Unspecified,0.0,0,1677,1693,1852,1884,175,191
8949,levle1_96.jpg,fore,Unspecified,0.0,0,2467,1759,2633,1925,166,166
8950,levle1_96.jpg,fore,Unspecified,0.0,0,2267,1809,2417,1967,150,158
8951,levle1_96.jpg,fore,Unspecified,0.0,0,2417,2424,2608,2615,191,191
8952,levle1_96.jpg,fore,Unspecified,0.0,0,3190,2524,3315,2698,125,174
8953,levle1_96.jpg,fore,Unspecified,0.0,0,3323,2532,3439,2673,116,141
8954,levle1_82.jpg,fore,Unspecified,0.0,0,2417,2233,2575,2474,158,241
8955,levle1_82.jpg,fore,Unspecified,0.0,0,2242,2075,2417,2283,175,208
8956,levle1_82.jpg,fore,Unspecified,0.0,0,2924,2457,3132,2640,208,183
8957,levle1_82.jpg,fore,Unspecified,0.0,0,2384,1103,2508,1236,124,133
8958,levle1_82.jpg,fore,Unspecified,0.0,0,2434,1227,2592,1369,158,142
8959,levle1_82.jpg,fore,Unspecified,0.0,0,2442,911,2583,1069,141,158
8960,levle1_82.jpg,fore,Unspecified,0.0,0,2226,1003,2359,1161,133,158
8961,levle1_82.jpg,fore,Unspecified,0.0,0,3074,1169,3298,1394,224,225
8962,levle1_82.jpg,fore,Unspecified,0.0,0,2741,1227,2874,1385,133,158
8963,levle1_82.jpg,fore,Unspecified,0.0,0,2666,1402,2974,1709,308,307
8964,levle1_82.jpg,fore,Unspecified,0.0,0,1835,2075,2026,2333,191,258
8965,levle1_83.jpg,fore,Unspecified,0.0,0,2916,2333,3057,2499,141,166
8966,levle1_83.jpg,fore,Unspecified,0.0,0,2292,2225,2417,2366,125,141
8967,levle1_83.jpg,fore,Unspecified,0.0,0,2400,2017,2567,2183,167,166
8968,levle1_83.jpg,fore,Unspecified,0.0,0,2616,2167,2716,2308,100,141
8969,levle1_83.jpg,fore,Unspecified,0.0,0,2525,2324,2633,2474,108,150
8970,levle1_83.jpg,fore,Unspecified,0.0,0,2650,2449,2733,2565,83,116
8971,levle1_83.jpg,fore,Unspecified,0.0,0,2741,2856,2858,3031,117,175
8972,levle1_83.jpg,fore,Unspecified,0.0,0,2641,2017,2783,2150,142,133
8973,levle1_83.jpg,fore,Unspecified,0.0,0,2874,1144,3015,1277,141,133
8974,levle1_83.jpg,fore,Unspecified,0.0,0,2949,911,3123,1069,174,158
8975,levle1_83.jpg,fore,Unspecified,0.0,0,3024,1169,3190,1327,166,158
8976,levle1_83.jpg,fore,Unspecified,0.0,0,3215,1028,3373,1177,158,149
8977,levle1_97.jpg,fore,Unspecified,0.0,0,2916,562,3107,779,191,217
8978,levle1_97.jpg,fore,Unspecified,0.0,0,3265,770,3398,928,133,158
8979,levle1_97.jpg,fore,Unspecified,0.0,0,2542,2291,2691,2432,149,141
8980,levle1_97.jpg,fore,Unspecified,0.0,0,2193,1925,2351,2083,158,158
8981,levle1_97.jpg,fore,Unspecified,0.0,0,2434,2507,2558,2673,124,166
8982,levle1_97.jpg,fore,Unspecified,0.0,0,2101,2607,2226,2715,125,108
8983,levle1_258.jpg,fore,Unspecified,0.0,0,1954,1239,2060,1327,106,88
8984,levle1_258.jpg,fore,Unspecified,0.0,0,2981,932,3130,1047,149,115
8985,levle1_258.jpg,fore,Unspecified,0.0,0,2086,1608,2191,1722,105,114
8986,levle1_258.jpg,fore,Unspecified,0.0,0,2332,2029,2437,2204,105,175
8987,levle1_258.jpg,fore,Unspecified,0.0,0,2156,1994,2270,2125,114,131
8988,levle1_258.jpg,fore,Unspecified,0.0,0,2516,1959,2682,2073,166,114
8989,levle1_258.jpg,fore,Unspecified,0.0,0,2551,2064,2674,2178,123,114
8990,levle1_258.jpg,fore,Unspecified,0.0,0,2279,2301,2367,2432,88,131
8991,levle1_68.jpg,fore,Unspecified,0.0,0,2340,2244,2493,2397,153,153
8992,levle1_68.jpg,fore,Unspecified,0.0,0,2118,2336,2233,2451,115,115
8993,levle1_68.jpg,fore,Unspecified,0.0,0,1451,2972,1620,3148,169,176
8994,levle1_68.jpg,fore,Unspecified,0.0,0,1237,1033,1405,1202,168,169
8995,levle1_68.jpg,fore,Unspecified,0.0,0,1152,1186,1275,1340,123,154
8996,levle1_68.jpg,fore,Unspecified,0.0,0,1367,650,1489,757,122,107
8997,levle1_68.jpg,fore,Unspecified,0.0,0,1352,336,1489,520,137,184
8998,levle1_68.jpg,fore,Unspecified,0.0,0,2424,1248,2585,1432,161,184
8999,levle1_516.jpg,fore,Unspecified,0.0,0,2302,849,2447,1010,145,161
9000,levle1_516.jpg,fore,Unspecified,0.0,0,1942,535,2133,765,191,230
9001,levle1_516.jpg,fore,Unspecified,0.0,0,2501,1225,2693,1447,192,222
9002,levle1_516.jpg,fore,Unspecified,0.0,0,2194,1179,2348,1332,154,153
9003,levle1_516.jpg,fore,Unspecified,0.0,0,1459,2060,1581,2198,122,138
9004,levle1_516.jpg,fore,Unspecified,0.0,0,1658,2389,1834,2504,176,115
9005,levle1_516.jpg,fore,Unspecified,0.0,0,1873,2934,2057,3064,184,130
9006,levle1_516.jpg,fore,Unspecified,0.0,0,2348,2627,2463,2765,115,138
9007,levle1_516.jpg,fore,Unspecified,0.0,0,2133,2872,2240,3010,107,138
9008,levle1_516.jpg,fore,Unspecified,0.0,0,2332,2773,2478,2872,146,99
9009,levle1_516.jpg,fore,Unspecified,0.0,0,2271,2895,2348,2972,77,77
9010,levle1_516.jpg,fore,Unspecified,0.0,0,2685,2658,2861,2811,176,153
9011,levle1_40.jpg,fore,Unspecified,0.0,0,1152,2251,1290,2366,138,115
9012,levle1_40.jpg,fore,Unspecified,0.0,0,1306,2336,1505,2520,199,184
9013,levle1_40.jpg,fore,Unspecified,0.0,0,1030,2642,1229,2819,199,177
9014,levle1_40.jpg,fore,Unspecified,0.0,0,1045,2520,1168,2665,123,145
9015,levle1_40.jpg,fore,Unspecified,0.0,0,991,2428,1076,2512,85,84
9016,levle1_40.jpg,fore,Unspecified,0.0,0,1007,2229,1129,2389,122,160
9017,levle1_40.jpg,fore,Unspecified,0.0,0,823,2236,976,2428,153,192
9018,levle1_40.jpg,fore,Unspecified,0.0,0,1321,1960,1413,2114,92,154
9019,levle1_40.jpg,fore,Unspecified,0.0,0,1543,2183,1727,2328,184,145
9020,levle1_40.jpg,fore,Unspecified,0.0,0,1060,1002,1214,1232,154,230
9021,levle1_270.jpg,fore,Unspecified,0.0,0,2011,757,2125,880,114,123
9022,levle1_270.jpg,fore,Unspecified,0.0,0,1834,872,1988,1071,154,199
9023,levle1_270.jpg,fore,Unspecified,0.0,0,2034,918,2133,1079,99,161
9024,levle1_270.jpg,fore,Unspecified,0.0,0,1313,2045,1428,2190,115,145
9025,levle1_270.jpg,fore,Unspecified,0.0,0,1765,2121,1926,2351,161,230
9026,levle1_270.jpg,fore,Unspecified,0.0,0,463,2765,601,2918,138,153
9027,levle1_270.jpg,fore,Unspecified,0.0,0,892,3094,1053,3301,161,207
9028,levle1_264.jpg,fore,Unspecified,0.0,0,1805,1108,1858,1204,53,96
9029,levle1_264.jpg,fore,Unspecified,0.0,0,1911,1073,1981,1161,70,88
9030,levle1_264.jpg,fore,Unspecified,0.0,0,2410,1011,2542,1108,132,97
9031,levle1_264.jpg,fore,Unspecified,0.0,0,2332,1959,2454,2073,122,114
9032,levle1_264.jpg,fore,Unspecified,0.0,0,2472,1915,2560,2003,88,88
9033,levle1_264.jpg,fore,Unspecified,0.0,0,2542,1985,2665,2108,123,123
9034,levle1_264.jpg,fore,Unspecified,0.0,0,2744,1818,2840,1897,96,79
9035,levle1_264.jpg,fore,Unspecified,0.0,0,2218,2389,2349,2529,131,140
9036,levle1_502.jpg,fore,Unspecified,0.0,0,1650,2926,1704,2995,54,69
9037,levle1_502.jpg,fore,Unspecified,0.0,0,1727,2979,1796,3025,69,46
9038,levle1_502.jpg,fore,Unspecified,0.0,0,1750,3064,1865,3194,115,130
9039,levle1_502.jpg,fore,Unspecified,0.0,0,1482,3163,1604,3263,122,100
9040,levle1_502.jpg,fore,Unspecified,0.0,0,1704,3324,1834,3455,130,131
9041,levle1_502.jpg,fore,Unspecified,0.0,0,1857,3340,1949,3455,92,115
9042,levle1_502.jpg,fore,Unspecified,0.0,0,1972,3248,2125,3432,153,184
9043,levle1_54.jpg,fore,Unspecified,0.0,0,332,2045,486,2098,154,53
9044,levle1_54.jpg,fore,Unspecified,0.0,0,340,2098,463,2213,123,115
9045,levle1_54.jpg,fore,Unspecified,0.0,0,470,2190,570,2343,100,153
9046,levle1_54.jpg,fore,Unspecified,0.0,0,654,2497,761,2581,107,84
9047,levle1_54.jpg,fore,Unspecified,0.0,0,738,2673,846,2842,108,169
9048,levle1_54.jpg,fore,Unspecified,0.0,0,1152,2934,1183,2979,31,45
9049,levle1_54.jpg,fore,Unspecified,0.0,0,1145,3018,1260,3079,115,61
9050,levle1_54.jpg,fore,Unspecified,0.0,0,746,2972,861,3102,115,130
9051,levle1_54.jpg,fore,Unspecified,0.0,0,1704,2972,1804,3117,100,145
9052,levle2_172.jpg,fore,Unspecified,0.0,0,2440,895,2631,1064,191,169
9053,levle2_172.jpg,fore,Unspecified,0.0,0,2371,1186,2516,1317,145,131
9054,levle2_172.jpg,fore,Unspecified,0.0,0,2463,1332,2585,1493,122,161
9055,levle2_172.jpg,fore,Unspecified,0.0,0,2102,1194,2202,1324,100,130
9056,levle2_172.jpg,fore,Unspecified,0.0,0,2102,543,2279,673,177,130
9057,levle2_172.jpg,fore,Unspecified,0.0,0,2662,1286,2784,1416,122,130
9058,levle2_172.jpg,fore,Unspecified,0.0,0,2700,1776,2830,1907,130,131
9059,levle2_172.jpg,fore,Unspecified,0.0,0,2562,1853,2731,2006,169,153
9060,levle2_172.jpg,fore,Unspecified,0.0,0,2647,2029,2762,2106,115,77
9061,levle2_172.jpg,fore,Unspecified,0.0,0,2662,2129,2731,2198,69,69
9062,levle2_172.jpg,fore,Unspecified,0.0,0,2555,2075,2639,2229,84,154
9063,levle2_172.jpg,fore,Unspecified,0.0,0,2263,2251,2394,2389,131,138
9064,levle2_172.jpg,fore,Unspecified,0.0,0,2440,2290,2562,2435,122,145
9065,levle2_172.jpg,fore,Unspecified,0.0,0,2248,2512,2355,2573,107,61
9066,levle2_172.jpg,fore,Unspecified,0.0,0,2263,2573,2447,2642,184,69
9067,levle2_172.jpg,fore,Unspecified,0.0,0,2233,2612,2447,2742,214,130
9068,levle2_172.jpg,fore,Unspecified,0.0,0,2064,2474,2210,2619,146,145
9069,levle2_172.jpg,fore,Unspecified,0.0,0,2171,2757,2317,2826,146,69
9070,levle2_172.jpg,fore,Unspecified,0.0,0,2233,2811,2363,2888,130,77
9071,levle2_172.jpg,fore,Unspecified,0.0,0,2171,2903,2325,2979,154,76
9072,levle2_172.jpg,fore,Unspecified,0.0,0,2509,2788,2677,2918,168,130
9073,levle2_172.jpg,fore,Unspecified,0.0,0,2700,2773,2815,2865,115,92
9074,levle2_172.jpg,fore,Unspecified,0.0,0,2516,2956,2647,3033,131,77
9075,levle2_172.jpg,fore,Unspecified,0.0,0,2409,3002,2539,3087,130,85
9076,levle2_172.jpg,fore,Unspecified,0.0,0,2332,3010,2432,3148,100,138
9077,levle2_172.jpg,fore,Unspecified,0.0,0,1949,3148,2102,3340,153,192
9078,levle2_172.jpg,fore,Unspecified,0.0,0,2440,2451,2547,2589,107,138
9079,levle2_166.jpg,fore,Unspecified,0.0,0,547,1286,631,1516,84,230
9080,levle2_166.jpg,fore,Unspecified,0.0,0,440,1064,578,1186,138,122
9081,levle2_166.jpg,fore,Unspecified,0.0,0,692,1133,838,1332,146,199
9082,levle2_166.jpg,fore,Unspecified,0.0,0,562,903,700,1041,138,138
9083,levle2_166.jpg,fore,Unspecified,0.0,0,394,1715,539,1891,145,176
9084,levle2_166.jpg,fore,Unspecified,0.0,0,539,1684,662,1830,123,146
9085,levle2_166.jpg,fore,Unspecified,0.0,0,470,1845,624,2029,154,184
9086,levle2_166.jpg,fore,Unspecified,0.0,0,440,2022,624,2206,184,184
9087,levle2_166.jpg,fore,Unspecified,0.0,0,639,1815,815,1968,176,153
9088,levle2_166.jpg,fore,Unspecified,0.0,0,784,1891,930,2037,146,146
9089,levle2_166.jpg,fore,Unspecified,0.0,0,692,2091,800,2297,108,206
9090,levle2_166.jpg,fore,Unspecified,0.0,0,792,2083,899,2221,107,138
9091,levle2_166.jpg,fore,Unspecified,0.0,0,899,2244,1022,2428,123,184
9092,levle2_166.jpg,fore,Unspecified,0.0,0,1022,2198,1145,2359,123,161
9093,levle2_166.jpg,fore,Unspecified,0.0,0,1175,2198,1336,2336,161,138
9094,levle2_166.jpg,fore,Unspecified,0.0,0,1206,2366,1375,2527,169,161
9095,levle2_166.jpg,fore,Unspecified,0.0,0,1076,2420,1191,2512,115,92
9096,levle2_166.jpg,fore,Unspecified,0.0,0,968,2458,1137,2589,169,131
9097,levle2_166.jpg,fore,Unspecified,0.0,0,1083,2581,1252,2673,169,92
9098,levle2_166.jpg,fore,Unspecified,0.0,0,1045,2681,1191,2834,146,153
9099,levle2_166.jpg,fore,Unspecified,0.0,0,1229,2819,1382,2934,153,115
9100,levle2_166.jpg,fore,Unspecified,0.0,0,1298,2987,1390,3110,92,123
9101,levle2_166.jpg,fore,Unspecified,0.0,0,1390,3110,1428,3186,38,76
9102,levle2_166.jpg,fore,Unspecified,0.0,0,1091,2872,1244,2956,153,84
9103,levle2_166.jpg,fore,Unspecified,0.0,0,1030,2941,1137,3064,107,123
9104,levle2_166.jpg,fore,Unspecified,0.0,0,853,3002,961,3117,108,115
9105,levle2_166.jpg,fore,Unspecified,0.0,0,647,2911,807,3048,160,137
9106,levle2_166.jpg,fore,Unspecified,0.0,0,601,2727,746,2842,145,115
9107,levle2_166.jpg,fore,Unspecified,0.0,0,2003,1884,2102,2045,99,161
9108,levle2_166.jpg,fore,Unspecified,0.0,0,2148,1945,2309,2121,161,176
9109,levle2_11.jpg,fore,Unspecified,0.0,0,68,35,91,58,23,23
9110,levle2_11.jpg,fore,Unspecified,0.0,0,74,61,101,89,27,28
9111,levle2_11.jpg,fore,Unspecified,0.0,0,98,14,118,44,20,30
9112,levle2_11.jpg,fore,Unspecified,0.0,0,125,40,151,69,26,29
9113,levle2_11.jpg,fore,Unspecified,0.0,0,166,67,188,87,22,20
9114,levle2_11.jpg,fore,Unspecified,0.0,0,47,51,71,80,24,29
9115,levle2_11.jpg,fore,Unspecified,0.0,0,175,227,199,251,24,24
9116,levle2_11.jpg,fore,Unspecified,0.0,0,97,354,122,372,25,18
9117,levle2_11.jpg,fore,Unspecified,0.0,0,85,465,100,487,15,22
9118,levle2_11.jpg,fore,Unspecified,0.0,0,115,482,129,507,14,25
9119,levle2_11.jpg,fore,Unspecified,0.0,0,134,476,148,500,14,24
9120,levle2_11.jpg,fore,Unspecified,0.0,0,157,495,172,519,15,24
9121,levle2_11.jpg,fore,Unspecified,0.0,0,155,465,166,486,11,21
9122,levle2_11.jpg,fore,Unspecified,0.0,0,206,422,233,448,27,26
9123,levle2_11.jpg,fore,Unspecified,0.0,0,219,454,242,484,23,30
9124,levle2_11.jpg,fore,Unspecified,0.0,0,184,471,199,498,15,27
9125,levle2_11.jpg,fore,Unspecified,0.0,0,105,515,118,533,13,18
9126,levle2_11.jpg,fore,Unspecified,0.0,0,121,536,144,556,23,20
9127,levle2_11.jpg,fore,Unspecified,0.0,0,31,428,53,455,22,27
9128,levle2_11.jpg,fore,Unspecified,0.0,0,137,435,169,465,32,30
9129,levle2_11.jpg,fore,Unspecified,0.0,0,107,422,133,443,26,21
9130,levle2_11.jpg,fore,Unspecified,0.0,0,40,299,61,327,21,28
9131,levle2_11.jpg,fore,Unspecified,0.0,0,65,316,89,343,24,27
9132,levle2_11.jpg,fore,Unspecified,0.0,0,18,244,40,266,22,22
9133,levle2_11.jpg,fore,Unspecified,0.0,0,65,139,86,174,21,35
9134,levle2_11.jpg,fore,Unspecified,0.0,0,91,202,130,246,39,44
9135,levle2_11.jpg,fore,Unspecified,0.0,0,155,210,179,230,24,20
9136,levle2_11.jpg,fore,Unspecified,0.0,0,61,266,83,298,22,32
9137,levle2_11.jpg,fore,Unspecified,0.0,0,87,282,118,307,31,25
9138,levle2_11.jpg,fore,Unspecified,0.0,0,168,334,205,378,37,44
9139,levle2_11.jpg,fore,Unspecified,0.0,0,216,307,244,336,28,29
9140,levle2_11.jpg,fore,Unspecified,0.0,0,118,389,137,421,19,32
9141,levle2_11.jpg,fore,Unspecified,0.0,0,54,388,86,418,32,30
9142,levle2_11.jpg,fore,Unspecified,0.0,0,85,428,118,453,33,25
9143,levle2_11.jpg,fore,Unspecified,0.0,0,186,516,216,552,30,36
9144,levle0_249.jpg,fore,Unspecified,0.0,0,1834,3033,1988,3225,154,192
9145,levle0_261.jpg,fore,Unspecified,0.0,0,1643,2872,1781,3033,138,161
9146,levle0_261.jpg,fore,Unspecified,0.0,0,1336,3010,1397,3156,61,146
9147,levle0_261.jpg,fore,Unspecified,0.0,0,2003,420,2087,535,84,115
9148,levle0_507.jpg,fore,Unspecified,0.0,0,830,1232,1068,1462,238,230
9149,levle0_513.jpg,fore,Unspecified,0.0,0,2570,2106,2769,2274,199,168
9150,levle0_275.jpg,fore,Unspecified,0.0,0,1827,3163,1988,3355,161,192
9151,levle0_275.jpg,fore,Unspecified,0.0,0,2486,2366,2677,2543,191,177
9152,levle2_39.jpg,fore,Unspecified,0.0,0,1689,834,1758,933,69,99
9153,levle2_39.jpg,fore,Unspecified,0.0,0,1750,673,1919,727,169,54
9154,levle2_39.jpg,fore,Unspecified,0.0,0,1949,374,2072,535,123,161
9155,levle2_39.jpg,fore,Unspecified,0.0,0,2110,642,2302,826,192,184
9156,levle2_39.jpg,fore,Unspecified,0.0,0,2026,865,2187,995,161,130
9157,levle2_39.jpg,fore,Unspecified,0.0,0,631,1286,807,1424,176,138
9158,levle2_39.jpg,fore,Unspecified,0.0,0,593,1117,746,1202,153,85
9159,levle2_39.jpg,fore,Unspecified,0.0,0,486,918,616,1033,130,115
9160,levle2_39.jpg,fore,Unspecified,0.0,0,593,995,685,1087,92,92
9161,levle2_39.jpg,fore,Unspecified,0.0,0,754,543,899,711,145,168
9162,levle2_39.jpg,fore,Unspecified,0.0,0,455,1301,593,1432,138,131
9163,levle2_39.jpg,fore,Unspecified,0.0,0,309,1409,493,1554,184,145
9164,levle2_39.jpg,fore,Unspecified,0.0,0,371,1547,532,1715,161,168
9165,levle2_39.jpg,fore,Unspecified,0.0,0,509,1501,624,1631,115,130
9166,levle2_39.jpg,fore,Unspecified,0.0,0,516,1600,654,1761,138,161
9167,levle2_39.jpg,fore,Unspecified,0.0,0,386,1692,532,1884,146,192
9168,levle2_39.jpg,fore,Unspecified,0.0,0,532,1830,654,1945,122,115
9169,levle2_39.jpg,fore,Unspecified,0.0,0,570,1914,692,2037,122,123
9170,levle2_39.jpg,fore,Unspecified,0.0,0,363,2160,470,2297,107,137
9171,levle2_39.jpg,fore,Unspecified,0.0,0,470,2160,601,2274,131,114
9172,levle2_39.jpg,fore,Unspecified,0.0,0,516,2221,624,2374,108,153
9173,levle2_39.jpg,fore,Unspecified,0.0,0,624,2251,807,2405,183,154
9174,levle2_39.jpg,fore,Unspecified,0.0,0,1283,2221,1413,2343,130,122
9175,levle2_39.jpg,fore,Unspecified,0.0,0,784,2343,915,2466,131,123
9176,levle2_39.jpg,fore,Unspecified,0.0,0,654,2566,823,2681,169,115
9177,levle2_39.jpg,fore,Unspecified,0.0,0,470,2704,647,2865,177,161
9178,levle2_39.jpg,fore,Unspecified,0.0,0,1612,2443,1765,2573,153,130
9179,levle2_39.jpg,fore,Unspecified,0.0,0,1681,2803,1827,3025,146,222
9180,levle2_39.jpg,fore,Unspecified,0.0,0,1827,2803,2087,3002,260,199
9181,levle2_39.jpg,fore,Unspecified,0.0,0,1489,535,1558,635,69,100
9182,levle2_39.jpg,fore,Unspecified,0.0,0,1558,727,1712,903,154,176
9183,levle2_39.jpg,fore,Unspecified,0.0,0,1037,1845,1198,2075,161,230
9184,levle0_498.jpg,fore,Unspecified,0.0,0,1129,3171,1237,3278,108,107
9185,levle0_3.jpg,fore,Unspecified,0.0,0,140,264,171,302,31,38
9186,levle0_3.jpg,fore,Unspecified,0.0,0,142,327,176,371,34,44
9187,levle0_3.jpg,fore,Unspecified,0.0,0,264,528,291,554,27,26
9188,levle0_329.jpg,fore,Unspecified,0.0,0,2631,1845,2784,2006,153,161
9189,levle0_14.jpg,fore,Unspecified,0.0,0,283,368,302,396,19,28
9190,levle1_106.jpg,fore,Unspecified,0.0,0,3232,1061,3373,1244,141,183
9191,levle1_106.jpg,fore,Unspecified,0.0,0,3198,787,3281,928,83,141
9192,levle1_106.jpg,fore,Unspecified,0.0,0,2999,870,3132,986,133,116
9193,levle1_106.jpg,fore,Unspecified,0.0,0,3015,1111,3165,1244,150,133
9194,levle1_106.jpg,fore,Unspecified,0.0,0,3099,970,3223,1136,124,166
9195,levle1_106.jpg,fore,Unspecified,0.0,0,2351,2690,2500,2840,149,150
9196,levle1_106.jpg,fore,Unspecified,0.0,0,2542,2773,2733,2981,191,208
9197,levle0_315.jpg,fore,Unspecified,0.0,0,2578,2022,2739,2175,161,153
9198,levle0_315.jpg,fore,Unspecified,0.0,0,1888,3071,2018,3202,130,131
9199,levle0_473.jpg,fore,Unspecified,0.0,0,386,2267,532,2443,146,176
9200,levle0_473.jpg,fore,Unspecified,0.0,0,340,3041,486,3194,146,153
9201,levle0_473.jpg,fore,Unspecified,0.0,0,1014,2336,1183,2489,169,153
9202,levle0_473.jpg,fore,Unspecified,0.0,0,1689,3010,1827,3148,138,138
9203,levle0_28.jpg,fore,Unspecified,0.0,0,1880,3071,2041,3217,161,146
9204,levle0_467.jpg,fore,Unspecified,0.0,0,884,1600,1068,1784,184,184
9205,levle0_467.jpg,fore,Unspecified,0.0,0,1152,2060,1313,2251,161,191
9206,levle1_112.jpg,fore,Unspecified,0.0,0,2434,2167,2542,2275,108,108
9207,levle1_112.jpg,fore,Unspecified,0.0,0,2384,2025,2467,2133,83,108
9208,levle1_112.jpg,fore,Unspecified,0.0,0,2650,2299,2758,2449,108,150
9209,levle1_112.jpg,fore,Unspecified,0.0,0,2517,2632,2608,2790,91,158
9210,levle1_112.jpg,fore,Unspecified,0.0,0,2741,2590,2849,2723,108,133
9211,levle1_112.jpg,fore,Unspecified,0.0,0,2417,2491,2525,2632,108,141
9212,levle1_112.jpg,fore,Unspecified,0.0,0,2600,2507,2675,2590,75,83
9213,levle1_112.jpg,fore,Unspecified,0.0,0,2392,2682,2508,2765,116,83
9214,levle1_112.jpg,fore,Unspecified,0.0,0,2309,2565,2375,2690,66,125
9215,levle0_301.jpg,fore,Unspecified,0.0,0,1535,2075,1658,2221,123,146
9216,levle1_489.jpg,fore,Unspecified,0.0,0,409,1462,509,1562,100,100
9217,levle1_489.jpg,fore,Unspecified,0.0,0,233,1799,340,1907,107,108
9218,levle1_489.jpg,fore,Unspecified,0.0,0,386,1746,486,1815,100,69
9219,levle1_489.jpg,fore,Unspecified,0.0,0,409,1899,562,2037,153,138
9220,levle1_489.jpg,fore,Unspecified,0.0,0,486,2198,662,2282,176,84
9221,levle1_489.jpg,fore,Unspecified,0.0,0,417,2274,593,2443,176,169
9222,levle1_489.jpg,fore,Unspecified,0.0,0,654,2236,784,2328,130,92
9223,levle1_489.jpg,fore,Unspecified,0.0,0,631,2328,784,2428,153,100
9224,levle1_489.jpg,fore,Unspecified,0.0,0,624,2435,708,2612,84,177
9225,levle1_489.jpg,fore,Unspecified,0.0,0,754,2466,884,2535,130,69
9226,levle1_489.jpg,fore,Unspecified,0.0,0,853,2504,1014,2673,161,169
9227,levle1_489.jpg,fore,Unspecified,0.0,0,1022,2144,1183,2274,161,130
9228,levle1_489.jpg,fore,Unspecified,0.0,0,1007,2351,1191,2527,184,176
9229,levle2_1.jpg,fore,Unspecified,0.0,0,351,123,376,139,25,16
9230,levle2_1.jpg,fore,Unspecified,0.0,0,393,130,408,146,15,16
9231,levle2_1.jpg,fore,Unspecified,0.0,0,393,146,407,160,14,14
9232,levle2_1.jpg,fore,Unspecified,0.0,0,357,178,378,198,21,20
9233,levle2_1.jpg,fore,Unspecified,0.0,0,337,73,360,94,23,21
9234,levle2_1.jpg,fore,Unspecified,0.0,0,364,39,385,64,21,25
9235,levle2_1.jpg,fore,Unspecified,0.0,0,204,340,221,355,17,15
9236,levle2_1.jpg,fore,Unspecified,0.0,0,191,344,204,359,13,15
9237,levle2_1.jpg,fore,Unspecified,0.0,0,208,358,220,382,12,24
9238,levle2_1.jpg,fore,Unspecified,0.0,0,235,396,251,410,16,14
9239,levle2_1.jpg,fore,Unspecified,0.0,0,222,400,236,418,14,18
9240,levle2_1.jpg,fore,Unspecified,0.0,0,213,389,225,405,12,16
9241,levle2_1.jpg,fore,Unspecified,0.0,0,188,383,203,400,15,17
9242,levle2_1.jpg,fore,Unspecified,0.0,0,180,404,201,421,21,17
9243,levle2_1.jpg,fore,Unspecified,0.0,0,207,421,229,435,22,14
9244,levle2_1.jpg,fore,Unspecified,0.0,0,180,436,192,458,12,22
9245,levle2_1.jpg,fore,Unspecified,0.0,0,249,469,268,490,19,21
9246,levle2_1.jpg,fore,Unspecified,0.0,0,218,467,239,487,21,20
9247,levle2_1.jpg,fore,Unspecified,0.0,0,239,486,264,508,25,22
9248,levle2_1.jpg,fore,Unspecified,0.0,0,165,346,183,367,18,21
9249,levle2_1.jpg,fore,Unspecified,0.0,0,151,345,165,366,14,21
9250,levle2_1.jpg,fore,Unspecified,0.0,0,130,331,149,352,19,21
9251,levle2_1.jpg,fore,Unspecified,0.0,0,147,362,157,379,10,17
9252,levle2_1.jpg,fore,Unspecified,0.0,0,170,369,188,380,18,11
9253,levle2_1.jpg,fore,Unspecified,0.0,0,165,376,190,393,25,17
9254,levle2_1.jpg,fore,Unspecified,0.0,0,151,383,169,405,18,22
9255,levle2_1.jpg,fore,Unspecified,0.0,0,286,284,300,303,14,19
9256,levle2_1.jpg,fore,Unspecified,0.0,0,200,302,218,319,18,17
9257,levle2_1.jpg,fore,Unspecified,0.0,0,191,320,208,333,17,13
9258,levle2_1.jpg,fore,Unspecified,0.0,0,222,362,235,374,13,12
9259,levle2_1.jpg,fore,Unspecified,0.0,0,223,376,240,391,17,15
9260,levle2_1.jpg,fore,Unspecified,0.0,0,290,396,311,419,21,23
9261,levle3_86.jpg,fore,,,0,191,72,202,83,11,11
9262,levle3_86.jpg,fore,,,0,176,66,190,75,14,9
9263,levle3_86.jpg,fore,,,0,185,103,198,114,13,11
9264,levle3_86.jpg,fore,,,0,153,64,167,81,14,17
9265,levle3_86.jpg,fore,,,0,133,65,139,71,6,6
9266,levle3_86.jpg,fore,,,0,111,88,122,97,11,9
9267,levle3_86.jpg,fore,,,0,120,110,132,123,12,13
9268,levle3_86.jpg,fore,,,0,144,101,160,111,16,10
9269,levle3_86.jpg,fore,,,0,169,145,183,158,14,13
9270,levle3_86.jpg,fore,,,0,194,118,203,129,9,11
9271,levle3_86.jpg,fore,,,0,108,137,118,148,10,11
9272,levle3_86.jpg,fore,,,0,177,36,193,51,16,15
9273,levle3_86.jpg,fore,,,0,240,49,250,62,10,13
9274,levle3_86.jpg,fore,,,0,238,73,252,88,14,15
9275,levle3_86.jpg,fore,,,0,227,66,242,81,15,15
9276,levle3_86.jpg,fore,,,0,216,85,240,102,24,17
9277,levle3_86.jpg,fore,,,0,217,73,227,84,10,11
9278,levle3_86.jpg,fore,,,0,203,73,216,85,13,12
9279,levle3_86.jpg,fore,,,0,182,79,194,93,12,14
9280,levle3_86.jpg,fore,,,0,158,81,172,91,14,10
9281,levle3_86.jpg,fore,,,0,186,53,196,66,10,13
9282,levle3_86.jpg,fore,,,0,158,32,168,42,10,10
9283,levle3_86.jpg,fore,,,0,151,41,165,53,14,12
9284,levle3_86.jpg,fore,,,0,163,44,177,59,14,15
9285,levle3_86.jpg,fore,,,0,139,39,154,55,15,16
9286,levle3_86.jpg,fore,,,0,119,32,134,45,15,13
9287,levle3_86.jpg,fore,,,0,139,63,154,79,15,16
9288,levle3_86.jpg,fore,,,0,109,63,126,75,17,12
9289,levle3_86.jpg,fore,,,0,115,79,128,89,13,10
9290,levle3_86.jpg,fore,,,0,146,89,167,102,21,13
9291,levle3_86.jpg,fore,,,0,115,99,131,112,16,13
9292,levle3_86.jpg,fore,,,0,94,95,109,103,15,8
9293,levle3_86.jpg,fore,,,0,95,115,113,131,18,16
9294,levle3_86.jpg,fore,,,0,126,141,143,159,17,18
9295,levle3_86.jpg,fore,,,0,144,126,164,140,20,14
9296,levle3_86.jpg,fore,,,0,169,114,190,129,21,15
9297,levle3_86.jpg,fore,,,0,209,138,223,151,14,13
9298,levle3_86.jpg,fore,,,0,219,150,228,160,9,10
9299,levle3_86.jpg,fore,,,0,196,158,212,171,16,13
9300,levle3_86.jpg,fore,,,0,198,167,211,186,13,19
9301,levle3_86.jpg,fore,,,0,242,94,262,110,20,16
9302,levle3_86.jpg,fore,,,0,62,83,73,93,11,10
9303,levle3_86.jpg,fore,,,0,74,109,85,116,11,7
9304,levle3_86.jpg,fore,,,0,83,67,93,74,10,7
9305,levle3_86.jpg,fore,,,0,98,59,107,69,9,10
9306,levle3_86.jpg,fore,,,0,100,77,110,86,10,9
9307,levle3_86.jpg,fore,,,0,224,171,234,181,10,10
9308,levle3_86.jpg,fore,,,0,216,178,227,192,11,14
9309,levle3_86.jpg,fore,,,0,228,160,239,171,11,11
9310,levle3_86.jpg,fore,,,0,202,89,212,97,10,8
9311,levle3_86.jpg,fore,,,0,196,60,210,71,14,11
9312,levle3_86.jpg,fore,,,0,223,51,236,62,13,11
9313,levle3_86.jpg,fore,,,0,236,30,250,42,14,12
9314,levle3_92.jpg,fore,,,0,1827,1011,1960,1153,133,142
9315,levle3_92.jpg,fore,,,0,2259,2117,2434,2324,175,207
9316,levle3_92.jpg,fore,,,0,3414,1028,3589,1227,175,199
9317,levle3_92.jpg,fore,,,0,3298,612,3497,961,199,349
9318,levle3_92.jpg,fore,,,0,1827,670,2026,812,199,142
9319,levle3_92.jpg,fore,,,0,1968,945,2193,1153,225,208
9320,levle3_92.jpg,fore,,,0,2126,1028,2284,1194,158,166
9321,levle3_92.jpg,fore,,,0,3074,488,3406,687,332,199
9322,levle3_92.jpg,fore,,,0,2550,945,2882,1194,332,249
9323,levle3_92.jpg,fore,,,0,3065,936,3365,1186,300,250
9324,levle3_92.jpg,fore,,,0,3132,1177,3240,1302,108,125
9325,levle3_92.jpg,fore,,,0,3040,1277,3207,1443,167,166
9326,levle3_92.jpg,fore,,,0,2866,1418,3049,1568,183,150
9327,levle3_92.jpg,fore,,,0,2716,1394,2907,1660,191,266
9328,levle3_92.jpg,fore,,,0,2126,1876,2384,2058,258,182
9329,levle3_92.jpg,fore,,,0,2110,1768,2326,1934,216,166
9330,levle3_92.jpg,fore,,,0,1877,1776,2126,1942,249,166
9331,levle3_92.jpg,fore,,,0,1677,2000,1910,2258,233,258
9332,levle3_92.jpg,fore,,,0,1827,2083,2093,2316,266,233
9333,levle3_92.jpg,fore,,,0,2076,2150,2259,2391,183,241
9334,levle3_92.jpg,fore,,,0,1669,2798,1860,2998,191,200
9335,levle3_92.jpg,fore,,,0,2267,2416,2392,2640,125,224
9336,levle3_92.jpg,fore,,,0,2359,1975,2608,2208,249,233
9337,levle3_92.jpg,fore,,,0,2858,2150,3032,2474,174,324
9338,levle3_92.jpg,fore,,,0,3040,2241,3207,2424,167,183
9339,levle3_92.jpg,fore,,,0,2924,2025,3207,2225,283,200
9340,levle3_92.jpg,fore,,,0,2924,1792,3140,1984,216,192
9341,levle3_92.jpg,fore,,,0,3240,1992,3473,2183,233,191
9342,levle3_92.jpg,fore,,,0,3148,1726,3373,1925,225,199
9343,levle3_92.jpg,fore,,,0,3240,1593,3389,1718,149,125
9344,levle3_92.jpg,fore,,,0,3340,1768,3539,1959,199,191
9345,levle3_92.jpg,fore,,,0,3497,1618,3797,1784,300,166
9346,levle3_92.jpg,fore,,,0,3572,1435,3730,1560,158,125
9347,levle3_92.jpg,fore,,,0,3207,1335,3456,1568,249,233
9348,levle3_92.jpg,fore,,,0,3481,1227,3630,1418,149,191
9349,levle3_92.jpg,fore,,,0,1734,206,1858,326,124,120
9350,levle3_92.jpg,fore,,,0,1790,1670,1918,1794,128,124
9351,levle3_92.jpg,fore,,,0,1894,1466,2014,1574,120,108
9352,levle3_92.jpg,fore,,,0,1814,1570,1914,1670,100,100
9353,levle3_92.jpg,fore,,,0,1674,1198,1794,1310,120,112
9354,levle3_92.jpg,fore,,,0,1562,1070,1686,1170,124,100
9355,levle3_92.jpg,fore,,,0,1710,890,1870,986,160,96
9356,levle3_92.jpg,fore,,,0,2142,622,2262,702,120,80
9357,levle3_92.jpg,fore,,,0,2202,886,2330,1034,128,148
9358,levle3_92.jpg,fore,,,0,2286,750,2418,850,132,100
9359,levle3_92.jpg,fore,,,0,2414,462,2542,582,128,120
9360,levle3_92.jpg,fore,,,0,2154,446,2290,586,136,140
9361,levle3_92.jpg,fore,,,0,2362,1822,2482,1982,120,160
9362,levle3_92.jpg,fore,,,0,2662,1782,2798,1910,136,128
9363,levle3_92.jpg,fore,,,0,2454,1706,2574,1826,120,120
9364,levle3_92.jpg,fore,,,0,2566,1518,2694,1634,128,116
9365,levle3_92.jpg,fore,,,0,1710,1434,1842,1598,132,164
9366,levle3_92.jpg,fore,,,0,2026,1370,2194,1518,168,148
9367,levle3_92.jpg,fore,,,0,2030,1210,2234,1318,204,108
9368,levle3_92.jpg,fore,,,0,1834,1206,1990,1318,156,112
9369,levle3_92.jpg,fore,,,0,1386,974,1538,1118,152,144
9370,levle3_92.jpg,fore,,,0,2574,2310,2754,2406,180,96
9371,levle3_92.jpg,fore,,,0,1582,2282,1738,2382,156,100
9372,levle3_92.jpg,fore,,,0,1478,2086,1606,2198,128,112
9373,levle3_92.jpg,fore,,,0,1638,2382,1774,2490,136,108
9374,levle3_92.jpg,fore,,,0,2782,1210,2970,1350,188,140
9375,levle3_92.jpg,fore,,,0,3446,1998,3622,2134,176,136
9376,levle3_92.jpg,fore,,,0,3278,2266,3458,2374,180,108
9377,levle3_79.jpg,fore,,,0,1827,1485,2041,1631,214,146
9378,levle3_79.jpg,fore,,,0,1750,1340,1850,1493,100,153
9379,levle3_79.jpg,fore,,,0,1604,1332,1704,1478,100,146
9380,levle3_79.jpg,fore,,,0,1528,1202,1650,1370,122,168
9381,levle3_79.jpg,fore,,,0,1420,1163,1512,1263,92,100
9382,levle3_79.jpg,fore,,,0,1367,1232,1459,1416,92,184
9383,levle3_79.jpg,fore,,,0,1558,1133,1666,1225,108,92
9384,levle3_79.jpg,fore,,,0,1620,1041,1811,1094,191,53
9385,levle3_79.jpg,fore,,,0,1643,1156,1758,1278,115,122
9386,levle3_79.jpg,fore,,,0,1758,1163,1857,1271,99,108
9387,levle3_79.jpg,fore,,,0,1750,1263,1865,1355,115,92
9388,levle3_79.jpg,fore,,,0,1896,1240,2041,1393,145,153
9389,levle3_79.jpg,fore,,,0,1911,1148,2011,1271,100,123
9390,levle3_79.jpg,fore,,,0,1804,964,1949,1140,145,176
9391,levle3_79.jpg,fore,,,0,1635,872,1735,1002,100,130
9392,levle3_79.jpg,fore,,,0,1543,887,1658,1064,115,177
9393,levle3_79.jpg,fore,,,0,1221,941,1321,1064,100,123
9394,levle3_79.jpg,fore,,,0,1336,1018,1528,1140,192,122
9395,levle3_79.jpg,fore,,,0,1359,849,1512,995,153,146
9396,levle3_79.jpg,fore,,,0,1367,665,1551,788,184,123
9397,levle3_79.jpg,fore,,,0,1903,1845,2034,1945,131,100
9398,levle3_79.jpg,fore,,,0,1911,1937,2064,2068,153,131
9399,levle3_79.jpg,fore,,,0,1604,1884,1781,2083,177,199
9400,levle3_79.jpg,fore,,,0,1543,1562,1689,1746,146,184
9401,levle3_79.jpg,fore,,,0,1466,1822,1681,1983,215,161
9402,levle3_79.jpg,fore,,,0,1451,1983,1627,2121,176,138
9403,levle3_79.jpg,fore,,,0,1298,1884,1482,2006,184,122
9404,levle3_79.jpg,fore,,,0,1260,2098,1344,2190,84,92
9405,levle3_79.jpg,fore,,,0,1405,2114,1466,2183,61,69
9406,levle3_79.jpg,fore,,,0,1413,2175,1597,2313,184,138
9407,levle3_79.jpg,fore,,,0,1420,2282,1643,2474,223,192
9408,levle3_79.jpg,fore,,,0,1329,2405,1535,2581,206,176
9409,levle3_79.jpg,fore,,,0,1505,2673,1543,2734,38,61
9410,levle3_79.jpg,fore,,,0,1704,2627,1911,2788,207,161
9411,levle3_79.jpg,fore,,,0,1666,2512,1827,2650,161,138
9412,levle3_79.jpg,fore,,,0,1689,2305,1796,2420,107,115
9413,levle3_79.jpg,fore,,,0,1650,2045,1804,2229,154,184
9414,levle3_79.jpg,fore,,,0,1773,2006,1972,2198,199,192
9415,levle3_79.jpg,fore,,,0,1758,2175,1995,2389,237,214
9416,levle3_79.jpg,fore,,,0,1773,2359,1942,2527,169,168
9417,levle3_79.jpg,fore,,,0,1359,3064,1558,3225,199,161
9418,levle3_79.jpg,fore,,,0,1988,2535,2141,2711,153,176
9419,levle3_79.jpg,fore,,,0,2398,2246,2529,2357,131,111
9420,levle3_79.jpg,fore,,,0,1188,1888,1284,2067,96,179
9421,levle3_79.jpg,fore,,,0,1288,2239,1405,2363,117,124
9422,levle3_79.jpg,fore,,,0,2305,2577,2429,2670,124,93
9423,levle3_79.jpg,fore,,,0,1912,2829,2040,2929,128,100
9424,levle3_79.jpg,fore,,,0,1515,2929,1595,3053,80,124
9425,levle3_79.jpg,fore,,,0,1595,2925,1698,3060,103,135
9426,levle3_79.jpg,fore,,,0,1667,2905,1777,3001,110,96
9427,levle3_79.jpg,fore,,,0,2005,2353,2077,2460,72,107
9428,levle3_79.jpg,fore,,,0,1508,1367,1622,1481,114,114
9429,levle3_79.jpg,fore,,,0,1336,412,1467,529,131,117
9430,levle3_79.jpg,fore,,,0,1605,2722,1719,2805,114,83
9431,levle3_79.jpg,fore,,,0,1522,2539,1622,2681,100,142
9432,levle3_79.jpg,fore,,,0,2057,2174,2164,2325,107,151
9433,levle3_79.jpg,fore,,,0,2043,2036,2160,2129,117,93
9434,levle3_79.jpg,fore,,,0,1815,1839,1922,1953,107,114
9435,levle3_79.jpg,fore,,,0,2050,2819,2160,2946,110,127
9436,levle1_338.jpg,fore,Unspecified,0.0,0,1244,3025,1397,3171,153,146
9437,levle1_338.jpg,fore,Unspecified,0.0,0,1543,2949,1650,3071,107,122
9438,levle1_338.jpg,fore,Unspecified,0.0,0,1497,3163,1650,3294,153,131
9439,levle1_338.jpg,fore,Unspecified,0.0,0,1696,3048,1919,3186,223,138
9440,levle1_338.jpg,fore,Unspecified,0.0,0,1934,3225,2018,3340,84,115
9441,levle1_338.jpg,fore,Unspecified,0.0,0,2171,3156,2317,3271,146,115
9442,levle1_338.jpg,fore,Unspecified,0.0,0,2156,3263,2302,3378,146,115
9443,levle1_338.jpg,fore,Unspecified,0.0,0,1995,2688,2118,2796,123,108
9444,levle1_462.jpg,fore,Unspecified,0.0,0,1344,2987,1459,3087,115,100
9445,levle1_462.jpg,fore,Unspecified,0.0,0,1896,2259,2049,2382,153,123
9446,levle1_462.jpg,fore,Unspecified,0.0,0,1911,2435,2087,2596,176,161
9447,levle1_462.jpg,fore,Unspecified,0.0,0,2432,2397,2616,2558,184,161
9448,levle1_462.jpg,fore,Unspecified,0.0,0,2739,2320,2907,2520,168,200
9449,levle1_462.jpg,fore,Unspecified,0.0,0,2746,2029,2869,2175,123,146
9450,levle1_462.jpg,fore,Unspecified,0.0,0,2708,1424,2823,1562,115,138
9451,levle1_462.jpg,fore,Unspecified,0.0,0,1244,1140,1313,1317,69,177
9452,levle1_462.jpg,fore,Unspecified,0.0,0,1290,933,1489,1171,199,238
9453,levle1_462.jpg,fore,Unspecified,0.0,0,1375,543,1558,665,183,122
9454,levle1_462.jpg,fore,Unspecified,0.0,0,999,704,1137,842,138,138
9455,levle0_117.jpg,fore,Unspecified,0.0,0,639,2558,738,2711,99,153
9456,levle0_117.jpg,fore,Unspecified,0.0,0,2225,2366,2340,2497,115,131
9457,levle1_304.jpg,fore,Unspecified,0.0,0,1750,3041,1857,3148,107,107
9458,levle1_304.jpg,fore,Unspecified,0.0,0,1175,3033,1329,3156,154,123
9459,levle1_304.jpg,fore,Unspecified,0.0,0,2072,2504,2210,2642,138,138
9460,levle1_304.jpg,fore,Unspecified,0.0,0,2064,2190,2202,2328,138,138
9461,levle1_304.jpg,fore,Unspecified,0.0,0,2355,2083,2509,2251,154,168
9462,levle1_304.jpg,fore,Unspecified,0.0,0,2915,2305,3030,2474,115,169
9463,levle3_45.jpg,fore,,,0,34,35,49,52,15,17
9464,levle3_45.jpg,fore,,,0,29,22,50,34,21,12
9465,levle3_45.jpg,fore,,,0,36,0,51,18,15,18
9466,levle3_45.jpg,fore,,,0,154,14,167,23,13,9
9467,levle3_45.jpg,fore,,,0,182,30,195,45,13,15
9468,levle3_45.jpg,fore,,,0,172,27,183,45,11,18
9469,levle3_45.jpg,fore,,,0,237,44,247,57,10,13
9470,levle3_45.jpg,fore,,,0,224,35,238,54,14,19
9471,levle3_45.jpg,fore,,,0,212,104,224,116,12,12
9472,levle3_45.jpg,fore,,,0,214,119,231,135,17,16
9473,levle3_45.jpg,fore,,,0,166,126,180,139,14,13
9474,levle3_45.jpg,fore,,,0,169,109,188,126,19,17
9475,levle3_45.jpg,fore,,,0,110,132,129,147,19,15
9476,levle3_45.jpg,fore,,,0,122,119,143,134,21,15
9477,levle3_45.jpg,fore,,,0,144,123,157,135,13,12
9478,levle3_45.jpg,fore,,,0,147,109,170,125,23,16
9479,levle3_45.jpg,fore,,,0,93,154,105,169,12,15
9480,levle3_45.jpg,fore,,,0,120,157,134,172,14,15
9481,levle3_45.jpg,fore,,,0,139,165,153,178,14,13
9482,levle3_45.jpg,fore,,,0,139,149,154,161,15,12
9483,levle3_45.jpg,fore,,,0,166,136,181,153,15,17
9484,levle3_45.jpg,fore,,,0,122,176,135,189,13,13
9485,levle3_45.jpg,fore,,,0,111,184,131,197,20,13
9486,levle3_45.jpg,fore,,,0,133,180,147,193,14,13
9487,levle3_45.jpg,fore,,,0,163,184,179,193,16,9
9488,levle3_45.jpg,fore,,,0,181,191,195,207,14,16
9489,levle3_45.jpg,fore,,,0,168,220,189,232,21,12
9490,levle3_45.jpg,fore,,,0,166,205,176,217,10,12
9491,levle3_45.jpg,fore,,,0,211,196,229,209,18,13
9492,levle3_45.jpg,fore,,,0,117,205,135,226,18,21
9493,levle3_45.jpg,fore,,,0,76,197,92,216,16,19
9494,levle3_45.jpg,fore,,,0,147,223,161,237,14,14
9495,levle3_45.jpg,fore,,,0,190,1,203,10,13,9
9496,levle3_45.jpg,fore,,,0,175,1,191,11,16,10
9497,levle3_45.jpg,fore,,,0,173,11,187,20,14,9
9498,levle3_45.jpg,fore,,,0,228,167,242,182,14,15
9499,levle3_45.jpg,fore,,,0,221,147,233,162,12,15
9500,levle3_45.jpg,fore,,,0,230,91,242,109,12,18
9501,levle3_45.jpg,fore,,,0,166,242,178,253,12,11
9502,levle3_45.jpg,fore,,,0,158,244,168,257,10,13
9503,levle3_45.jpg,fore,,,0,165,170,179,182,14,12
9504,levle3_45.jpg,fore,,,0,204,131,219,147,15,16
9505,levle3_45.jpg,fore,,,0,195,145,214,162,19,17
9506,levle3_45.jpg,fore,,,0,169,158,182,170,13,12
9507,levle3_45.jpg,fore,,,0,179,157,198,179,19,22
9508,levle3_45.jpg,fore,,,0,196,198,208,207,12,9
9509,levle3_45.jpg,fore,,,0,193,206,204,216,11,10
9510,levle3_45.jpg,fore,,,0,182,43,192,56,10,13
9511,levle3_45.jpg,fore,,,0,184,145,196,158,12,13
9512,levle3_45.jpg,fore,,,0,193,128,206,143,13,15
9513,levle3_45.jpg,fore,,,0,93,232,104,242,11,10
9514,levle3_45.jpg,fore,,,0,100,236,115,250,15,14
9515,levle3_45.jpg,fore,,,0,94,219,102,231,8,12
9516,levle3_45.jpg,fore,,,0,100,219,111,230,11,11
9517,levle3_45.jpg,fore,,,0,77,165,88,181,11,16
9518,levle3_45.jpg,fore,,,0,96,170,109,187,13,17
9519,levle3_45.jpg,fore,,,0,109,165,122,178,13,13
9520,levle3_51.jpg,fore,,,0,203,131,239,166,36,35
9521,levle3_51.jpg,fore,,,0,236,147,266,182,30,35
9522,levle3_51.jpg,fore,,,0,206,177,235,213,29,36
9523,levle3_51.jpg,fore,,,0,190,165,207,196,17,31
9524,levle3_51.jpg,fore,,,0,173,178,194,208,21,30
9525,levle3_51.jpg,fore,,,0,149,170,173,210,24,40
9526,levle3_51.jpg,fore,,,0,150,234,169,262,19,28
9527,levle3_51.jpg,fore,,,0,138,277,178,305,40,28
9528,levle3_51.jpg,fore,,,0,115,343,157,378,42,35
9529,levle3_51.jpg,fore,,,0,159,358,194,393,35,35
9530,levle3_51.jpg,fore,,,0,186,334,223,371,37,37
9531,levle3_51.jpg,fore,,,0,202,303,218,325,16,22
9532,levle3_51.jpg,fore,,,0,82,289,114,319,32,30
9533,levle3_51.jpg,fore,,,0,103,389,133,417,30,28
9534,levle3_51.jpg,fore,,,0,134,425,162,456,28,31
9535,levle3_51.jpg,fore,,,0,185,427,214,470,29,43
9536,levle3_51.jpg,fore,,,0,190,23,226,51,36,28
9537,levle3_51.jpg,fore,,,0,211,49,252,83,41,34
9538,levle3_51.jpg,fore,,,0,226,75,278,113,52,38
9539,levle3_51.jpg,fore,,,0,111,141,149,194,38,53
9540,levle3_51.jpg,fore,,,0,189,221,217,262,28,41
9541,levle3_51.jpg,fore,,,0,260,157,302,225,42,68
9542,levle3_51.jpg,fore,,,0,149,305,195,345,46,40
9543,levle3_51.jpg,fore,,,0,14,330,57,361,43,31
9544,levle3_51.jpg,fore,,,0,101,438,126,468,25,30
9545,levle3_51.jpg,fore,,,0,28,466,60,504,32,38
9546,levle3_51.jpg,fore,,,0,225,421,251,459,26,38
9547,levle3_51.jpg,fore,,,0,107,519,145,550,38,31
9548,levle3_51.jpg,fore,,,0,66,194,96,217,30,23
9549,levle3_51.jpg,fore,,,0,47,219,78,257,31,38
9550,levle3_51.jpg,fore,,,0,106,234,135,262,29,28
9551,levle3_51.jpg,fore,,,0,238,15,267,38,29,23
9552,levle3_51.jpg,fore,,,0,218,312,244,334,26,22
9553,levle3_51.jpg,fore,,,0,227,367,247,385,20,18
9554,levle3_51.jpg,fore,,,0,211,377,231,399,20,22
9555,levle3_51.jpg,fore,,,0,142,399,163,419,21,20
9556,levle3_51.jpg,fore,,,0,160,408,192,430,32,22
9557,levle3_51.jpg,fore,,,0,67,487,93,510,26,23
9558,levle3_51.jpg,fore,,,0,130,457,156,479,26,22
9559,levle3_51.jpg,fore,,,0,26,431,57,455,31,24
9560,levle3_51.jpg,fore,,,0,80,383,106,408,26,25
9561,levle3_51.jpg,fore,,,0,178,103,205,131,27,28
9562,levle3_51.jpg,fore,,,0,220,115,252,143,32,28
9563,levle3_51.jpg,fore,,,0,265,136,295,158,30,22
9564,levle3_51.jpg,fore,,,0,92,502,118,523,26,21
9565,levle3_51.jpg,fore,,,0,121,493,144,512,23,19
9566,levle3_51.jpg,fore,,,0,230,399,254,424,24,25
9567,levle3_51.jpg,fore,,,0,257,118,277,142,20,24
9568,levle3_51.jpg,fore,,,0,68,460,98,485,30,25
9569,levle3_51.jpg,fore,,,0,102,478,126,499,24,21
9570,levle3_51.jpg,fore,,,0,160,481,187,514,27,33
9571,levle3_51.jpg,fore,,,0,163,435,190,456,27,21
9572,levle3_51.jpg,fore,,,0,181,273,219,305,38,32
9573,levle0_103.jpg,fore,Unspecified,0.0,0,1604,2826,1696,2911,92,85
9574,levle0_103.jpg,fore,Unspecified,0.0,0,1712,244,1880,374,168,130
9575,levle1_310.jpg,fore,Unspecified,0.0,0,1551,1117,1627,1248,76,131
9576,levle1_310.jpg,fore,Unspecified,0.0,0,1604,1340,1727,1470,123,130
9577,levle1_310.jpg,fore,Unspecified,0.0,0,976,2504,1129,2658,153,154
9578,levle1_310.jpg,fore,Unspecified,0.0,0,961,2757,1099,2903,138,146
9579,levle1_310.jpg,fore,Unspecified,0.0,0,846,2581,945,2757,99,176
9580,levle1_310.jpg,fore,Unspecified,0.0,0,1283,3240,1367,3355,84,115
9581,levle1_310.jpg,fore,Unspecified,0.0,0,1436,3033,1597,3232,161,199
9582,levle1_476.jpg,fore,Unspecified,0.0,0,1260,727,1451,903,191,176
9583,levle1_476.jpg,fore,Unspecified,0.0,0,516,2474,685,2658,169,184
9584,levle1_476.jpg,fore,Unspecified,0.0,0,930,2443,1129,2535,199,92
9585,levle1_476.jpg,fore,Unspecified,0.0,0,961,2520,1099,2665,138,145
9586,levle1_476.jpg,fore,Unspecified,0.0,0,976,2681,1114,2834,138,153
9587,levle1_476.jpg,fore,Unspecified,0.0,0,823,2635,953,2796,130,161
9588,levle1_476.jpg,fore,Unspecified,0.0,0,723,2773,899,2949,176,176
9589,levle1_476.jpg,fore,Unspecified,0.0,0,907,3048,1045,3148,138,100
9590,levle1_476.jpg,fore,Unspecified,0.0,0,1489,2956,1658,3148,169,192
9591,levle1_309.jpg,fore,Unspecified,0.0,0,1260,1370,1382,1462,122,92
9592,levle1_309.jpg,fore,Unspecified,0.0,0,1635,2918,1735,3033,100,115
9593,levle1_309.jpg,fore,Unspecified,0.0,0,1842,3110,1988,3209,146,99
9594,levle1_309.jpg,fore,Unspecified,0.0,0,2233,1999,2355,2098,122,99
9595,levle1_309.jpg,fore,Unspecified,0.0,0,1528,3194,1696,3317,168,123
9596,levle1_309.jpg,fore,Unspecified,0.0,0,1765,2359,1919,2512,154,153
9597,levle3_48.jpg,fore,,,0,76,147,82,159,6,12
9598,levle3_48.jpg,fore,,,0,102,142,123,153,21,11
9599,levle3_48.jpg,fore,,,0,108,130,124,140,16,10
9600,levle3_48.jpg,fore,,,0,81,111,94,124,13,13
9601,levle3_48.jpg,fore,,,0,73,104,82,112,9,8
9602,levle3_48.jpg,fore,,,0,98,117,105,129,7,12
9603,levle3_48.jpg,fore,,,0,97,106,110,118,13,12
9604,levle3_48.jpg,fore,,,0,53,88,71,100,18,12
9605,levle3_48.jpg,fore,,,0,44,104,62,112,18,8
9606,levle3_48.jpg,fore,,,0,62,100,81,120,19,20
9607,levle3_48.jpg,fore,,,0,75,70,92,78,17,8
9608,levle3_48.jpg,fore,,,0,79,222,91,236,12,14
9609,levle3_48.jpg,fore,,,0,94,234,102,248,8,14
9610,levle3_48.jpg,fore,,,0,56,233,79,249,23,16
9611,levle3_48.jpg,fore,,,0,69,192,82,208,13,16
9612,levle3_48.jpg,fore,,,0,135,196,148,211,13,15
9613,levle3_48.jpg,fore,,,0,144,176,163,191,19,15
9614,levle3_48.jpg,fore,,,0,172,171,189,185,17,14
9615,levle3_48.jpg,fore,,,0,193,206,211,223,18,17
9616,levle3_48.jpg,fore,,,0,173,209,188,221,15,12
9617,levle3_48.jpg,fore,,,0,177,228,191,238,14,10
9618,levle3_48.jpg,fore,,,0,177,256,194,267,17,11
9619,levle3_48.jpg,fore,,,0,146,215,161,226,15,11
9620,levle3_48.jpg,fore,,,0,104,213,121,227,17,14
9621,levle3_48.jpg,fore,,,0,123,260,139,276,16,16
9622,levle3_48.jpg,fore,,,0,162,214,177,233,15,19
9623,levle3_48.jpg,fore,,,0,73,84,90,96,17,12
9624,levle3_48.jpg,fore,,,0,88,86,100,97,12,11
9625,levle3_48.jpg,fore,,,0,75,128,95,134,20,6
9626,levle3_48.jpg,fore,,,0,90,134,102,145,12,11
9627,levle3_48.jpg,fore,,,0,75,173,94,191,19,18
9628,levle3_48.jpg,fore,,,0,104,195,119,206,15,11
9629,levle3_48.jpg,fore,,,0,91,202,102,214,11,12
9630,levle3_48.jpg,fore,,,0,115,160,130,175,15,15
9631,levle3_48.jpg,fore,,,0,154,191,167,202,13,11
9632,levle3_48.jpg,fore,,,0,152,202,164,213,12,11
9633,levle3_48.jpg,fore,,,0,165,192,181,209,16,17
9634,levle3_48.jpg,fore,,,0,121,225,138,237,17,12
9635,levle3_48.jpg,fore,,,0,103,253,118,267,15,14
9636,levle3_48.jpg,fore,,,0,145,236,162,250,17,14
9637,levle3_48.jpg,fore,,,0,128,132,141,143,13,11
9638,levle3_48.jpg,fore,,,0,120,144,134,155,14,11
9639,levle3_48.jpg,fore,,,0,21,36,35,49,14,13
9640,levle3_48.jpg,fore,,,0,30,91,47,107,17,16
9641,levle3_48.jpg,fore,,,0,12,65,29,77,17,12
9642,levle3_48.jpg,fore,,,0,59,264,73,273,14,9
9643,levle3_48.jpg,fore,,,0,52,266,65,281,13,15
9644,levle3_48.jpg,fore,,,0,92,164,106,174,14,10
9645,levle3_48.jpg,fore,,,0,95,174,105,184,10,10
9646,levle3_48.jpg,fore,,,0,96,183,105,191,9,8
9647,levle3_48.jpg,fore,,,0,43,54,56,66,13,12
9648,levle3_48.jpg,fore,,,0,52,193,66,206,14,13
9649,levle3_48.jpg,fore,,,0,125,175,137,189,12,14
9650,levle3_48.jpg,fore,,,0,181,196,193,208,12,12
9651,levle3_48.jpg,fore,,,0,187,184,200,197,13,13
9652,levle3_48.jpg,fore,,,0,70,253,85,268,15,15
9653,levle3_48.jpg,fore,,,0,62,208,73,223,11,15
9654,levle3_48.jpg,fore,,,0,69,217,79,228,10,11
9655,levle3_48.jpg,fore,,,0,121,196,134,213,13,17
9656,levle3_48.jpg,fore,,,0,105,181,119,196,14,15
9657,levle3_48.jpg,fore,,,0,117,179,128,196,11,17
9658,levle1_453.jpg,fore,Unspecified,0.0,0,748,355,805,400,57,45
9659,levle1_453.jpg,fore,Unspecified,0.0,0,728,221,796,269,68,48
9660,levle1_453.jpg,fore,Unspecified,0.0,0,629,241,688,284,59,43
9661,levle1_453.jpg,fore,Unspecified,0.0,0,589,272,632,326,43,54
9662,levle1_453.jpg,fore,Unspecified,0.0,0,643,295,680,343,37,48
9663,levle1_453.jpg,fore,Unspecified,0.0,0,546,573,603,619,57,46
9664,levle1_453.jpg,fore,Unspecified,0.0,0,436,630,464,687,28,57
9665,levle1_453.jpg,fore,Unspecified,0.0,0,515,636,552,701,37,65
9666,levle1_453.jpg,fore,Unspecified,0.0,0,558,641,620,729,62,88
9667,levle1_453.jpg,fore,Unspecified,0.0,0,507,709,620,766,113,57
9668,levle1_453.jpg,fore,Unspecified,0.0,0,583,803,660,840,77,37
9669,levle1_453.jpg,fore,Unspecified,0.0,0,476,809,524,857,48,48
9670,levle1_453.jpg,fore,Unspecified,0.0,0,524,829,606,897,82,68
9671,levle1_453.jpg,fore,Unspecified,0.0,0,484,355,546,386,62,31
9672,levle1_453.jpg,fore,Unspecified,0.0,0,512,426,583,477,71,51
9673,levle1_453.jpg,fore,Unspecified,0.0,0,581,448,654,528,73,80
9674,levle3_74.jpg,fore,,,0,932,265,1026,317,94,52
9675,levle3_74.jpg,fore,,,0,825,239,890,278,65,39
9676,levle3_74.jpg,fore,,,0,802,190,857,242,55,52
9677,levle3_74.jpg,fore,,,0,727,207,802,265,75,58
9678,levle3_74.jpg,fore,,,0,948,174,1007,216,59,42
9679,levle3_74.jpg,fore,,,0,753,314,799,350,46,36
9680,levle3_74.jpg,fore,,,0,799,340,851,379,52,39
9681,levle3_74.jpg,fore,,,0,721,304,747,337,26,33
9682,levle3_74.jpg,fore,,,0,581,314,643,366,62,52
9683,levle3_74.jpg,fore,,,0,558,389,604,421,46,32
9684,levle3_74.jpg,fore,,,0,607,376,666,418,59,42
9685,levle3_74.jpg,fore,,,0,565,424,620,460,55,36
9686,levle3_74.jpg,fore,,,0,607,411,662,463,55,52
9687,levle3_74.jpg,fore,,,0,653,428,705,463,52,35
9688,levle3_74.jpg,fore,,,0,711,441,770,489,59,48
9689,levle3_74.jpg,fore,,,0,679,463,734,525,55,62
9690,levle3_74.jpg,fore,,,0,649,486,692,541,43,55
9691,levle3_74.jpg,fore,,,0,688,499,744,541,56,42
9692,levle3_74.jpg,fore,,,0,692,548,753,597,61,49
9693,levle3_74.jpg,fore,,,0,792,538,857,597,65,59
9694,levle3_74.jpg,fore,,,0,760,632,835,688,75,56
9695,levle3_74.jpg,fore,,,0,682,619,753,665,71,46
9696,levle3_74.jpg,fore,,,0,617,541,672,600,55,59
9697,levle3_74.jpg,fore,,,0,558,551,620,606,62,55
9698,levle3_74.jpg,fore,,,0,539,515,581,545,42,30
9699,levle3_74.jpg,fore,,,0,503,473,542,509,39,36
9700,levle3_74.jpg,fore,,,0,500,558,562,613,62,55
9701,levle3_74.jpg,fore,,,0,523,597,562,645,39,48
9702,levle3_74.jpg,fore,,,0,552,587,601,649,49,62
9703,levle3_74.jpg,fore,,,0,584,489,620,525,36,36
9704,levle3_74.jpg,fore,,,0,536,450,594,496,58,46
9705,levle3_74.jpg,fore,,,0,646,333,753,408,107,75
9706,levle3_74.jpg,fore,,,0,1403,431,1448,493,45,62
9707,levle3_74.jpg,fore,,,0,1431,480,1484,539,53,59
9708,levle3_74.jpg,fore,,,0,604,594,675,665,71,71
9709,levle3_74.jpg,fore,,,0,754,382,800,430,46,48
9710,levle3_74.jpg,fore,,,0,1032,187,1084,259,52,72
9711,levle3_74.jpg,fore,,,0,1378,727,1428,791,50,64
9712,levle3_74.jpg,fore,,,0,1297,813,1364,867,67,54
9713,levle3_74.jpg,fore,,,0,1188,807,1234,860,46,53
9714,levle3_74.jpg,fore,,,0,801,387,866,423,65,36
9715,levle3_74.jpg,fore,,,0,1292,403,1344,471,52,68
9716,levle3_74.jpg,fore,,,0,1477,634,1520,688,43,54
9717,levle3_74.jpg,fore,,,0,1298,656,1368,728,70,72
9718,levle3_74.jpg,fore,,,0,1341,594,1415,674,74,80
9719,levle3_74.jpg,fore,,,0,741,490,800,565,59,75
9720,levle3_74.jpg,fore,,,0,832,448,894,502,62,54
9721,levle3_74.jpg,fore,,,0,1438,722,1497,780,59,58
9722,levle3_74.jpg,fore,,,0,766,583,823,630,57,47
9723,levle3_74.jpg,fore,,,0,1288,723,1355,770,67,47
9724,levle3_74.jpg,fore,,,0,1372,803,1438,851,66,48
9725,levle0_126.jpg,fore,Unspecified,0.0,0,1512,2872,1704,2979,192,107
9726,levle0_126.jpg,fore,Unspecified,0.0,0,1375,2941,1474,3056,99,115
9727,levle0_126.jpg,fore,Unspecified,0.0,0,1604,3048,1742,3179,138,131
9728,levle1_335.jpg,fore,Unspecified,0.0,0,1076,1179,1206,1278,130,99
9729,levle1_335.jpg,fore,Unspecified,0.0,0,777,1386,953,1547,176,161
9730,levle1_335.jpg,fore,Unspecified,0.0,0,1558,1102,1696,1225,138,123
9731,levle1_335.jpg,fore,Unspecified,0.0,0,1428,1102,1520,1225,92,123
9732,levle1_335.jpg,fore,Unspecified,0.0,0,1168,3025,1252,3133,84,108
9733,levle1_335.jpg,fore,Unspecified,0.0,0,1298,3117,1436,3263,138,146
9734,levle1_335.jpg,fore,Unspecified,0.0,0,1505,2934,1620,3064,115,130
9735,levle1_335.jpg,fore,Unspecified,0.0,0,1988,3110,2164,3240,176,130
9736,levle0_132.jpg,fore,Unspecified,0.0,0,2317,2658,2440,2834,123,176
9737,levle1_321.jpg,fore,Unspecified,0.0,0,777,2206,961,2458,184,252
9738,levle1_321.jpg,fore,Unspecified,0.0,0,348,2320,478,2535,130,215
9739,levle1_321.jpg,fore,Unspecified,0.0,0,240,2489,394,2604,154,115
9740,levle1_321.jpg,fore,Unspecified,0.0,0,378,2612,463,2750,85,138
9741,levle1_321.jpg,fore,Unspecified,0.0,0,616,2796,723,2964,107,168
9742,levle1_321.jpg,fore,Unspecified,0.0,0,754,2796,945,3033,191,237
9743,levle1_321.jpg,fore,Unspecified,0.0,0,1037,2137,1191,2290,154,153
9744,levle3_60.jpg,fore,,,0,366,169,394,187,28,18
9745,levle3_60.jpg,fore,,,0,335,127,368,157,33,30
9746,levle3_60.jpg,fore,,,0,387,68,408,84,21,16
9747,levle3_60.jpg,fore,,,0,290,55,319,79,29,24
9748,levle3_60.jpg,fore,,,0,280,130,301,151,21,21
9749,levle3_60.jpg,fore,,,0,319,192,356,226,37,34
9750,levle3_60.jpg,fore,,,0,293,207,328,240,35,33
9751,levle3_60.jpg,fore,,,0,271,222,296,253,25,31
9752,levle3_60.jpg,fore,,,0,357,253,398,295,41,42
9753,levle3_60.jpg,fore,,,0,277,283,305,305,28,22
9754,levle3_60.jpg,fore,,,0,339,284,364,322,25,38
9755,levle3_60.jpg,fore,,,0,247,251,268,278,21,27
9756,levle3_60.jpg,fore,,,0,221,170,244,198,23,28
9757,levle3_60.jpg,fore,,,0,137,153,173,184,36,31
9758,levle3_60.jpg,fore,,,0,217,79,251,121,34,42
9759,levle3_60.jpg,fore,,,0,148,102,180,129,32,27
9760,levle3_60.jpg,fore,,,0,210,303,250,338,40,35
9761,levle3_60.jpg,fore,,,0,85,174,118,209,33,35
9762,levle3_60.jpg,fore,,,0,191,207,215,241,24,34
9763,levle3_60.jpg,fore,,,0,157,246,192,279,35,33
9764,levle3_60.jpg,fore,,,0,120,255,146,276,26,21
9765,levle3_60.jpg,fore,,,0,180,167,201,195,21,28
9766,levle3_60.jpg,fore,,,0,297,164,331,194,34,30
9767,levle3_60.jpg,fore,,,0,245,186,278,213,33,27
9768,levle3_60.jpg,fore,,,0,304,255,334,284,30,29
9769,levle3_60.jpg,fore,,,0,438,244,461,272,23,28
9770,levle3_60.jpg,fore,,,0,410,249,436,269,26,20
9771,levle3_60.jpg,fore,,,0,478,295,499,320,21,25
9772,levle3_60.jpg,fore,,,0,422,302,452,330,30,28
9773,levle3_60.jpg,fore,,,0,394,307,415,341,21,34
9774,levle3_60.jpg,fore,,,0,307,306,329,322,22,16
9775,levle3_60.jpg,fore,,,0,377,344,403,365,26,21
9776,levle3_60.jpg,fore,,,0,248,313,279,341,31,28
9777,levle3_60.jpg,fore,,,0,136,289,174,324,38,35
9778,levle3_60.jpg,fore,,,0,122,187,146,220,24,33
9779,levle3_60.jpg,fore,,,0,178,115,223,134,45,19
9780,levle3_60.jpg,fore,,,0,172,128,207,160,35,32
9781,levle3_60.jpg,fore,,,0,251,132,276,165,25,33
9782,levle3_60.jpg,fore,,,0,257,87,289,113,32,26
9783,levle3_60.jpg,fore,,,0,234,59,259,82,25,23
9784,levle3_60.jpg,fore,,,0,167,56,213,89,46,33
9785,levle3_60.jpg,fore,,,0,293,23,326,54,33,31
9786,levle3_60.jpg,fore,,,0,347,49,392,73,45,24
9787,levle3_60.jpg,fore,,,0,92,102,113,116,21,14
9788,levle3_60.jpg,fore,,,0,83,132,118,166,35,34
9789,levle3_60.jpg,fore,,,0,43,67,94,110,51,43
9790,levle3_60.jpg,fore,,,0,83,44,119,72,36,28
9791,levle3_60.jpg,fore,,,0,348,220,374,245,26,25
9792,levle3_60.jpg,fore,,,0,334,325,366,351,32,26
9793,levle3_60.jpg,fore,,,0,291,339,325,370,34,31
9794,levle3_60.jpg,fore,,,0,425,346,456,369,31,23
9795,levle3_60.jpg,fore,,,0,468,333,502,352,34,19
9796,levle3_60.jpg,fore,,,0,308,89,338,108,30,19
9797,levle3_60.jpg,fore,,,0,336,99,361,123,25,24
9798,levle3_60.jpg,fore,,,0,474,110,494,128,20,18
9799,levle3_60.jpg,fore,,,0,432,136,461,164,29,28
9800,levle3_60.jpg,fore,,,0,395,217,420,242,25,25
9801,levle3_60.jpg,fore,,,0,86,221,111,247,25,26
9802,levle3_60.jpg,fore,,,0,148,195,182,222,34,27
9803,levle3_60.jpg,fore,,,0,47,28,76,56,29,28
9804,levle3_60.jpg,fore,,,0,226,218,254,250,28,32
9805,levle3_60.jpg,fore,,,0,200,268,233,300,33,32
9806,levle3_60.jpg,fore,,,0,215,347,251,377,36,30
9807,levle3_60.jpg,fore,,,0,185,341,217,374,32,33
9808,levle3_60.jpg,fore,,,0,37,1,54,22,17,21
9809,levle1_447.jpg,fore,Unspecified,0.0,0,1390,619,1520,803,130,184
9810,levle1_447.jpg,fore,Unspecified,0.0,0,2179,359,2371,535,192,176
9811,levle1_447.jpg,fore,Unspecified,0.0,0,2225,1056,2355,1278,130,222
9812,levle1_447.jpg,fore,Unspecified,0.0,0,2371,895,2601,1094,230,199
9813,levle1_447.jpg,fore,Unspecified,0.0,0,2217,1976,2363,2068,146,92
9814,levle1_447.jpg,fore,Unspecified,0.0,0,2309,2052,2440,2144,131,92
9815,levle1_447.jpg,fore,Unspecified,0.0,0,2148,2183,2294,2343,146,160
9816,levle1_447.jpg,fore,Unspecified,0.0,0,2294,2267,2470,2451,176,184
9817,levle1_447.jpg,fore,Unspecified,0.0,0,2125,2474,2286,2619,161,145
9818,levle1_447.jpg,fore,Unspecified,0.0,0,1926,2535,2072,2681,146,146
9819,levle1_447.jpg,fore,Unspecified,0.0,0,2486,2374,2616,2466,130,92
9820,levle1_447.jpg,fore,Unspecified,0.0,0,2233,2650,2363,2780,130,130
9821,levle1_447.jpg,fore,Unspecified,0.0,0,2861,2658,3014,2780,153,122
9822,levle1_490.jpg,fore,Unspecified,0.0,0,2340,2137,2547,2274,207,137
9823,levle1_490.jpg,fore,Unspecified,0.0,0,2225,2160,2332,2290,107,130
9824,levle1_490.jpg,fore,Unspecified,0.0,0,2141,2251,2263,2397,122,146
9825,levle1_490.jpg,fore,Unspecified,0.0,0,2141,2412,2286,2566,145,154
9826,levle1_490.jpg,fore,Unspecified,0.0,0,2317,2504,2432,2635,115,131
9827,levle1_490.jpg,fore,Unspecified,0.0,0,2309,2336,2371,2466,62,130
9828,levle1_490.jpg,fore,Unspecified,0.0,0,2394,2274,2509,2504,115,230
9829,levle1_484.jpg,fore,Unspecified,0.0,0,1214,1562,1298,1646,84,84
9830,levle1_484.jpg,fore,Unspecified,0.0,0,1145,681,1244,826,99,145
9831,levle1_484.jpg,fore,Unspecified,0.0,0,2064,1079,2164,1225,100,146
9832,levle1_484.jpg,fore,Unspecified,0.0,0,1221,2474,1298,2627,77,153
9833,levle1_484.jpg,fore,Unspecified,0.0,0,1512,2451,1635,2604,123,153
9834,levle1_484.jpg,fore,Unspecified,0.0,0,761,2267,846,2374,85,107
9835,levle1_484.jpg,fore,Unspecified,0.0,0,1505,2665,1666,2796,161,131
9836,levle1_484.jpg,fore,Unspecified,0.0,0,1306,2474,1375,2589,69,115
9837,levle0_318.jpg,fore,Unspecified,0.0,0,1865,3071,2049,3232,184,161
9838,levle0_25.jpg,fore,Unspecified,0.0,0,1221,2918,1329,3117,108,199
9839,levle0_25.jpg,fore,Unspecified,0.0,0,1030,2382,1152,2558,122,176
9840,levle0_31.jpg,fore,Unspecified,0.0,0,1788,2581,1934,2765,146,184
9841,levle1_137.jpg,fore,Unspecified,0.0,0,1198,1263,1329,1347,131,84
9842,levle1_137.jpg,fore,Unspecified,0.0,0,1681,2880,1781,3025,100,145
9843,levle1_137.jpg,fore,Unspecified,0.0,0,1451,3056,1574,3140,123,84
9844,levle1_137.jpg,fore,Unspecified,0.0,0,1367,2926,1512,3025,145,99
9845,levle1_137.jpg,fore,Unspecified,0.0,0,1466,3140,1597,3255,131,115
9846,levle1_137.jpg,fore,Unspecified,0.0,0,1329,3117,1413,3232,84,115
9847,levle1_137.jpg,fore,Unspecified,0.0,0,1237,3064,1321,3163,84,99
9848,levle0_324.jpg,fore,Unspecified,0.0,0,1620,811,1796,972,176,161
9849,levle0_324.jpg,fore,Unspecified,0.0,0,1214,3071,1428,3225,214,154
9850,levle0_19.jpg,fore,Unspecified,0.0,0,157,32,180,53,23,21
9851,levle0_19.jpg,fore,Unspecified,0.0,0,88,262,100,281,12,19
9852,levle0_19.jpg,fore,Unspecified,0.0,0,130,252,149,271,19,19
9853,levle0_442.jpg,fore,Unspecified,0.0,0,125,2704,217,2834,92,130
9854,levle0_442.jpg,fore,Unspecified,0.0,0,164,2612,302,2719,138,107
9855,levle0_456.jpg,fore,Unspecified,0.0,0,2026,1041,2217,1225,191,184
9856,levle0_456.jpg,fore,Unspecified,0.0,0,2210,1340,2309,1478,99,138
9857,levle0_456.jpg,fore,Unspecified,0.0,0,2394,1455,2501,1592,107,137
9858,levle1_123.jpg,fore,Unspecified,0.0,0,3040,1718,3157,1892,117,174
9859,levle1_123.jpg,fore,Unspecified,0.0,0,1868,1360,1952,1502,84,142
9860,levle1_123.jpg,fore,Unspecified,0.0,0,2026,1701,2110,1892,84,191
9861,levle1_123.jpg,fore,Unspecified,0.0,0,2359,2100,2517,2241,158,141
9862,levle1_123.jpg,fore,Unspecified,0.0,0,2351,2449,2500,2649,149,200
9863,levle1_123.jpg,fore,Unspecified,0.0,0,1893,2250,2068,2466,175,216
9864,levle1_123.jpg,fore,Unspecified,0.0,0,2026,2624,2193,2815,167,191
9865,levle1_123.jpg,fore,Unspecified,0.0,0,1636,2241,1777,2441,141,200
9866,levle1_123.jpg,fore,Unspecified,0.0,0,2384,795,2475,945,91,150
9867,levle1_123.jpg,fore,Unspecified,0.0,0,2616,2931,2783,3122,167,191
9868,levle0_330.jpg,fore,Unspecified,0.0,0,677,1983,784,2068,107,85
9869,levle0_495.jpg,fore,Unspecified,0.0,0,1635,788,1750,903,115,115
9870,levle0_495.jpg,fore,Unspecified,0.0,0,1443,3232,1543,3340,100,108
9871,levle2_20.jpg,fore,Unspecified,0.0,0,542,37,574,75,32,38
9872,levle2_20.jpg,fore,Unspecified,0.0,0,448,333,485,351,37,18
9873,levle2_20.jpg,fore,Unspecified,0.0,0,534,355,558,410,24,55
9874,levle2_20.jpg,fore,Unspecified,0.0,0,448,447,470,469,22,22
9875,levle2_20.jpg,fore,Unspecified,0.0,0,493,434,525,471,32,37
9876,levle2_20.jpg,fore,Unspecified,0.0,0,454,472,483,501,29,29
9877,levle2_20.jpg,fore,Unspecified,0.0,0,385,412,411,440,26,28
9878,levle2_20.jpg,fore,Unspecified,0.0,0,400,440,419,474,19,34
9879,levle2_20.jpg,fore,Unspecified,0.0,0,421,391,457,429,36,38
9880,levle2_20.jpg,fore,Unspecified,0.0,0,683,64,715,91,32,27
9881,levle2_20.jpg,fore,Unspecified,0.0,0,632,24,662,53,30,29
9882,levle2_20.jpg,fore,Unspecified,0.0,0,312,280,344,309,32,29
9883,levle2_20.jpg,fore,Unspecified,0.0,0,289,307,328,355,39,48
9884,levle2_20.jpg,fore,Unspecified,0.0,0,321,312,355,355,34,43
9885,levle2_20.jpg,fore,Unspecified,0.0,0,347,336,384,378,37,42
9886,levle2_20.jpg,fore,Unspecified,0.0,0,275,370,304,405,29,35
9887,levle2_20.jpg,fore,Unspecified,0.0,0,155,392,180,424,25,32
9888,levle2_20.jpg,fore,Unspecified,0.0,0,209,408,237,444,28,36
9889,levle2_20.jpg,fore,Unspecified,0.0,0,196,436,237,461,41,25
9890,levle2_20.jpg,fore,Unspecified,0.0,0,209,460,241,485,32,25
9891,levle2_20.jpg,fore,Unspecified,0.0,0,243,420,265,445,22,25
9892,levle2_20.jpg,fore,Unspecified,0.0,0,264,434,297,471,33,37
9893,levle2_20.jpg,fore,Unspecified,0.0,0,192,528,241,562,49,34
9894,levle2_20.jpg,fore,Unspecified,0.0,0,233,506,270,535,37,29
9895,levle2_20.jpg,fore,Unspecified,0.0,0,196,623,225,660,29,37
9896,levle2_20.jpg,fore,Unspecified,0.0,0,248,647,278,674,30,27
9897,levle2_20.jpg,fore,Unspecified,0.0,0,280,640,309,672,29,32
9898,levle2_20.jpg,fore,Unspecified,0.0,0,408,487,435,516,27,29
9899,levle2_20.jpg,fore,Unspecified,0.0,0,395,512,425,556,30,44
9900,levle2_20.jpg,fore,Unspecified,0.0,0,419,517,449,541,30,24
9901,levle2_20.jpg,fore,Unspecified,0.0,0,449,501,493,530,44,29
9902,levle2_20.jpg,fore,Unspecified,0.0,0,353,543,382,580,29,37
9903,levle2_20.jpg,fore,Unspecified,0.0,0,390,559,419,588,29,29
9904,levle2_20.jpg,fore,Unspecified,0.0,0,462,562,483,589,21,27
9905,levle2_20.jpg,fore,Unspecified,0.0,0,550,544,578,578,28,34
9906,levle2_20.jpg,fore,Unspecified,0.0,0,557,514,597,551,40,37
9907,levle0_278.jpg,fore,Unspecified,0.0,0,2072,2543,2225,2765,153,222
9908,levle0_278.jpg,fore,Unspecified,0.0,0,2608,1271,2762,1455,154,184
9909,levle0_278.jpg,fore,Unspecified,0.0,0,2532,2734,2708,2819,176,85
9910,levle2_34.jpg,fore,Unspecified,0.0,0,1551,160,1712,282,161,122
9911,levle2_34.jpg,fore,Unspecified,0.0,0,1106,328,1290,527,184,199
9912,levle2_34.jpg,fore,Unspecified,0.0,0,1520,2251,1666,2359,146,108
9913,levle2_34.jpg,fore,Unspecified,0.0,0,1413,2106,1551,2244,138,138
9914,levle2_34.jpg,fore,Unspecified,0.0,0,1321,2328,1520,2481,199,153
9915,levle2_34.jpg,fore,Unspecified,0.0,0,968,2842,1083,3002,115,160
9916,levle2_34.jpg,fore,Unspecified,0.0,0,1497,2918,1635,3071,138,153
9917,levle2_34.jpg,fore,Unspecified,0.0,0,1949,2811,2041,2934,92,123
9918,levle2_34.jpg,fore,Unspecified,0.0,0,210,2014,256,2083,46,69
9919,levle2_34.jpg,fore,Unspecified,0.0,0,777,274,938,397,161,123
9920,levle2_34.jpg,fore,Unspecified,0.0,0,861,45,1068,213,207,168
9921,levle2_34.jpg,fore,Unspecified,0.0,0,616,650,738,826,122,176
9922,levle2_34.jpg,fore,Unspecified,0.0,0,302,765,440,872,138,107
9923,levle2_34.jpg,fore,Unspecified,0.0,0,309,933,424,1056,115,123
9924,levle2_34.jpg,fore,Unspecified,0.0,0,371,1041,486,1163,115,122
9925,levle2_34.jpg,fore,Unspecified,0.0,0,509,865,731,1071,222,206
9926,levle2_34.jpg,fore,Unspecified,0.0,0,815,527,945,635,130,108
9927,levle2_34.jpg,fore,Unspecified,0.0,0,248,1186,424,1332,176,146
9928,levle2_34.jpg,fore,Unspecified,0.0,0,179,1332,355,1501,176,169
9929,levle2_34.jpg,fore,Unspecified,0.0,0,539,1746,608,1891,69,145
9930,levle2_34.jpg,fore,Unspecified,0.0,0,486,2382,662,2527,176,145
9931,levle2_34.jpg,fore,Unspecified,0.0,0,363,2106,501,2282,138,176
9932,levle2_34.jpg,fore,Unspecified,0.0,0,1106,2121,1244,2221,138,100
9933,levle2_34.jpg,fore,Unspecified,0.0,0,1122,2206,1221,2397,99,191
9934,levle2_34.jpg,fore,Unspecified,0.0,0,348,2773,555,3002,207,229
9935,levle0_250.jpg,fore,Unspecified,0.0,0,1857,2888,2049,3110,192,222
9936,levle2_180.jpg,fore,,,0,1068,2274,1229,2366,161,92
9937,levle2_180.jpg,fore,,,0,761,2098,930,2190,169,92
9938,levle2_180.jpg,fore,,,0,700,2129,892,2282,192,153
9939,levle2_180.jpg,fore,,,0,578,2267,838,2420,260,153
9940,levle2_180.jpg,fore,,,0,455,2068,708,2144,253,76
9941,levle2_180.jpg,fore,,,0,463,2229,631,2351,168,122
9942,levle2_180.jpg,fore,,,0,317,2106,524,2206,207,100
9943,levle2_180.jpg,fore,,,0,225,2198,386,2382,161,184
9944,levle2_180.jpg,fore,,,0,440,2497,654,2665,214,168
9945,levle2_180.jpg,fore,,,0,432,2811,700,2903,268,92
9946,levle2_180.jpg,fore,,,0,647,2665,838,2742,191,77
9947,levle2_180.jpg,fore,,,0,761,2734,853,2903,92,169
9948,levle2_180.jpg,fore,,,0,654,3025,807,3110,153,85
9949,levle2_180.jpg,fore,,,0,861,2742,1037,2972,176,230
9950,levle2_180.jpg,fore,,,0,1842,535,2141,796,299,261
9951,levle2_180.jpg,fore,,,0,2026,719,2317,956,291,237
9952,levle2_180.jpg,fore,,,0,1060,2532,1164,2632,104,100
9953,levle2_180.jpg,fore,,,0,426,1832,564,1963,138,131
9954,levle2_180.jpg,fore,,,0,943,1936,1064,2046,121,110
9955,levle2_180.jpg,fore,,,0,205,1712,322,1822,117,110
9956,levle2_180.jpg,fore,,,0,705,2577,840,2677,135,100
9957,levle0_522.jpg,fore,Unspecified,0.0,0,2041,2903,2194,3194,153,291
9958,levle0_244.jpg,fore,Unspecified,0.0,0,715,2742,784,2926,69,184
9959,levle0_244.jpg,fore,Unspecified,0.0,0,1244,2995,1420,3202,176,207
9960,levle0_293.jpg,fore,Unspecified,0.0,0,1229,2612,1543,2872,314,260
9961,levle0_293.jpg,fore,Unspecified,0.0,0,846,2504,991,2681,145,177
9962,levle0_293.jpg,fore,Unspecified,0.0,0,1145,2880,1298,3125,153,245
9963,levle2_143.jpg,fore,,,0,1451,2060,1627,2198,176,138
9964,levle2_143.jpg,fore,,,0,1344,2144,1543,2351,199,207
9965,levle2_143.jpg,fore,,,0,1106,2504,1283,2635,177,131
9966,levle2_143.jpg,fore,,,0,999,2412,1129,2543,130,131
9967,levle2_143.jpg,fore,,,0,830,2366,999,2543,169,177
9968,levle2_143.jpg,fore,,,0,876,2221,999,2374,123,153
9969,levle2_143.jpg,fore,,,0,754,2160,907,2343,153,183
9970,levle2_143.jpg,fore,,,0,670,2244,838,2420,168,176
9971,levle2_143.jpg,fore,,,0,601,2091,715,2190,114,99
9972,levle2_143.jpg,fore,,,0,547,1968,708,2121,161,153
9973,levle2_143.jpg,fore,,,0,363,1776,524,1953,161,177
9974,levle2_143.jpg,fore,,,0,509,1516,685,1707,176,191
9975,levle2_143.jpg,fore,,,0,1037,2221,1160,2359,123,138
9976,levle2_143.jpg,fore,,,0,991,397,1114,520,123,123
9977,levle2_143.jpg,fore,,,0,1926,1033,2041,1194,115,161
9978,levle2_143.jpg,fore,,,0,1635,619,1781,734,146,115
9979,levle2_143.jpg,fore,,,0,1804,527,1949,704,145,177
9980,levle2_143.jpg,fore,,,0,1980,780,2102,941,122,161
9981,levle2_143.jpg,fore,,,0,708,1860,822,1988,114,128
9982,levle2_143.jpg,fore,,,0,540,2277,633,2360,93,83
9983,levle2_143.jpg,fore,,,0,953,2653,1102,2781,149,128
9984,levle0_287.jpg,fore,Unspecified,0.0,0,1466,2351,1620,2512,154,161
9985,levle2_157.jpg,fore,,,0,2263,1117,2355,1255,92,138
9986,levle2_157.jpg,fore,,,0,1873,2336,2011,2466,138,130
9987,levle2_157.jpg,fore,,,0,1313,596,1413,635,100,39
9988,levle2_157.jpg,fore,,,0,2386,1914,2516,2037,130,123
9989,levle2_157.jpg,fore,,,0,2547,2160,2662,2290,115,130
9990,levle2_157.jpg,fore,,,0,2670,2183,2784,2290,114,107
9991,levle2_157.jpg,fore,,,0,2478,2236,2570,2343,92,107
9992,levle2_157.jpg,fore,,,0,2417,2313,2547,2412,130,99
9993,levle2_157.jpg,fore,,,0,2417,2389,2516,2543,99,154
9994,levle2_157.jpg,fore,,,0,2286,2443,2409,2566,123,123
9995,levle2_157.jpg,fore,,,0,2225,2443,2317,2550,92,107
9996,levle2_157.jpg,fore,,,0,2179,2259,2286,2405,107,146
9997,levle2_157.jpg,fore,,,0,2057,2290,2171,2405,114,115
9998,levle2_157.jpg,fore,,,0,1934,2520,2102,2589,168,69
9999,levle2_157.jpg,fore,,,0,2018,2581,2125,2665,107,84
10000,levle2_157.jpg,fore,,,0,2079,2635,2148,2719,69,84
10001,levle2_157.jpg,fore,,,0,2141,2612,2302,2788,161,176
10002,levle2_157.jpg,fore,,,0,2150,1125,2253,1219,103,94
10003,levle2_157.jpg,fore,,,0,1784,2319,1884,2436,100,117
10004,levle2_157.jpg,fore,,,0,2088,2439,2212,2550,124,111
10005,levle2_157.jpg,fore,,,0,1698,881,1846,970,148,89
10006,levle1_269.jpg,fore,Unspecified,0.0,0,1344,1953,1497,2091,153,138
10007,levle1_269.jpg,fore,Unspecified,0.0,0,1643,2589,1781,2665,138,76
10008,levle1_269.jpg,fore,Unspecified,0.0,0,1781,2681,1919,2788,138,107
10009,levle1_269.jpg,fore,Unspecified,0.0,0,1620,2780,1781,2934,161,154
10010,levle1_269.jpg,fore,Unspecified,0.0,0,1313,2811,1443,2903,130,92
10011,levle1_269.jpg,fore,Unspecified,0.0,0,1436,2918,1543,3056,107,138
10012,levle1_269.jpg,fore,Unspecified,0.0,0,1804,903,1888,1087,84,184
10013,levle1_269.jpg,fore,Unspecified,0.0,0,2079,1278,2248,1508,169,230
10014,levle1_59.jpg,fore,Unspecified,0.0,0,509,2213,631,2328,122,115
10015,levle1_59.jpg,fore,Unspecified,0.0,0,424,2236,570,2389,146,153
10016,levle1_59.jpg,fore,Unspecified,0.0,0,585,2343,647,2451,62,108
10017,levle1_59.jpg,fore,Unspecified,0.0,0,662,2389,846,2512,184,123
10018,levle1_59.jpg,fore,Unspecified,0.0,0,539,2527,700,2604,161,77
10019,levle1_59.jpg,fore,Unspecified,0.0,0,555,2573,654,2696,99,123
10020,levle1_59.jpg,fore,Unspecified,0.0,0,1436,2949,1528,3064,92,115
10021,levle1_71.jpg,fore,Unspecified,0.0,0,3256,745,3531,936,275,191
10022,levle1_71.jpg,fore,Unspecified,0.0,0,2633,704,2891,837,258,133
10023,levle1_71.jpg,fore,Unspecified,0.0,0,2924,787,3148,970,224,183
10024,levle1_71.jpg,fore,Unspecified,0.0,0,3157,920,3298,1086,141,166
10025,levle1_71.jpg,fore,Unspecified,0.0,0,2683,928,2891,1119,208,191
10026,levle1_71.jpg,fore,Unspecified,0.0,0,3007,1069,3165,1360,158,291
10027,levle1_71.jpg,fore,Unspecified,0.0,0,3323,1103,3514,1352,191,249
10028,levle1_71.jpg,fore,Unspecified,0.0,0,2766,1377,2991,1585,225,208
10029,levle1_71.jpg,fore,Unspecified,0.0,0,2999,1369,3173,1585,174,216
10030,levle1_71.jpg,fore,Unspecified,0.0,0,3232,1418,3464,1684,232,266
10031,levle1_71.jpg,fore,Unspecified,0.0,0,3090,1618,3323,1925,233,307
10032,levle1_71.jpg,fore,Unspecified,0.0,0,2866,1859,3032,2083,166,224
10033,levle1_71.jpg,fore,Unspecified,0.0,0,2891,2150,3049,2349,158,199
10034,levle1_71.jpg,fore,Unspecified,0.0,0,3306,2241,3522,2441,216,200
10035,levle1_71.jpg,fore,Unspecified,0.0,0,3497,986,3797,1319,300,333
10036,levle1_527.jpg,fore,Unspecified,0.0,0,1283,1432,1367,1539,84,107
10037,levle1_527.jpg,fore,Unspecified,0.0,0,1375,1654,1482,1730,107,76
10038,levle1_527.jpg,fore,Unspecified,0.0,0,1482,1730,1597,1815,115,85
10039,levle1_527.jpg,fore,Unspecified,0.0,0,1137,1516,1283,1585,146,69
10040,levle1_527.jpg,fore,Unspecified,0.0,0,1152,1646,1267,1799,115,153
10041,levle1_527.jpg,fore,Unspecified,0.0,0,945,1592,1137,1769,192,177
10042,levle1_241.jpg,fore,Unspecified,0.0,0,892,1416,991,1539,99,123
10043,levle1_241.jpg,fore,Unspecified,0.0,0,1919,458,2064,635,145,177
10044,levle1_241.jpg,fore,Unspecified,0.0,0,930,1983,1198,2106,268,123
10045,levle1_241.jpg,fore,Unspecified,0.0,0,961,2106,1114,2328,153,222
10046,levle1_241.jpg,fore,Unspecified,0.0,0,800,2382,892,2481,92,99
10047,levle1_241.jpg,fore,Unspecified,0.0,0,1175,2305,1344,2489,169,184
10048,levle1_241.jpg,fore,Unspecified,0.0,0,1206,2581,1336,2734,130,153
10049,levle1_241.jpg,fore,Unspecified,0.0,0,1482,2497,1689,2658,207,161
10050,levle1_255.jpg,fore,Unspecified,0.0,0,96,133,101,140,5,7
10051,levle1_255.jpg,fore,Unspecified,0.0,0,134,141,141,150,7,9
10052,levle1_255.jpg,fore,Unspecified,0.0,0,123,167,135,179,12,12
10053,levle1_255.jpg,fore,Unspecified,0.0,0,99,168,107,175,8,7
10054,levle1_255.jpg,fore,Unspecified,0.0,0,97,177,106,185,9,8
10055,levle1_255.jpg,fore,Unspecified,0.0,0,85,183,104,197,19,14
10056,levle1_65.jpg,fore,Unspecified,0.0,0,424,1861,555,2022,131,161
10057,levle1_65.jpg,fore,Unspecified,0.0,0,1129,2374,1267,2474,138,100
10058,levle1_65.jpg,fore,Unspecified,0.0,0,1451,834,1574,933,123,99
10059,levle1_65.jpg,fore,Unspecified,0.0,0,1313,734,1482,834,169,100
10060,levle1_65.jpg,fore,Unspecified,0.0,0,1643,1186,1804,1340,161,154
10061,levle1_65.jpg,fore,Unspecified,0.0,0,1329,2956,1581,3094,252,138
10062,levle1_533.jpg,fore,Unspecified,0.0,0,2187,1041,2355,1225,168,184
10063,levle1_533.jpg,fore,Unspecified,0.0,0,2447,1807,2639,1983,192,176
10064,levle1_533.jpg,fore,Unspecified,0.0,0,2616,2075,2731,2221,115,146
10065,levle1_533.jpg,fore,Unspecified,0.0,0,2631,2351,2762,2504,131,153
10066,levle1_533.jpg,fore,Unspecified,0.0,0,1934,2397,2133,2550,199,153
10067,levle1_533.jpg,fore,Unspecified,0.0,0,2041,481,2217,635,176,154
10068,levle1_282.jpg,fore,Unspecified,0.0,0,1681,2221,1796,2412,115,191
10069,levle1_282.jpg,fore,Unspecified,0.0,0,1804,2121,1942,2267,138,146
10070,levle1_282.jpg,fore,Unspecified,0.0,0,1957,2244,2102,2397,145,153
10071,levle1_282.jpg,fore,Unspecified,0.0,0,2095,2213,2240,2466,145,253
10072,levle1_282.jpg,fore,Unspecified,0.0,0,2309,2167,2432,2313,123,146
10073,levle1_282.jpg,fore,Unspecified,0.0,0,1221,3087,1352,3217,131,130
10074,levle1_296.jpg,fore,Unspecified,0.0,0,2210,2098,2355,2229,145,131
10075,levle1_296.jpg,fore,Unspecified,0.0,0,2210,1930,2378,2106,168,176
10076,levle1_296.jpg,fore,Unspecified,0.0,0,2823,2206,3045,2351,222,145
10077,levle1_296.jpg,fore,Unspecified,0.0,0,1681,2351,1896,2527,215,176
10078,levle1_296.jpg,fore,Unspecified,0.0,0,2171,2757,2332,2895,161,138
10079,levle1_296.jpg,fore,Unspecified,0.0,0,2233,1010,2394,1263,161,253
10080,levle1_296.jpg,fore,Unspecified,0.0,0,2493,2796,2601,2865,108,69
10081,levle1_297.jpg,fore,Unspecified,0.0,0,1068,1945,1206,2106,138,161
10082,levle1_297.jpg,fore,Unspecified,0.0,0,677,2129,861,2259,184,130
10083,levle1_297.jpg,fore,Unspecified,0.0,0,777,2428,884,2566,107,138
10084,levle1_297.jpg,fore,Unspecified,0.0,0,1091,2428,1175,2612,84,184
10085,levle1_297.jpg,fore,Unspecified,0.0,0,470,2190,547,2320,77,130
10086,levle1_297.jpg,fore,Unspecified,0.0,0,478,2359,639,2512,161,153
10087,levle1_297.jpg,fore,Unspecified,0.0,0,486,1539,532,1646,46,107
10088,levle1_297.jpg,fore,Unspecified,0.0,0,570,1845,662,2029,92,184
10089,levle1_297.jpg,fore,Unspecified,0.0,0,202,2466,325,2612,123,146
10090,levle1_297.jpg,fore,Unspecified,0.0,0,578,2558,700,2650,122,92
10091,levle1_283.jpg,fore,Unspecified,0.0,0,2769,2129,2945,2259,176,130
10092,levle1_283.jpg,fore,Unspecified,0.0,0,2447,1646,2578,1807,131,161
10093,levle1_283.jpg,fore,Unspecified,0.0,0,2624,1715,2700,1838,76,123
10094,levle1_283.jpg,fore,Unspecified,0.0,0,2187,2236,2279,2397,92,161
10095,levle1_283.jpg,fore,Unspecified,0.0,0,2018,2206,2133,2328,115,122
10096,levle1_283.jpg,fore,Unspecified,0.0,0,1888,2060,1988,2206,100,146
10097,levle1_283.jpg,fore,Unspecified,0.0,0,1505,2619,1635,2734,130,115
10098,levle1_283.jpg,fore,Unspecified,0.0,0,1390,2474,1505,2612,115,138
10099,levle1_283.jpg,fore,Unspecified,0.0,0,1221,3148,1313,3301,92,153
10100,levle1_283.jpg,fore,Unspecified,0.0,0,1382,3163,1497,3340,115,177
10101,levle1_283.jpg,fore,Unspecified,0.0,0,1267,926,1382,1041,115,115
10102,levle1_254.jpg,fore,Unspecified,0.0,0,1053,1110,1206,1217,153,107
10103,levle1_254.jpg,fore,Unspecified,0.0,0,2148,2543,2302,2734,154,191
10104,levle1_254.jpg,fore,Unspecified,0.0,0,2003,2573,2141,2750,138,177
10105,levle1_254.jpg,fore,Unspecified,0.0,0,2516,2397,2608,2535,92,138
10106,levle1_254.jpg,fore,Unspecified,0.0,0,2409,2451,2486,2589,77,138
10107,levle1_254.jpg,fore,Unspecified,0.0,0,1397,3255,1535,3370,138,115
10108,levle1_254.jpg,fore,Unspecified,0.0,0,1221,1117,1375,1263,154,146
10109,levle1_532.jpg,fore,Unspecified,0.0,0,2340,1179,2463,1294,123,115
10110,levle1_532.jpg,fore,Unspecified,0.0,0,2440,1363,2555,1485,115,122
10111,levle1_532.jpg,fore,Unspecified,0.0,0,2562,1677,2662,1838,100,161
10112,levle1_532.jpg,fore,Unspecified,0.0,0,1244,2543,1375,2696,131,153
10113,levle1_532.jpg,fore,Unspecified,0.0,0,1106,1117,1198,1217,92,100
10114,levle1_532.jpg,fore,Unspecified,0.0,0,1060,956,1206,1102,146,146
10115,levle1_532.jpg,fore,Unspecified,0.0,0,1742,366,1880,527,138,161
10116,levle1_64.jpg,fore,Unspecified,0.0,0,1972,1025,2057,1248,85,223
10117,levle1_64.jpg,fore,Unspecified,0.0,0,2210,1094,2371,1217,161,123
10118,levle1_64.jpg,fore,Unspecified,0.0,0,1375,1623,1443,1761,68,138
10119,levle1_64.jpg,fore,Unspecified,0.0,0,1436,3025,1658,3225,222,200
10120,levle1_64.jpg,fore,Unspecified,0.0,0,1152,3041,1244,3117,92,76
10121,levle1_64.jpg,fore,Unspecified,0.0,0,2026,3248,2164,3386,138,138
10122,levle1_526.jpg,fore,Unspecified,0.0,0,999,910,1221,1033,222,123
10123,levle1_526.jpg,fore,Unspecified,0.0,0,1375,290,1520,435,145,145
10124,levle1_526.jpg,fore,Unspecified,0.0,0,601,2129,792,2305,191,176
10125,levle1_526.jpg,fore,Unspecified,0.0,0,654,2497,769,2558,115,61
10126,levle1_526.jpg,fore,Unspecified,0.0,0,884,2428,1030,2573,146,145
10127,levle1_526.jpg,fore,Unspecified,0.0,0,761,2711,892,2819,131,108
10128,levle1_526.jpg,fore,Unspecified,0.0,0,807,2826,907,2872,100,46
10129,levle1_526.jpg,fore,Unspecified,0.0,0,999,2956,1106,3048,107,92
10130,levle1_526.jpg,fore,Unspecified,0.0,0,1191,2895,1313,3071,122,176
10131,levle1_526.jpg,fore,Unspecified,0.0,0,1037,3079,1129,3202,92,123
10132,levle1_526.jpg,fore,Unspecified,0.0,0,1168,3102,1229,3225,61,123
10133,levle1_70.jpg,fore,Unspecified,0.0,0,2633,953,2924,1161,291,208
10134,levle1_70.jpg,fore,Unspecified,0.0,0,3198,97,3348,205,150,108
10135,levle1_70.jpg,fore,Unspecified,0.0,0,3007,1044,3148,1219,141,175
10136,levle1_70.jpg,fore,Unspecified,0.0,0,3423,1078,3589,1202,166,124
10137,levle1_70.jpg,fore,Unspecified,0.0,0,1943,1261,2193,1360,250,99
10138,levle1_70.jpg,fore,Unspecified,0.0,0,2101,1344,2317,1485,216,141
10139,levle1_70.jpg,fore,Unspecified,0.0,0,2375,1277,2583,1477,208,200
10140,levle1_70.jpg,fore,Unspecified,0.0,0,1827,1402,2060,1610,233,208
10141,levle1_70.jpg,fore,Unspecified,0.0,0,2126,1460,2309,1601,183,141
10142,levle1_70.jpg,fore,Unspecified,0.0,0,2134,1718,2292,1867,158,149
10143,levle1_70.jpg,fore,Unspecified,0.0,0,2234,1876,2558,2150,324,274
10144,levle1_70.jpg,fore,Unspecified,0.0,0,2010,2183,2292,2424,282,241
10145,levle1_70.jpg,fore,Unspecified,0.0,0,2592,1443,2816,1585,224,142
10146,levle1_70.jpg,fore,Unspecified,0.0,0,2517,1626,2849,1851,332,225
10147,levle1_70.jpg,fore,Unspecified,0.0,0,2741,1851,2991,2042,250,191
10148,levle1_70.jpg,fore,Unspecified,0.0,0,2974,2017,3190,2200,216,183
10149,levle1_70.jpg,fore,Unspecified,0.0,0,3190,1967,3365,2117,175,150
10150,levle1_70.jpg,fore,Unspecified,0.0,0,3207,2100,3514,2358,307,258
10151,levle1_70.jpg,fore,Unspecified,0.0,0,1395,3056,1611,3214,216,158
10152,levle1_70.jpg,fore,Unspecified,0.0,0,2193,2773,2508,3006,315,233
10153,levle1_240.jpg,fore,Unspecified,0.0,0,731,1516,830,1669,99,153
10154,levle1_240.jpg,fore,Unspecified,0.0,0,800,1899,922,2045,122,146
10155,levle1_240.jpg,fore,Unspecified,0.0,0,945,2037,1060,2137,115,100
10156,levle1_240.jpg,fore,Unspecified,0.0,0,892,2183,1022,2251,130,68
10157,levle1_240.jpg,fore,Unspecified,0.0,0,884,2251,1053,2313,169,62
10158,levle1_240.jpg,fore,Unspecified,0.0,0,938,2359,1129,2466,191,107
10159,levle1_240.jpg,fore,Unspecified,0.0,0,1168,2642,1283,2773,115,131
10160,levle1_240.jpg,fore,Unspecified,0.0,0,1375,2934,1482,3087,107,153
10161,levle1_268.jpg,fore,Unspecified,0.0,0,1635,1056,1796,1202,161,146
10162,levle1_268.jpg,fore,Unspecified,0.0,0,2210,1125,2325,1225,115,100
10163,levle1_268.jpg,fore,Unspecified,0.0,0,1827,2359,1995,2512,168,153
10164,levle1_268.jpg,fore,Unspecified,0.0,0,1781,2635,1896,2734,115,99
10165,levle1_268.jpg,fore,Unspecified,0.0,0,1459,2619,1543,2727,84,108
10166,levle1_268.jpg,fore,Unspecified,0.0,0,1811,2780,1972,2911,161,131
10167,levle1_268.jpg,fore,Unspecified,0.0,0,2463,964,2578,1094,115,130
10168,levle1_268.jpg,fore,Unspecified,0.0,0,2064,2320,2156,2474,92,154
10169,levle1_58.jpg,fore,Unspecified,0.0,0,1566,933,1704,1102,138,169
10170,levle1_58.jpg,fore,Unspecified,0.0,0,1183,1585,1344,1730,161,145
10171,levle1_58.jpg,fore,Unspecified,0.0,0,1405,3271,1520,3370,115,99
10172,levle1_58.jpg,fore,Unspecified,0.0,0,2294,2221,2440,2313,146,92
10173,levle1_58.jpg,fore,Unspecified,0.0,0,2225,2581,2325,2696,100,115
10174,levle1_58.jpg,fore,Unspecified,0.0,0,1896,2788,2018,2918,122,130
10175,levle1_58.jpg,fore,Unspecified,0.0,0,2049,2734,2171,2872,122,138
10176,levle1_58.jpg,fore,Unspecified,0.0,0,2026,2604,2187,2757,161,153
10177,levle1_58.jpg,fore,Unspecified,0.0,0,1474,3064,1589,3209,115,145
10178,levle2_156.jpg,fore,Unspecified,0.0,0,1053,1301,1152,1401,99,100
10179,levle2_156.jpg,fore,Unspecified,0.0,0,945,1217,1083,1347,138,130
10180,levle2_156.jpg,fore,Unspecified,0.0,0,1068,1033,1160,1148,92,115
10181,levle2_156.jpg,fore,Unspecified,0.0,0,907,2251,1045,2374,138,123
10182,levle2_156.jpg,fore,Unspecified,0.0,0,800,2343,915,2443,115,100
10183,levle2_156.jpg,fore,Unspecified,0.0,0,761,2458,869,2543,108,85
10184,levle2_156.jpg,fore,Unspecified,0.0,0,884,2520,945,2635,61,115
10185,levle2_156.jpg,fore,Unspecified,0.0,0,938,2635,1076,2773,138,138
10186,levle2_156.jpg,fore,Unspecified,0.0,0,1168,2696,1306,2857,138,161
10187,levle2_156.jpg,fore,Unspecified,0.0,0,1137,2497,1206,2543,69,46
10188,levle2_156.jpg,fore,Unspecified,0.0,0,1106,2481,1260,2642,154,161
10189,levle2_156.jpg,fore,Unspecified,0.0,0,1137,2343,1283,2474,146,131
10190,levle2_156.jpg,fore,Unspecified,0.0,0,1244,2351,1352,2474,108,123
10191,levle2_156.jpg,fore,Unspecified,0.0,0,1352,2389,1459,2481,107,92
10192,levle2_156.jpg,fore,Unspecified,0.0,0,1060,2190,1191,2305,131,115
10193,levle2_156.jpg,fore,Unspecified,0.0,0,1229,2137,1336,2305,107,168
10194,levle2_156.jpg,fore,Unspecified,0.0,0,1581,2428,1712,2573,131,145
10195,levle2_156.jpg,fore,Unspecified,0.0,0,1443,2366,1574,2443,131,77
10196,levle2_156.jpg,fore,Unspecified,0.0,0,1451,2512,1597,2642,146,130
10197,levle2_156.jpg,fore,Unspecified,0.0,0,1336,2596,1512,2719,176,123
10198,levle2_156.jpg,fore,Unspecified,0.0,0,984,2405,1099,2550,115,145
10199,levle2_156.jpg,fore,Unspecified,0.0,0,2171,1163,2317,1271,146,108
10200,levle2_156.jpg,fore,Unspecified,0.0,0,1911,535,2041,619,130,84
10201,levle2_156.jpg,fore,Unspecified,0.0,0,2302,849,2478,972,176,123
10202,levle2_156.jpg,fore,Unspecified,0.0,0,2179,543,2325,665,146,122
10203,levle0_286.jpg,fore,Unspecified,0.0,0,1405,2374,1581,2535,176,161
10204,levle0_286.jpg,fore,Unspecified,0.0,0,1597,2313,1750,2489,153,176
10205,levle2_142.jpg,fore,,,0,2463,1646,2578,1815,115,169
10206,levle2_142.jpg,fore,,,0,2271,1953,2355,2029,84,76
10207,levle2_142.jpg,fore,,,0,2325,2014,2417,2091,92,77
10208,levle2_142.jpg,fore,,,0,2447,2052,2585,2160,138,108
10209,levle2_142.jpg,fore,,,0,2562,2022,2700,2129,138,107
10210,levle2_142.jpg,fore,,,0,2355,2152,2463,2259,108,107
10211,levle2_142.jpg,fore,,,0,2355,2267,2486,2397,131,130
10212,levle2_142.jpg,fore,,,0,2371,2397,2447,2504,76,107
10213,levle2_142.jpg,fore,,,0,2202,2267,2348,2420,146,153
10214,levle2_142.jpg,fore,,,0,2171,2443,2240,2504,69,61
10215,levle2_142.jpg,fore,,,0,2302,2474,2432,2612,130,138
10216,levle2_142.jpg,fore,,,0,2118,2190,2233,2359,115,169
10217,levle2_142.jpg,fore,,,0,2072,2435,2194,2596,122,161
10218,levle2_142.jpg,fore,,,0,2156,2535,2279,2688,123,153
10219,levle2_142.jpg,fore,,,0,1827,2160,1988,2412,161,252
10220,levle2_142.jpg,fore,,,0,1152,1048,1306,1194,154,146
10221,levle2_142.jpg,fore,,,0,1252,711,1382,895,130,184
10222,levle2_142.jpg,fore,,,0,1681,596,1850,734,169,138
10223,levle2_142.jpg,fore,,,0,1865,665,2049,857,184,192
10224,levle2_142.jpg,fore,,,0,2240,2136,2350,2250,110,114
10225,levle2_142.jpg,fore,,,0,2009,1932,2123,2029,114,97
10226,levle0_292.jpg,fore,Unspecified,0.0,0,1267,2481,1459,2704,192,223
10227,levle0_292.jpg,fore,Unspecified,0.0,0,1183,2711,1267,2849,84,138
10228,levle0_292.jpg,fore,Unspecified,0.0,0,1819,2114,1942,2244,123,130
10229,levle0_523.jpg,fore,Unspecified,0.0,0,2317,1769,2532,1983,215,214
10230,levle0_245.jpg,fore,Unspecified,0.0,0,647,826,800,926,153,100
10231,levle0_245.jpg,fore,Unspecified,0.0,0,463,1868,616,2098,153,230
10232,levle2_181.jpg,fore,,,0,486,2091,723,2328,237,237
10233,levle2_181.jpg,fore,,,0,1221,2382,1405,2527,184,145
10234,levle2_181.jpg,fore,,,0,892,2757,968,2826,76,69
10235,levle2_181.jpg,fore,,,0,961,2581,1122,2811,161,230
10236,levle2_181.jpg,fore,,,0,1543,2857,1673,3048,130,191
10237,levle2_181.jpg,fore,,,0,1160,1822,1336,1968,176,146
10238,levle2_181.jpg,fore,,,0,1145,2029,1214,2091,69,62
10239,levle2_181.jpg,fore,,,0,1290,2106,1474,2282,184,176
10240,levle2_181.jpg,fore,,,0,1382,2826,1443,2872,61,46
10241,levle2_181.jpg,fore,,,0,1152,2704,1306,2895,154,191
10242,levle2_181.jpg,fore,,,0,1275,2658,1413,2803,138,145
10243,levle2_181.jpg,fore,,,0,1237,3002,1397,3225,160,223
10244,levle2_181.jpg,fore,,,0,1489,2949,1551,3033,62,84
10245,levle2_181.jpg,fore,,,0,1689,2803,1819,2972,130,169
10246,levle2_181.jpg,fore,,,0,1620,3079,1788,3240,168,161
10247,levle2_181.jpg,fore,,,0,1014,1945,1122,2045,108,100
10248,levle2_181.jpg,fore,,,0,812,2301,905,2398,93,97
10249,levle2_181.jpg,fore,,,0,826,1912,933,2015,107,103
10250,levle2_181.jpg,fore,,,0,874,2163,1002,2277,128,114
10251,levle2_181.jpg,fore,,,0,1112,2619,1243,2757,131,138
10252,levle2_181.jpg,fore,,,0,1308,3201,1557,3319,249,118
10253,levle0_251.jpg,fore,Unspecified,0.0,0,1773,2083,1949,2267,176,184
10254,levle2_35.jpg,fore,Unspecified,0.0,0,670,1340,853,1470,183,130
10255,levle2_35.jpg,fore,Unspecified,0.0,0,807,1401,961,1508,154,107
10256,levle2_35.jpg,fore,Unspecified,0.0,0,861,1462,1030,1684,169,222
10257,levle2_35.jpg,fore,Unspecified,0.0,0,922,1294,1083,1424,161,130
10258,levle2_35.jpg,fore,Unspecified,0.0,0,1390,504,1466,604,76,100
10259,levle2_35.jpg,fore,Unspecified,0.0,0,1474,443,1620,589,146,146
10260,levle2_35.jpg,fore,Unspecified,0.0,0,1650,336,1796,474,146,138
10261,levle2_35.jpg,fore,Unspecified,0.0,0,1765,351,1919,520,154,169
10262,levle2_35.jpg,fore,Unspecified,0.0,0,1735,535,1911,665,176,130
10263,levle2_35.jpg,fore,Unspecified,0.0,0,1574,711,1773,865,199,154
10264,levle2_35.jpg,fore,Unspecified,0.0,0,1781,811,1865,926,84,115
10265,levle2_35.jpg,fore,Unspecified,0.0,0,1873,826,2034,1010,161,184
10266,levle2_35.jpg,fore,Unspecified,0.0,0,2202,673,2340,865,138,192
10267,levle2_35.jpg,fore,Unspecified,0.0,0,2378,1102,2470,1255,92,153
10268,levle2_35.jpg,fore,Unspecified,0.0,0,639,2152,731,2244,92,92
10269,levle2_35.jpg,fore,Unspecified,0.0,0,815,2183,915,2282,100,99
10270,levle2_35.jpg,fore,Unspecified,0.0,0,723,2305,884,2435,161,130
10271,levle2_35.jpg,fore,Unspecified,0.0,0,838,2282,1007,2428,169,146
10272,levle2_35.jpg,fore,Unspecified,0.0,0,945,2236,1076,2359,131,123
10273,levle2_35.jpg,fore,Unspecified,0.0,0,1106,2229,1244,2336,138,107
10274,levle2_35.jpg,fore,Unspecified,0.0,0,1091,2366,1168,2451,77,85
10275,levle2_35.jpg,fore,Unspecified,0.0,0,938,2435,1030,2512,92,77
10276,levle2_35.jpg,fore,Unspecified,0.0,0,991,2481,1091,2573,100,92
10277,levle2_35.jpg,fore,Unspecified,0.0,0,1076,2543,1168,2627,92,84
10278,levle2_35.jpg,fore,Unspecified,0.0,0,1068,2673,1175,2788,107,115
10279,levle2_35.jpg,fore,Unspecified,0.0,0,1267,2305,1420,2458,153,153
10280,levle2_35.jpg,fore,Unspecified,0.0,0,1436,2259,1551,2435,115,176
10281,levle2_35.jpg,fore,Unspecified,0.0,0,1597,2451,1735,2589,138,138
10282,levle2_35.jpg,fore,Unspecified,0.0,0,1459,2466,1589,2612,130,146
10283,levle0_279.jpg,fore,Unspecified,0.0,0,2394,1501,2585,1638,191,137
10284,levle0_279.jpg,fore,Unspecified,0.0,0,1819,2382,2041,2581,222,199
10285,levle0_279.jpg,fore,Unspecified,0.0,0,1306,3087,1482,3248,176,161
10286,levle2_21.jpg,fore,Unspecified,0.0,0,302,121,327,145,25,24
10287,levle2_21.jpg,fore,Unspecified,0.0,0,259,198,287,229,28,31
10288,levle2_21.jpg,fore,Unspecified,0.0,0,279,219,315,257,36,38
10289,levle2_21.jpg,fore,Unspecified,0.0,0,380,232,436,274,56,42
10290,levle2_21.jpg,fore,Unspecified,0.0,0,474,310,493,334,19,24
10291,levle2_21.jpg,fore,Unspecified,0.0,0,264,520,300,557,36,37
10292,levle2_21.jpg,fore,Unspecified,0.0,0,508,342,548,376,40,34
10293,levle2_21.jpg,fore,Unspecified,0.0,0,493,368,531,399,38,31
10294,levle2_21.jpg,fore,Unspecified,0.0,0,417,618,449,639,32,21
10295,levle2_21.jpg,fore,Unspecified,0.0,0,374,616,406,639,32,23
10296,levle2_21.jpg,fore,Unspecified,0.0,0,453,259,499,310,46,51
10297,levle2_21.jpg,fore,Unspecified,0.0,0,448,297,485,351,37,54
10298,levle2_21.jpg,fore,Unspecified,0.0,0,491,282,534,325,43,43
10299,levle2_21.jpg,fore,Unspecified,0.0,0,466,399,506,429,40,30
10300,levle2_21.jpg,fore,Unspecified,0.0,0,504,397,544,440,40,43
10301,levle2_21.jpg,fore,Unspecified,0.0,0,432,421,478,448,46,27
10302,levle2_21.jpg,fore,Unspecified,0.0,0,449,440,478,480,29,40
10303,levle2_21.jpg,fore,Unspecified,0.0,0,438,478,470,506,32,28
10304,levle2_21.jpg,fore,Unspecified,0.0,0,415,436,449,465,34,29
10305,levle2_21.jpg,fore,Unspecified,0.0,0,406,455,442,495,36,40
10306,levle2_21.jpg,fore,Unspecified,0.0,0,357,469,389,495,32,26
10307,levle2_21.jpg,fore,Unspecified,0.0,0,347,499,380,525,33,26
10308,levle2_21.jpg,fore,Unspecified,0.0,0,329,469,357,495,28,26
10309,levle2_21.jpg,fore,Unspecified,0.0,0,245,588,272,616,27,28
10310,levle2_21.jpg,fore,Unspecified,0.0,0,279,582,312,614,33,32
10311,levle2_21.jpg,fore,Unspecified,0.0,0,232,614,255,640,23,26
10312,levle2_21.jpg,fore,Unspecified,0.0,0,232,644,272,682,40,38
10313,levle2_21.jpg,fore,Unspecified,0.0,0,278,648,308,678,30,30
10314,levle2_21.jpg,fore,Unspecified,0.0,0,306,650,325,674,19,24
10315,levle2_21.jpg,fore,Unspecified,0.0,0,327,656,349,695,22,39
10316,levle2_21.jpg,fore,Unspecified,0.0,0,338,637,374,673,36,36
10317,levle0_494.jpg,fore,Unspecified,0.0,0,1773,673,1880,842,107,169
10318,levle0_494.jpg,fore,Unspecified,0.0,0,1106,2374,1221,2504,115,130
10319,levle0_494.jpg,fore,Unspecified,0.0,0,1336,2504,1482,2635,146,131
10320,levle0_480.jpg,fore,Unspecified,0.0,0,815,2259,1045,2543,230,284
10321,levle0_457.jpg,fore,Unspecified,0.0,0,2110,1002,2263,1148,153,146
10322,levle0_331.jpg,fore,Unspecified,0.0,0,915,1753,1022,1907,107,154
10323,levle1_122.jpg,fore,Unspecified,0.0,0,2134,471,2259,629,125,158
10324,levle1_122.jpg,fore,Unspecified,0.0,0,2242,2657,2375,2823,133,166
10325,levle1_122.jpg,fore,Unspecified,0.0,0,2425,2358,2567,2532,142,174
10326,levle1_122.jpg,fore,Unspecified,0.0,0,2558,1992,2708,2191,150,199
10327,levle1_122.jpg,fore,Unspecified,0.0,0,2600,1867,2733,1975,133,108
10328,levle1_122.jpg,fore,Unspecified,0.0,0,2866,1884,3040,1967,174,83
10329,levle0_325.jpg,fore,Unspecified,0.0,0,1367,819,1451,956,84,137
10330,levle0_325.jpg,fore,Unspecified,0.0,0,2057,2711,2187,2872,130,161
10331,levle1_136.jpg,fore,Unspecified,0.0,0,348,2014,463,2114,115,100
10332,levle1_136.jpg,fore,Unspecified,0.0,0,317,2121,478,2206,161,85
10333,levle1_136.jpg,fore,Unspecified,0.0,0,447,2206,524,2297,77,91
10334,levle1_136.jpg,fore,Unspecified,0.0,0,723,2681,815,2773,92,92
10335,levle1_136.jpg,fore,Unspecified,0.0,0,784,3010,853,3117,69,107
10336,levle1_136.jpg,fore,Unspecified,0.0,0,1114,2926,1221,2995,107,69
10337,levle1_136.jpg,fore,Unspecified,0.0,0,1191,3018,1275,3125,84,107
10338,levle0_443.jpg,fore,Unspecified,0.0,0,1359,374,1520,520,161,146
10339,levle0_443.jpg,fore,Unspecified,0.0,0,2401,1937,2662,2183,261,246
10340,levle0_18.jpg,fore,Unspecified,0.0,0,205,341,231,365,26,24
10341,levle0_18.jpg,fore,Unspecified,0.0,0,187,388,206,417,19,29
10342,levle0_319.jpg,fore,Unspecified,0.0,0,1857,1263,2018,1401,161,138
10343,levle0_319.jpg,fore,Unspecified,0.0,0,478,2221,723,2343,245,122
10344,levle0_24.jpg,fore,Unspecified,0.0,0,1543,2397,1666,2481,123,84
10345,levle0_24.jpg,fore,Unspecified,0.0,0,1367,2466,1551,2566,184,100
10346,levle0_24.jpg,fore,Unspecified,0.0,0,1696,2964,1834,3179,138,215
10347,levle1_485.jpg,fore,Unspecified,0.0,0,2532,2160,2746,2297,214,137
10348,levle1_485.jpg,fore,Unspecified,0.0,0,2102,2941,2302,3071,200,130
10349,levle1_485.jpg,fore,Unspecified,0.0,0,1796,2773,1972,2849,176,76
10350,levle1_485.jpg,fore,Unspecified,0.0,0,1827,3102,1926,3232,99,130
10351,levle1_485.jpg,fore,Unspecified,0.0,0,1466,3110,1604,3225,138,115
10352,levle1_485.jpg,fore,Unspecified,0.0,0,1566,3286,1704,3416,138,130
10353,levle1_485.jpg,fore,Unspecified,0.0,0,1443,1010,1543,1125,100,115
10354,levle1_485.jpg,fore,Unspecified,0.0,0,1252,2535,1344,2650,92,115
10355,levle1_491.jpg,fore,Unspecified,0.0,0,2355,2091,2532,2282,177,191
10356,levle1_491.jpg,fore,Unspecified,0.0,0,2156,2137,2317,2259,161,122
10357,levle1_491.jpg,fore,Unspecified,0.0,0,2148,2274,2286,2389,138,115
10358,levle1_491.jpg,fore,Unspecified,0.0,0,2049,2420,2217,2504,168,84
10359,levle1_491.jpg,fore,Unspecified,0.0,0,2164,2527,2279,2612,115,85
10360,levle1_491.jpg,fore,Unspecified,0.0,0,2271,2389,2378,2550,107,161
10361,levle1_491.jpg,fore,Unspecified,0.0,0,2378,2313,2478,2420,100,107
10362,levle3_61.jpg,fore,,,0,437,546,488,571,51,25
10363,levle3_61.jpg,fore,,,0,405,554,462,611,57,57
10364,levle3_61.jpg,fore,,,0,362,550,403,575,41,25
10365,levle3_61.jpg,fore,,,0,421,500,470,544,49,44
10366,levle3_61.jpg,fore,,,0,393,459,439,494,46,35
10367,levle3_61.jpg,fore,,,0,452,439,511,494,59,55
10368,levle3_61.jpg,fore,,,0,350,443,395,481,45,38
10369,levle3_61.jpg,fore,,,0,316,538,352,569,36,31
10370,levle3_61.jpg,fore,,,0,246,528,309,571,63,43
10371,levle3_61.jpg,fore,,,0,236,479,281,508,45,29
10372,levle3_61.jpg,fore,,,0,177,492,228,544,51,52
10373,levle3_61.jpg,fore,,,0,56,548,121,591,65,43
10374,levle3_61.jpg,fore,,,0,135,554,173,615,38,61
10375,levle3_61.jpg,fore,,,0,234,400,289,453,55,53
10376,levle3_61.jpg,fore,,,0,295,420,342,475,47,55
10377,levle3_61.jpg,fore,,,0,330,388,389,429,59,41
10378,levle3_61.jpg,fore,,,0,88,329,143,388,55,59
10379,levle3_61.jpg,fore,,,0,287,345,358,394,71,49
10380,levle3_61.jpg,fore,,,0,356,286,417,329,61,43
10381,levle3_61.jpg,fore,,,0,376,353,429,392,53,39
10382,levle3_61.jpg,fore,,,0,366,252,417,305,51,53
10383,levle3_61.jpg,fore,,,0,316,236,358,276,42,40
10384,levle3_61.jpg,fore,,,0,326,201,372,246,46,45
10385,levle3_61.jpg,fore,,,0,395,148,448,177,53,29
10386,levle3_61.jpg,fore,,,0,443,154,490,207,47,53
10387,levle3_61.jpg,fore,,,0,253,158,320,197,67,39
10388,levle3_61.jpg,fore,,,0,82,427,129,465,47,38
10389,levle3_61.jpg,fore,,,0,383,73,429,146,46,73
10390,levle3_61.jpg,fore,,,0,446,41,511,102,65,61
10391,levle3_61.jpg,fore,,,0,530,456,577,498,47,42
10392,levle3_61.jpg,fore,,,0,66,295,94,320,28,25
10393,levle3_61.jpg,fore,,,0,88,268,138,301,50,33
10394,levle3_61.jpg,fore,,,0,188,229,210,260,22,31
10395,levle3_61.jpg,fore,,,0,196,261,226,286,30,25
10396,levle3_61.jpg,fore,,,0,177,302,214,334,37,32
10397,levle3_61.jpg,fore,,,0,171,375,203,411,32,36
10398,levle3_61.jpg,fore,,,0,152,413,178,442,26,29
10399,levle3_61.jpg,fore,,,0,135,386,158,430,23,44
10400,levle3_61.jpg,fore,,,0,108,468,134,494,26,26
10401,levle3_61.jpg,fore,,,0,85,484,110,511,25,27
10402,levle3_61.jpg,fore,,,0,104,506,157,556,53,50
10403,levle3_61.jpg,fore,,,0,216,323,264,374,48,51
10404,levle3_61.jpg,fore,,,0,272,310,319,346,47,36
10405,levle3_61.jpg,fore,,,0,322,316,345,347,23,31
10406,levle3_61.jpg,fore,,,0,357,331,392,361,35,30
10407,levle3_61.jpg,fore,,,0,335,302,359,324,24,22
10408,levle3_61.jpg,fore,,,0,325,271,354,302,29,31
10409,levle3_61.jpg,fore,,,0,270,231,298,268,28,37
10410,levle3_61.jpg,fore,,,0,287,264,316,292,29,28
10411,levle3_61.jpg,fore,,,0,392,194,429,227,37,33
10412,levle3_61.jpg,fore,,,0,427,253,471,285,44,32
10413,levle3_61.jpg,fore,,,0,485,131,552,169,67,38
10414,levle3_61.jpg,fore,,,0,308,488,358,536,50,48
10415,levle3_61.jpg,fore,,,0,9,368,42,421,33,53
10416,levle3_61.jpg,fore,,,0,9,422,57,452,48,30
10417,levle3_61.jpg,fore,,,0,573,39,609,76,36,37
10418,levle3_61.jpg,fore,,,0,503,396,542,457,39,61
10419,levle1_320.jpg,fore,Unspecified,0.0,0,754,305,899,535,145,230
10420,levle1_320.jpg,fore,Unspecified,0.0,0,386,2259,547,2389,161,130
10421,levle1_320.jpg,fore,Unspecified,0.0,0,486,2420,631,2504,145,84
10422,levle1_320.jpg,fore,Unspecified,0.0,0,424,2619,539,2780,115,161
10423,levle1_320.jpg,fore,Unspecified,0.0,0,1091,2918,1214,3110,123,192
10424,levle1_320.jpg,fore,Unspecified,0.0,0,1267,2895,1428,3033,161,138
10425,levle1_320.jpg,fore,Unspecified,0.0,0,1765,3110,1873,3301,108,191
10426,levle1_320.jpg,fore,Unspecified,0.0,0,562,2558,692,2727,130,169
10427,levle0_133.jpg,fore,Unspecified,0.0,0,2325,2681,2432,2796,107,115
10428,levle1_446.jpg,fore,Unspecified,0.0,0,1443,527,1643,696,200,169
10429,levle1_446.jpg,fore,Unspecified,0.0,0,2233,1071,2424,1278,191,207
10430,levle1_446.jpg,fore,Unspecified,0.0,0,2263,1945,2455,2037,192,92
10431,levle1_446.jpg,fore,Unspecified,0.0,0,2340,2029,2478,2160,138,131
10432,levle1_446.jpg,fore,Unspecified,0.0,0,2164,2198,2302,2336,138,138
10433,levle1_446.jpg,fore,Unspecified,0.0,0,2302,2290,2432,2412,130,122
10434,levle1_446.jpg,fore,Unspecified,0.0,0,2547,2397,2662,2497,115,100
10435,levle1_446.jpg,fore,Unspecified,0.0,0,1919,2397,2095,2619,176,222
10436,levle1_446.jpg,fore,Unspecified,0.0,0,2095,2481,2279,2650,184,169
10437,levle1_446.jpg,fore,Unspecified,0.0,0,2263,2673,2378,2765,115,92
10438,levle1_446.jpg,fore,Unspecified,0.0,0,2455,2673,2601,2803,146,130
10439,levle1_446.jpg,fore,Unspecified,0.0,0,1781,3033,2041,3179,260,146
10440,levle1_452.jpg,fore,Unspecified,0.0,0,251,248,285,278,34,30
10441,levle1_452.jpg,fore,Unspecified,0.0,0,239,214,259,237,20,23
10442,levle1_452.jpg,fore,Unspecified,0.0,0,255,98,276,117,21,19
10443,levle1_452.jpg,fore,Unspecified,0.0,0,251,77,275,94,24,17
10444,levle1_452.jpg,fore,Unspecified,0.0,0,276,80,295,101,19,21
10445,levle1_452.jpg,fore,Unspecified,0.0,0,300,98,310,117,10,19
10446,levle1_452.jpg,fore,Unspecified,0.0,0,333,36,357,55,24,19
10447,levle1_334.jpg,fore,Unspecified,0.0,0,1375,865,1512,995,137,130
10448,levle1_334.jpg,fore,Unspecified,0.0,0,1382,1133,1512,1232,130,99
10449,levle1_334.jpg,fore,Unspecified,0.0,0,1926,1171,2034,1294,108,123
10450,levle1_334.jpg,fore,Unspecified,0.0,0,1980,1309,2072,1416,92,107
10451,levle1_334.jpg,fore,Unspecified,0.0,0,2202,1278,2294,1416,92,138
10452,levle1_334.jpg,fore,Unspecified,0.0,0,1321,2497,1413,2566,92,69
10453,levle1_334.jpg,fore,Unspecified,0.0,0,1244,3133,1336,3232,92,99
10454,levle0_127.jpg,fore,Unspecified,0.0,0,2693,2121,2853,2313,160,192
10455,levle0_127.jpg,fore,Unspecified,0.0,0,1597,2964,1765,3102,168,138
10456,levle3_75.jpg,fore,,,0,542,704,594,759,52,55
10457,levle3_75.jpg,fore,,,0,578,662,646,720,68,58
10458,levle3_75.jpg,fore,,,0,610,639,672,688,62,49
10459,levle3_75.jpg,fore,,,0,649,558,679,580,30,22
10460,levle3_75.jpg,fore,,,0,714,509,757,571,43,62
10461,levle3_75.jpg,fore,,,0,747,525,822,584,75,59
10462,levle3_75.jpg,fore,,,0,1182,762,1234,824,52,62
10463,levle3_75.jpg,fore,,,0,1043,782,1101,834,58,52
10464,levle3_75.jpg,fore,,,0,864,788,929,856,65,68
10465,levle3_75.jpg,fore,,,0,864,746,896,785,32,39
10466,levle3_75.jpg,fore,,,0,893,691,961,756,68,65
10467,levle3_75.jpg,fore,,,0,867,710,913,756,46,46
10468,levle3_75.jpg,fore,,,0,867,658,926,717,59,59
10469,levle3_75.jpg,fore,,,0,877,606,893,649,16,43
10470,levle3_75.jpg,fore,,,0,792,577,831,616,39,39
10471,levle3_75.jpg,fore,,,0,766,603,815,665,49,62
10472,levle3_75.jpg,fore,,,0,672,658,708,694,36,36
10473,levle3_75.jpg,fore,,,0,692,675,718,717,26,42
10474,levle3_75.jpg,fore,,,0,640,746,711,804,71,58
10475,levle3_75.jpg,fore,,,0,640,691,708,739,68,48
10476,levle3_75.jpg,fore,,,0,757,652,812,697,55,45
10477,levle3_75.jpg,fore,,,0,705,665,763,704,58,39
10478,levle3_75.jpg,fore,,,0,708,688,770,736,62,48
10479,levle3_75.jpg,fore,,,0,744,710,805,762,61,52
10480,levle3_75.jpg,fore,,,0,799,691,880,726,81,35
10481,levle3_75.jpg,fore,,,0,792,723,857,775,65,52
10482,levle3_75.jpg,fore,,,0,727,765,779,811,52,46
10483,levle3_75.jpg,fore,,,0,792,746,848,811,56,65
10484,levle3_75.jpg,fore,,,0,688,580,753,658,65,78
10485,levle3_75.jpg,fore,,,0,1189,631,1244,677,55,46
10486,levle3_75.jpg,fore,,,0,915,614,951,653,36,39
10487,levle3_75.jpg,fore,,,0,998,719,1043,762,45,43
10488,levle3_75.jpg,fore,,,0,974,788,1024,823,50,35
10489,levle3_75.jpg,fore,,,0,635,602,669,648,34,46
10490,levle3_75.jpg,fore,,,0,848,416,897,451,49,35
10491,levle3_75.jpg,fore,,,0,729,388,768,425,39,37
10492,levle3_75.jpg,fore,,,0,1352,456,1398,508,46,52
10493,levle3_75.jpg,fore,,,0,1368,357,1428,419,60,62
10494,levle3_75.jpg,fore,,,0,1315,327,1366,380,51,53
10495,levle3_75.jpg,fore,,,0,1411,276,1452,327,41,51
10496,levle3_75.jpg,fore,,,0,1234,179,1306,230,72,51
10497,levle3_75.jpg,fore,,,0,1117,160,1177,216,60,56
10498,levle3_75.jpg,fore,,,0,1131,231,1181,282,50,51
10499,levle3_75.jpg,fore,,,0,1295,127,1355,180,60,53
10500,levle3_75.jpg,fore,,,0,1324,197,1397,259,73,62
10501,levle3_75.jpg,fore,,,0,1395,185,1452,237,57,52
10502,levle3_75.jpg,fore,,,0,1432,142,1501,191,69,49
10503,levle3_75.jpg,fore,,,0,1375,147,1432,190,57,43
10504,levle3_75.jpg,fore,,,0,1449,279,1500,331,51,52
10505,levle3_75.jpg,fore,,,0,1304,420,1358,483,54,63
10506,levle3_75.jpg,fore,,,0,929,651,977,696,48,45
10507,levle3_75.jpg,fore,,,0,866,471,931,545,65,74
10508,levle3_75.jpg,fore,,,0,574,588,632,640,58,52
10509,levle3_75.jpg,fore,,,0,764,462,851,527,87,65
10510,levle3_75.jpg,fore,,,0,1244,148,1292,183,48,35
10511,levle3_75.jpg,fore,,,0,712,100,758,145,46,45
10512,levle3_75.jpg,fore,,,0,643,116,683,154,40,38
10513,levle3_75.jpg,fore,,,0,683,82,717,140,34,58
10514,levle3_75.jpg,fore,,,0,764,53,835,80,71,27
10515,levle3_75.jpg,fore,,,0,858,568,906,610,48,42
10516,levle3_49.jpg,fore,,,0,244,20,278,40,34,20
10517,levle3_49.jpg,fore,,,0,252,63,256,67,4,4
10518,levle3_49.jpg,fore,,,0,226,45,256,65,30,20
10519,levle3_49.jpg,fore,,,0,195,33,236,69,41,36
10520,levle3_49.jpg,fore,,,0,230,97,264,124,34,27
10521,levle3_49.jpg,fore,,,0,199,124,234,140,35,16
10522,levle3_49.jpg,fore,,,0,193,140,226,169,33,29
10523,levle3_49.jpg,fore,,,0,171,157,195,178,24,21
10524,levle3_49.jpg,fore,,,0,182,174,207,202,25,28
10525,levle3_49.jpg,fore,,,0,221,172,258,196,37,24
10526,levle3_49.jpg,fore,,,0,219,212,251,240,32,28
10527,levle3_49.jpg,fore,,,0,210,236,238,257,28,21
10528,levle3_49.jpg,fore,,,0,195,242,228,272,33,30
10529,levle3_49.jpg,fore,,,0,185,270,215,294,30,24
10530,levle3_49.jpg,fore,,,0,169,277,202,318,33,41
10531,levle3_49.jpg,fore,,,0,263,322,296,350,33,28
10532,levle3_49.jpg,fore,,,0,312,391,346,421,34,30
10533,levle3_49.jpg,fore,,,0,133,129,147,149,14,20
10534,levle3_49.jpg,fore,,,0,150,136,182,174,32,38
10535,levle3_49.jpg,fore,,,0,155,188,186,216,31,28
10536,levle3_49.jpg,fore,,,0,161,218,195,244,34,26
10537,levle3_49.jpg,fore,,,0,119,238,154,262,35,24
10538,levle3_49.jpg,fore,,,0,256,200,288,233,32,33
10539,levle3_49.jpg,fore,,,0,284,233,318,256,34,23
10540,levle3_49.jpg,fore,,,0,303,266,335,301,32,35
10541,levle3_49.jpg,fore,,,0,264,257,299,286,35,29
10542,levle3_49.jpg,fore,,,0,272,282,312,319,40,37
10543,levle3_49.jpg,fore,,,0,364,268,401,303,37,35
10544,levle3_49.jpg,fore,,,0,278,413,310,443,32,30
10545,levle3_49.jpg,fore,,,0,308,429,334,462,26,33
10546,levle3_49.jpg,fore,,,0,350,414,375,438,25,24
10547,levle3_49.jpg,fore,,,0,348,434,387,472,39,38
10548,levle3_49.jpg,fore,,,0,187,60,215,91,28,31
10549,levle3_49.jpg,fore,,,0,147,68,174,88,27,20
10550,levle3_49.jpg,fore,,,0,173,30,196,54,23,24
10551,levle3_49.jpg,fore,,,0,214,14,241,34,27,20
10552,levle3_49.jpg,fore,,,0,340,315,369,335,29,20
10553,levle3_49.jpg,fore,,,0,224,380,264,408,40,28
10554,levle3_49.jpg,fore,,,0,413,404,437,426,24,22
10555,levle3_49.jpg,fore,,,0,411,455,431,473,20,18
10556,levle3_49.jpg,fore,,,0,332,360,369,384,37,24
10557,levle3_49.jpg,fore,,,0,245,240,272,261,27,21
10558,levle3_49.jpg,fore,,,0,227,258,263,282,36,24
10559,levle3_49.jpg,fore,,,0,238,144,261,175,23,31
10560,levle3_49.jpg,fore,,,0,256,138,280,163,24,25
10561,levle3_49.jpg,fore,,,0,392,432,410,455,18,23
10562,levle3_49.jpg,fore,,,0,336,209,361,234,25,25
10563,levle3_49.jpg,fore,,,0,290,319,320,344,30,25
10564,levle3_49.jpg,fore,,,0,226,346,242,366,16,20
10565,levle3_49.jpg,fore,,,0,270,393,295,410,25,17
10566,levle3_49.jpg,fore,,,0,396,459,412,475,16,16
10567,levle3_49.jpg,fore,,,0,208,353,229,371,21,18
10568,levle3_49.jpg,fore,,,0,230,365,250,382,20,17
10569,levle3_49.jpg,fore,,,0,172,256,189,270,17,14
10570,levle3_49.jpg,fore,,,0,161,249,178,262,17,13
10571,levle3_49.jpg,fore,,,0,285,215,306,236,21,21
10572,levle3_49.jpg,fore,,,0,269,169,286,184,17,15
10573,levle3_49.jpg,fore,,,0,195,222,214,236,19,14
10574,levle3_49.jpg,fore,,,0,252,304,280,322,28,18
10575,levle1_308.jpg,fore,Unspecified,0.0,0,1942,2558,2087,2734,145,176
10576,levle1_308.jpg,fore,Unspecified,0.0,0,1298,2872,1482,3018,184,146
10577,levle1_308.jpg,fore,Unspecified,0.0,0,1420,964,1505,1087,85,123
10578,levle1_308.jpg,fore,Unspecified,0.0,0,1390,750,1528,865,138,115
10579,levle1_308.jpg,fore,Unspecified,0.0,0,1712,727,1819,857,107,130
10580,levle1_308.jpg,fore,Unspecified,0.0,0,1589,3133,1773,3217,184,84
10581,levle1_478.jpg,fore,Unspecified,0.0,0,1543,2412,1650,2497,107,85
10582,levle1_478.jpg,fore,Unspecified,0.0,0,1712,2458,1765,2558,53,100
10583,levle1_478.jpg,fore,Unspecified,0.0,0,1796,2451,1903,2558,107,107
10584,levle1_478.jpg,fore,Unspecified,0.0,0,1857,2550,1934,2612,77,62
10585,levle1_478.jpg,fore,Unspecified,0.0,0,1758,2604,1819,2734,61,130
10586,levle1_478.jpg,fore,Unspecified,0.0,0,1873,2658,2011,2711,138,53
10587,levle1_478.jpg,fore,Unspecified,0.0,0,1903,2727,2041,2826,138,99
10588,levle1_478.jpg,fore,Unspecified,0.0,0,2064,2635,2141,2719,77,84
10589,levle1_478.jpg,fore,Unspecified,0.0,0,2087,2773,2164,2918,77,145
10590,levle1_478.jpg,fore,Unspecified,0.0,0,1972,2336,2064,2428,92,92
10591,levle1_478.jpg,fore,Unspecified,0.0,0,2057,2466,2217,2650,160,184
10592,levle0_119.jpg,fore,Unspecified,0.0,0,2700,1232,2815,1416,115,184
10593,levle1_444.jpg,fore,Unspecified,0.0,0,3217,932,3384,1125,167,193
10594,levle1_444.jpg,fore,Unspecified,0.0,0,3253,2073,3358,2169,105,96
10595,levle1_444.jpg,fore,Unspecified,0.0,0,3437,2187,3542,2336,105,149
10596,levle1_444.jpg,fore,Unspecified,0.0,0,3568,2459,3630,2608,62,149
10597,levle1_444.jpg,fore,Unspecified,0.0,0,3674,2424,3761,2546,87,122
10598,levle1_444.jpg,fore,Unspecified,0.0,0,3095,2397,3226,2529,131,132
10599,levle0_131.jpg,fore,Unspecified,0.0,0,1704,2995,1804,3163,100,168
10600,levle0_131.jpg,fore,Unspecified,0.0,0,1581,2359,1696,2481,115,122
10601,levle1_322.jpg,fore,Unspecified,0.0,0,2394,2229,2478,2389,84,160
10602,levle1_322.jpg,fore,Unspecified,0.0,0,2723,2274,2807,2412,84,138
10603,levle1_322.jpg,fore,Unspecified,0.0,0,2478,2443,2624,2596,146,153
10604,levle1_322.jpg,fore,Unspecified,0.0,0,2754,2451,2869,2573,115,122
10605,levle1_322.jpg,fore,Unspecified,0.0,0,2202,3079,2271,3255,69,176
10606,levle1_322.jpg,fore,Unspecified,0.0,0,2018,3171,2187,3363,169,192
10607,levle1_322.jpg,fore,Unspecified,0.0,0,1329,1033,1497,1171,168,138
10608,levle3_63.jpg,fore,,,0,161,42,185,66,24,24
10609,levle3_63.jpg,fore,,,0,124,188,146,200,22,12
10610,levle3_63.jpg,fore,,,0,126,122,141,139,15,17
10611,levle3_63.jpg,fore,,,0,153,216,176,233,23,17
10612,levle3_63.jpg,fore,,,0,136,226,154,249,18,23
10613,levle3_63.jpg,fore,,,0,96,181,115,202,19,21
10614,levle3_63.jpg,fore,,,0,70,151,87,168,17,17
10615,levle3_63.jpg,fore,,,0,60,250,78,269,18,19
10616,levle3_63.jpg,fore,,,0,33,259,48,276,15,17
10617,levle3_63.jpg,fore,,,0,56,277,70,296,14,19
10618,levle3_63.jpg,fore,,,0,9,103,23,122,14,19
10619,levle3_63.jpg,fore,,,0,22,177,36,197,14,20
10620,levle3_63.jpg,fore,,,0,119,67,147,91,28,24
10621,levle3_63.jpg,fore,,,0,145,84,164,106,19,22
10622,levle3_63.jpg,fore,,,0,70,66,97,87,27,21
10623,levle3_63.jpg,fore,,,0,19,72,47,94,28,22
10624,levle3_63.jpg,fore,,,0,67,109,92,127,25,18
10625,levle3_63.jpg,fore,,,0,28,125,57,150,29,25
10626,levle3_63.jpg,fore,,,0,57,178,75,196,18,18
10627,levle3_63.jpg,fore,,,0,61,199,89,222,28,23
10628,levle3_63.jpg,fore,,,0,97,163,113,180,16,17
10629,levle3_63.jpg,fore,,,0,3,209,36,252,33,43
10630,levle3_63.jpg,fore,,,0,115,256,136,278,21,22
10631,levle3_63.jpg,fore,,,0,152,269,180,290,28,21
10632,levle3_63.jpg,fore,,,0,157,252,173,267,16,15
10633,levle3_63.jpg,fore,,,0,142,314,161,338,19,24
10634,levle3_63.jpg,fore,,,0,90,111,114,133,24,22
10635,levle3_63.jpg,fore,,,0,33,38,53,54,20,16
10636,levle3_63.jpg,fore,,,0,70,30,102,57,32,27
10637,levle3_63.jpg,fore,,,0,3,12,31,39,28,27
10638,levle3_63.jpg,fore,,,0,153,130,166,145,13,15
10639,levle3_63.jpg,fore,,,0,110,93,124,106,14,13
10640,levle3_63.jpg,fore,,,0,124,97,140,107,16,10
10641,levle3_63.jpg,fore,,,0,150,65,171,81,21,16
10642,levle3_63.jpg,fore,,,0,59,130,82,146,23,16
10643,levle3_63.jpg,fore,,,0,94,227,108,242,14,15
10644,levle3_63.jpg,fore,,,0,118,235,130,247,12,12
10645,levle3_63.jpg,fore,,,0,181,244,198,260,17,16
10646,levle3_63.jpg,fore,,,0,178,260,195,277,17,17
10647,levle3_63.jpg,fore,,,0,76,282,92,300,16,18
10648,levle3_63.jpg,fore,,,0,63,299,78,307,15,8
10649,levle3_63.jpg,fore,,,0,63,307,81,317,18,10
10650,levle3_63.jpg,fore,,,0,45,297,59,312,14,15
10651,levle3_63.jpg,fore,,,0,41,319,58,337,17,18
10652,levle3_63.jpg,fore,,,0,16,267,29,280,13,13
10653,levle3_63.jpg,fore,,,0,114,133,132,150,18,17
10654,levle3_63.jpg,fore,,,0,124,41,146,57,22,16
10655,levle3_63.jpg,fore,,,0,37,239,52,254,15,15
10656,levle3_63.jpg,fore,,,0,41,174,58,190,17,16
10657,levle3_63.jpg,fore,,,0,25,165,41,176,16,11
10658,levle3_63.jpg,fore,,,0,35,152,51,164,16,12
10659,levle3_63.jpg,fore,,,0,125,1,140,12,15,11
10660,levle3_63.jpg,fore,,,0,140,31,159,44,19,13
10661,levle3_63.jpg,fore,,,0,92,1,106,15,14,14
10662,levle3_63.jpg,fore,,,0,63,11,81,24,18,13
10663,levle3_63.jpg,fore,,,0,138,6,150,19,12,13
10664,levle3_63.jpg,fore,,,0,129,16,146,29,17,13
10665,levle3_63.jpg,fore,,,0,42,111,55,124,13,13
10666,levle3_63.jpg,fore,,,0,92,90,108,109,16,19
10667,levle3_63.jpg,fore,,,0,159,1,175,13,16,12
10668,levle3_63.jpg,fore,,,0,165,86,181,102,16,16
10669,levle3_63.jpg,fore,,,0,244,258,263,276,19,18
10670,levle3_63.jpg,fore,,,0,207,256,225,277,18,21
10671,levle3_63.jpg,fore,,,0,86,207,103,224,17,17
10672,levle3_77.jpg,fore,,,0,344,50,365,87,21,37
10673,levle3_77.jpg,fore,,,0,334,106,359,144,25,38
10674,levle3_77.jpg,fore,,,0,397,17,418,31,21,14
10675,levle3_77.jpg,fore,,,0,418,33,440,48,22,15
10676,levle3_77.jpg,fore,,,0,265,288,301,334,36,46
10677,levle3_77.jpg,fore,,,0,329,351,363,386,34,35
10678,levle3_77.jpg,fore,,,0,317,473,337,502,20,29
10679,levle3_77.jpg,fore,,,0,284,466,310,502,26,36
10680,levle3_77.jpg,fore,,,0,342,523,394,564,52,41
10681,levle3_77.jpg,fore,,,0,382,535,413,574,31,39
10682,levle3_77.jpg,fore,,,0,416,506,450,555,34,49
10683,levle3_77.jpg,fore,,,0,454,564,490,600,36,36
10684,levle3_77.jpg,fore,,,0,512,254,531,285,19,31
10685,levle3_77.jpg,fore,,,0,442,250,476,279,34,29
10686,levle3_77.jpg,fore,,,0,476,293,514,327,38,34
10687,levle3_77.jpg,fore,,,0,459,317,498,355,39,38
10688,levle3_77.jpg,fore,,,0,514,319,562,358,48,39
10689,levle3_77.jpg,fore,,,0,359,249,401,297,42,48
10690,levle3_77.jpg,fore,,,0,346,201,385,231,39,30
10691,levle3_77.jpg,fore,,,0,320,252,356,290,36,38
10692,levle3_77.jpg,fore,,,0,289,231,330,278,41,47
10693,levle3_77.jpg,fore,,,0,269,194,303,235,34,41
10694,levle3_77.jpg,fore,,,0,358,387,401,439,43,52
10695,levle3_77.jpg,fore,,,0,368,353,419,399,51,46
10696,levle3_77.jpg,fore,,,0,437,422,454,441,17,19
10697,levle3_77.jpg,fore,,,0,445,459,497,506,52,47
10698,levle3_77.jpg,fore,,,0,353,475,404,525,51,50
10699,levle3_77.jpg,fore,,,0,389,583,442,617,53,34
10700,levle3_77.jpg,fore,,,0,488,542,529,593,41,51
10701,levle3_77.jpg,fore,,,0,459,603,505,641,46,38
10702,levle3_77.jpg,fore,,,0,524,593,555,633,31,40
10703,levle3_77.jpg,fore,,,0,443,648,476,682,33,34
10704,levle3_77.jpg,fore,,,0,515,686,545,708,30,22
10705,levle3_77.jpg,fore,,,0,507,732,531,756,24,24
10706,levle3_77.jpg,fore,,,0,526,363,546,398,20,35
10707,levle3_77.jpg,fore,,,0,546,437,577,485,31,48
10708,levle3_77.jpg,fore,,,0,245,470,275,507,30,37
10709,levle3_77.jpg,fore,,,0,263,379,288,403,25,24
10710,levle3_77.jpg,fore,,,0,255,323,281,354,26,31
10711,levle3_77.jpg,fore,,,0,206,281,235,304,29,23
10712,levle3_77.jpg,fore,,,0,391,314,425,350,34,36
10713,levle3_77.jpg,fore,,,0,412,402,443,433,31,31
10714,levle3_77.jpg,fore,,,0,476,392,498,422,22,30
10715,levle3_77.jpg,fore,,,0,378,61,409,79,31,18
10716,levle3_77.jpg,fore,,,0,401,70,426,90,25,20
10717,levle3_77.jpg,fore,,,0,483,13,517,31,34,18
10718,levle3_77.jpg,fore,,,0,536,8,575,28,39,20
10719,levle3_77.jpg,fore,,,0,508,1,530,23,22,22
10720,levle3_77.jpg,fore,,,0,348,94,381,118,33,24
10721,levle3_77.jpg,fore,,,0,426,49,456,69,30,20
10722,levle3_77.jpg,fore,,,0,316,142,338,172,22,30
10723,levle3_77.jpg,fore,,,0,419,261,439,287,20,26
10724,levle3_77.jpg,fore,,,0,401,280,430,305,29,25
10725,levle3_77.jpg,fore,,,0,430,317,456,337,26,20
10726,levle3_77.jpg,fore,,,0,431,340,460,366,29,26
10727,levle3_77.jpg,fore,,,0,437,284,462,309,25,25
10728,levle3_77.jpg,fore,,,0,354,571,377,597,23,26
10729,levle3_77.jpg,fore,,,0,551,630,580,654,29,24
10730,levle3_77.jpg,fore,,,0,501,631,531,657,30,26
10731,levle3_77.jpg,fore,,,0,503,608,525,630,22,22
10732,levle3_77.jpg,fore,,,0,490,673,515,693,25,20
10733,levle3_77.jpg,fore,,,0,554,394,575,421,21,27
10734,levle3_77.jpg,fore,,,0,322,327,350,348,28,21
10735,levle0_125.jpg,fore,Unspecified,0.0,0,1589,2389,1712,2520,123,131
10736,levle0_125.jpg,fore,Unspecified,0.0,0,1842,2481,1972,2573,130,92
10737,levle0_125.jpg,fore,Unspecified,0.0,0,2003,2857,2164,2979,161,122
10738,levle1_336.jpg,fore,Unspecified,0.0,0,807,2650,922,2780,115,130
10739,levle1_336.jpg,fore,Unspecified,0.0,0,738,2535,815,2673,77,138
10740,levle1_336.jpg,fore,Unspecified,0.0,0,624,2474,715,2619,91,145
10741,levle1_336.jpg,fore,Unspecified,0.0,0,715,2374,792,2504,77,130
10742,levle1_336.jpg,fore,Unspecified,0.0,0,601,2320,677,2435,76,115
10743,levle1_336.jpg,fore,Unspecified,0.0,0,1359,2305,1466,2397,107,92
10744,levle1_450.jpg,fore,Unspecified,0.0,0,1114,1294,1298,1439,184,145
10745,levle1_450.jpg,fore,Unspecified,0.0,0,2225,658,2440,842,215,184
10746,levle1_450.jpg,fore,Unspecified,0.0,0,1934,497,2118,696,184,199
10747,levle1_450.jpg,fore,Unspecified,0.0,0,2601,635,2784,887,183,252
10748,levle1_450.jpg,fore,Unspecified,0.0,0,1221,2052,1428,2183,207,131
10749,levle1_450.jpg,fore,Unspecified,0.0,0,1091,2037,1206,2190,115,153
10750,levle1_450.jpg,fore,Unspecified,0.0,0,984,2443,1214,2596,230,153
10751,levle1_450.jpg,fore,Unspecified,0.0,0,1911,2489,2087,2673,176,184
10752,levle3_88.jpg,fore,,,0,460,434,523,504,63,70
10753,levle3_88.jpg,fore,,,0,503,416,560,463,57,47
10754,levle3_88.jpg,fore,,,0,383,504,409,553,26,49
10755,levle3_88.jpg,fore,,,0,315,490,354,520,39,30
10756,levle3_88.jpg,fore,,,0,389,445,430,492,41,47
10757,levle3_88.jpg,fore,,,0,348,381,411,449,63,68
10758,levle3_88.jpg,fore,,,0,246,284,336,367,90,83
10759,levle3_88.jpg,fore,,,0,264,373,317,418,53,45
10760,levle3_88.jpg,fore,,,0,252,428,311,477,59,49
10761,levle3_88.jpg,fore,,,0,217,404,260,445,43,41
10762,levle3_88.jpg,fore,,,0,220,473,256,520,36,47
10763,levle3_88.jpg,fore,,,0,262,479,313,528,51,49
10764,levle3_88.jpg,fore,,,0,271,524,328,563,57,39
10765,levle3_88.jpg,fore,,,0,289,547,332,596,43,49
10766,levle3_88.jpg,fore,,,0,330,530,370,571,40,41
10767,levle3_88.jpg,fore,,,0,399,492,432,526,33,34
10768,levle3_88.jpg,fore,,,0,432,508,472,561,40,53
10769,levle3_88.jpg,fore,,,0,409,573,479,641,70,68
10770,levle3_88.jpg,fore,,,0,336,573,366,606,30,33
10771,levle3_88.jpg,fore,,,0,289,616,344,673,55,57
10772,levle3_88.jpg,fore,,,0,313,651,356,702,43,51
10773,levle3_88.jpg,fore,,,0,330,702,397,763,67,61
10774,levle3_88.jpg,fore,,,0,234,679,289,732,55,53
10775,levle3_88.jpg,fore,,,0,234,636,295,696,61,60
10776,levle3_88.jpg,fore,,,0,281,724,340,781,59,57
10777,levle3_88.jpg,fore,,,0,346,632,409,694,63,62
10778,levle3_88.jpg,fore,,,0,401,702,454,753,53,51
10779,levle3_88.jpg,fore,,,0,389,806,436,867,47,61
10780,levle3_88.jpg,fore,,,0,419,785,511,853,92,68
10781,levle3_88.jpg,fore,,,0,428,845,495,910,67,65
10782,levle3_88.jpg,fore,,,0,562,667,607,718,45,51
10783,levle3_88.jpg,fore,,,0,387,178,413,204,26,26
10784,levle3_88.jpg,fore,,,0,631,64,663,86,32,22
10785,levle3_88.jpg,fore,,,0,604,30,639,66,35,36
10786,levle3_88.jpg,fore,,,0,570,23,599,55,29,32
10787,levle3_88.jpg,fore,,,0,568,58,604,90,36,32
10788,levle3_88.jpg,fore,,,0,526,82,572,106,46,24
10789,levle3_88.jpg,fore,,,0,500,80,532,107,32,27
10790,levle3_88.jpg,fore,,,0,514,28,549,54,35,26
10791,levle3_88.jpg,fore,,,0,502,50,539,74,37,24
10792,levle3_88.jpg,fore,,,0,476,53,503,78,27,25
10793,levle3_88.jpg,fore,,,0,464,81,499,104,35,23
10794,levle3_88.jpg,fore,,,0,434,161,461,184,27,23
10795,levle3_88.jpg,fore,,,0,227,347,261,373,34,26
10796,levle3_88.jpg,fore,,,0,319,415,346,445,27,30
10797,levle3_88.jpg,fore,,,0,250,530,283,557,33,27
10798,levle3_88.jpg,fore,,,0,308,840,338,878,30,38
10799,levle3_88.jpg,fore,,,0,397,873,424,905,27,32
10800,levle3_88.jpg,fore,,,0,470,728,511,759,41,31
10801,levle3_88.jpg,fore,,,0,499,656,527,680,28,24
10802,levle3_88.jpg,fore,,,0,444,648,482,683,38,35
10803,levle3_88.jpg,fore,,,0,405,664,438,692,33,28
10804,levle3_88.jpg,fore,,,0,538,783,566,812,28,29
10805,levle3_88.jpg,fore,,,0,502,820,534,848,32,28
10806,levle3_88.jpg,fore,,,0,300,259,334,292,34,33
10807,levle3_88.jpg,fore,,,0,337,222,370,257,33,35
10808,levle3_88.jpg,fore,,,0,371,142,403,169,32,27
10809,levle3_88.jpg,fore,,,0,548,132,583,159,35,27
10810,levle3_88.jpg,fore,,,0,650,625,676,659,26,34
10811,levle3_88.jpg,fore,,,0,506,515,546,548,40,33
10812,levle3_88.jpg,fore,,,0,479,529,506,559,27,30
10813,levle3_88.jpg,fore,,,0,318,461,351,496,33,35
10814,levle3_88.jpg,fore,,,0,348,448,373,476,25,28
10815,levle3_88.jpg,fore,,,0,377,589,417,626,40,37
10816,levle1_487.jpg,fore,Unspecified,0.0,0,2348,2106,2532,2229,184,123
10817,levle1_487.jpg,fore,Unspecified,0.0,0,2194,2114,2386,2229,192,115
10818,levle1_487.jpg,fore,Unspecified,0.0,0,2302,1953,2440,2083,138,130
10819,levle1_487.jpg,fore,Unspecified,0.0,0,1903,1983,2125,2083,222,100
10820,levle1_487.jpg,fore,Unspecified,0.0,0,2072,2244,2263,2336,191,92
10821,levle1_487.jpg,fore,Unspecified,0.0,0,2240,2305,2332,2405,92,100
10822,levle1_487.jpg,fore,Unspecified,0.0,0,2378,2251,2532,2366,154,115
10823,levle1_487.jpg,fore,Unspecified,0.0,0,2102,2366,2279,2512,177,146
10824,levle1_487.jpg,fore,Unspecified,0.0,0,2141,2504,2340,2612,199,108
10825,levle1_487.jpg,fore,Unspecified,0.0,0,2332,2435,2608,2604,276,169
10826,levle1_487.jpg,fore,Unspecified,0.0,0,2363,1631,2555,1799,192,168
10827,levle1_487.jpg,fore,Unspecified,0.0,0,1804,2236,1903,2320,99,84
10828,levle1_493.jpg,fore,Unspecified,0.0,0,447,1684,532,1838,85,154
10829,levle1_493.jpg,fore,Unspecified,0.0,0,792,2152,1014,2221,222,69
10830,levle1_493.jpg,fore,Unspecified,0.0,0,769,2221,922,2359,153,138
10831,levle1_493.jpg,fore,Unspecified,0.0,0,685,2343,815,2489,130,146
10832,levle1_493.jpg,fore,Unspecified,0.0,0,685,1999,800,2137,115,138
10833,levle1_493.jpg,fore,Unspecified,0.0,0,1014,2183,1099,2297,85,114
10834,levle1_493.jpg,fore,Unspecified,0.0,0,976,2274,1068,2382,92,108
10835,levle1_493.jpg,fore,Unspecified,0.0,0,938,2374,1083,2527,145,153
10836,levle1_493.jpg,fore,Unspecified,0.0,0,1091,2405,1183,2512,92,107
10837,levle1_493.jpg,fore,Unspecified,0.0,0,1206,2497,1397,2688,191,191
10838,levle1_493.jpg,fore,Unspecified,0.0,0,1489,2206,1612,2313,123,107
10839,levle1_493.jpg,fore,Unspecified,0.0,0,1581,2029,1750,2236,169,207
10840,levle1_493.jpg,fore,Unspecified,0.0,0,1160,2190,1306,2343,146,153
10841,levle0_32.jpg,fore,Unspecified,0.0,0,1719,2451,1880,2619,161,168
10842,levle0_32.jpg,fore,Unspecified,0.0,0,1972,2075,2141,2267,169,192
10843,levle0_469.jpg,fore,Unspecified,0.0,0,1298,1102,1466,1317,168,215
10844,levle0_26.jpg,fore,Unspecified,0.0,0,1489,1792,1589,1991,100,199
10845,levle1_108.jpg,fore,Unspecified,0.0,0,2134,1502,2259,1660,125,158
10846,levle1_108.jpg,fore,Unspecified,0.0,0,3273,1992,3431,2108,158,116
10847,levle1_108.jpg,fore,Unspecified,0.0,0,2484,2823,2575,2964,91,141
10848,levle1_108.jpg,fore,Unspecified,0.0,0,2392,3097,2508,3239,116,142
10849,levle1_108.jpg,fore,Unspecified,0.0,0,2193,3014,2284,3156,91,142
10850,levle1_108.jpg,fore,Unspecified,0.0,0,2276,3031,2409,3189,133,158
10851,levle1_108.jpg,fore,Unspecified,0.0,0,2608,3056,2725,3164,117,108
10852,levle1_120.jpg,fore,Unspecified,0.0,0,3032,2009,3198,2225,166,216
10853,levle1_120.jpg,fore,Unspecified,0.0,0,2733,1942,2941,2108,208,166
10854,levle1_120.jpg,fore,Unspecified,0.0,0,2733,2100,2874,2142,141,42
10855,levle1_120.jpg,fore,Unspecified,0.0,0,2874,2167,3007,2291,133,124
10856,levle1_120.jpg,fore,Unspecified,0.0,0,2791,2366,2916,2482,125,116
10857,levle1_120.jpg,fore,Unspecified,0.0,0,2508,2150,2600,2241,92,91
10858,levle1_120.jpg,fore,Unspecified,0.0,0,2583,2590,2708,2723,125,133
10859,levle1_120.jpg,fore,Unspecified,0.0,0,2700,2599,2808,2790,108,191
10860,levle1_120.jpg,fore,Unspecified,0.0,0,2467,438,2641,579,174,141
10861,levle0_455.jpg,fore,Unspecified,0.0,0,1888,910,2102,1048,214,138
10862,levle0_455.jpg,fore,Unspecified,0.0,0,2141,1163,2309,1301,168,138
10863,levle0_455.jpg,fore,Unspecified,0.0,0,2378,1248,2486,1363,108,115
10864,levle0_455.jpg,fore,Unspecified,0.0,0,2447,1845,2601,2075,154,230
10865,levle0_455.jpg,fore,Unspecified,0.0,0,2225,1968,2355,2190,130,222
10866,levle0_441.jpg,fore,Unspecified,0.0,0,547,2328,738,2497,191,169
10867,levle0_441.jpg,fore,Unspecified,0.0,0,784,2865,961,3041,177,176
10868,levle0_441.jpg,fore,Unspecified,0.0,0,1198,3041,1405,3202,207,161
10869,levle1_134.jpg,fore,Unspecified,0.0,0,455,2481,570,2566,115,85
10870,levle1_134.jpg,fore,Unspecified,0.0,0,608,2688,784,2865,176,177
10871,levle1_134.jpg,fore,Unspecified,0.0,0,631,1983,731,2129,100,146
10872,levle1_134.jpg,fore,Unspecified,0.0,0,784,1799,884,1937,100,138
10873,levle1_134.jpg,fore,Unspecified,0.0,0,723,1638,830,1738,107,100
10874,levle1_134.jpg,fore,Unspecified,0.0,0,1589,1999,1696,2137,107,138
10875,levle1_134.jpg,fore,Unspecified,0.0,0,1306,1654,1405,1784,99,130
10876,levle1_134.jpg,fore,Unspecified,0.0,0,1168,1654,1275,1746,107,92
10877,levle1_134.jpg,fore,Unspecified,0.0,0,1145,1501,1237,1600,92,99
10878,levle1_134.jpg,fore,Unspecified,0.0,0,976,2765,1106,2857,130,92
10879,levle1_134.jpg,fore,Unspecified,0.0,0,1114,2888,1214,2987,100,99
10880,levle0_327.jpg,fore,Unspecified,0.0,0,1919,2788,2057,2934,138,146
10881,levle0_496.jpg,fore,Unspecified,0.0,0,1520,719,1666,857,146,138
10882,levle0_496.jpg,fore,Unspecified,0.0,0,1413,3179,1558,3294,145,115
10883,levle0_496.jpg,fore,Unspecified,0.0,0,1574,3286,1666,3409,92,123
10884,levle0_482.jpg,fore,Unspecified,0.0,0,1443,2796,1574,2849,131,53
10885,levle0_482.jpg,fore,Unspecified,0.0,0,1520,543,1704,635,184,92
10886,levle0_482.jpg,fore,Unspecified,0.0,0,1267,642,1420,727,153,85
10887,levle2_37.jpg,fore,Unspecified,0.0,0,1551,711,1666,819,115,108
10888,levle2_37.jpg,fore,Unspecified,0.0,0,1466,527,1589,757,123,230
10889,levle2_37.jpg,fore,Unspecified,0.0,0,1451,221,1597,343,146,122
10890,levle2_37.jpg,fore,Unspecified,0.0,0,1313,305,1413,458,100,153
10891,levle2_37.jpg,fore,Unspecified,0.0,0,1145,481,1359,566,214,85
10892,levle2_37.jpg,fore,Unspecified,0.0,0,1237,589,1375,696,138,107
10893,levle2_37.jpg,fore,Unspecified,0.0,0,1229,803,1352,941,123,138
10894,levle2_37.jpg,fore,Unspecified,0.0,0,1397,780,1528,895,131,115
10895,levle2_37.jpg,fore,Unspecified,0.0,0,999,681,1152,826,153,145
10896,levle2_37.jpg,fore,Unspecified,0.0,0,2210,872,2417,1056,207,184
10897,levle2_37.jpg,fore,Unspecified,0.0,0,2263,1056,2363,1163,100,107
10898,levle2_37.jpg,fore,Unspecified,0.0,0,2317,1125,2501,1301,184,176
10899,levle2_37.jpg,fore,Unspecified,0.0,0,2524,1010,2654,1156,130,146
10900,levle2_37.jpg,fore,Unspecified,0.0,0,2608,1002,2784,1133,176,131
10901,levle2_37.jpg,fore,Unspecified,0.0,0,2478,1194,2593,1340,115,146
10902,levle2_37.jpg,fore,Unspecified,0.0,0,2616,1163,2777,1286,161,123
10903,levle2_37.jpg,fore,Unspecified,0.0,0,2601,1278,2777,1493,176,215
10904,levle2_37.jpg,fore,Unspecified,0.0,0,2539,1317,2677,1432,138,115
10905,levle2_37.jpg,fore,Unspecified,0.0,0,1712,1922,1811,2022,99,100
10906,levle2_37.jpg,fore,Unspecified,0.0,0,1811,2167,1957,2282,146,115
10907,levle2_37.jpg,fore,Unspecified,0.0,0,1926,2175,2072,2274,146,99
10908,levle2_37.jpg,fore,Unspecified,0.0,0,2041,2137,2187,2267,146,130
10909,levle2_37.jpg,fore,Unspecified,0.0,0,2240,2198,2409,2336,169,138
10910,levle2_37.jpg,fore,Unspecified,0.0,0,2148,2244,2271,2374,123,130
10911,levle2_37.jpg,fore,Unspecified,0.0,0,1750,3156,1880,3286,130,130
10912,levle2_37.jpg,fore,Unspecified,0.0,0,2463,2543,2562,2627,99,84
10913,levle2_37.jpg,fore,Unspecified,0.0,0,2187,2382,2286,2489,99,107
10914,levle2_37.jpg,fore,Unspecified,0.0,0,2417,1907,2539,2068,122,161
10915,levle2_37.jpg,fore,Unspecified,0.0,0,2532,1999,2654,2160,122,161
10916,levle2_37.jpg,fore,Unspecified,0.0,0,2685,1822,2838,1914,153,92
10917,levle2_37.jpg,fore,Unspecified,0.0,0,2700,1876,2784,2006,84,130
10918,levle2_37.jpg,fore,Unspecified,0.0,0,2570,2137,2784,2221,214,84
10919,levle2_37.jpg,fore,Unspecified,0.0,0,2486,2251,2647,2336,161,85
10920,levle2_37.jpg,fore,Unspecified,0.0,0,2624,2282,2792,2481,168,199
10921,levle2_37.jpg,fore,Unspecified,0.0,0,2440,1784,2593,1899,153,115
10922,levle0_509.jpg,fore,Unspecified,0.0,0,2279,2152,2440,2389,161,237
10923,levle0_509.jpg,fore,Unspecified,0.0,0,2440,1907,2731,2167,291,260
10924,levle0_509.jpg,fore,Unspecified,0.0,0,2041,2589,2279,2826,238,237
10925,levle2_23.jpg,fore,Unspecified,0.0,0,310,242,334,260,24,18
10926,levle2_23.jpg,fore,Unspecified,0.0,0,287,208,306,232,19,24
10927,levle2_23.jpg,fore,Unspecified,0.0,0,264,197,279,226,15,29
10928,levle2_23.jpg,fore,Unspecified,0.0,0,252,182,268,201,16,19
10929,levle2_23.jpg,fore,Unspecified,0.0,0,223,200,248,226,25,26
10930,levle2_23.jpg,fore,Unspecified,0.0,0,149,174,173,200,24,26
10931,levle2_23.jpg,fore,Unspecified,0.0,0,161,224,181,249,20,25
10932,levle2_23.jpg,fore,Unspecified,0.0,0,191,225,207,250,16,25
10933,levle2_23.jpg,fore,Unspecified,0.0,0,239,238,283,269,44,31
10934,levle2_23.jpg,fore,Unspecified,0.0,0,246,306,278,341,32,35
10935,levle2_23.jpg,fore,Unspecified,0.0,0,182,382,207,411,25,29
10936,levle2_23.jpg,fore,Unspecified,0.0,0,183,413,197,441,14,28
10937,levle2_23.jpg,fore,Unspecified,0.0,0,206,414,226,447,20,33
10938,levle2_23.jpg,fore,Unspecified,0.0,0,203,439,228,475,25,36
10939,levle2_23.jpg,fore,Unspecified,0.0,0,246,397,264,427,18,30
10940,levle2_23.jpg,fore,Unspecified,0.0,0,421,335,443,361,22,26
10941,levle2_23.jpg,fore,Unspecified,0.0,0,403,310,428,335,25,25
10942,levle2_23.jpg,fore,Unspecified,0.0,0,190,173,226,214,36,41
10943,levle2_23.jpg,fore,Unspecified,0.0,0,173,172,194,200,21,28
10944,levle2_23.jpg,fore,Unspecified,0.0,0,214,232,235,270,21,38
10945,levle2_23.jpg,fore,Unspecified,0.0,0,251,265,279,302,28,37
10946,levle2_23.jpg,fore,Unspecified,0.0,0,274,277,302,319,28,42
10947,levle2_23.jpg,fore,Unspecified,0.0,0,299,326,330,365,31,39
10948,levle2_23.jpg,fore,Unspecified,0.0,0,381,339,412,373,31,34
10949,levle2_23.jpg,fore,Unspecified,0.0,0,202,325,238,358,36,33
10950,levle2_23.jpg,fore,Unspecified,0.0,0,202,355,234,373,32,18
10951,levle2_23.jpg,fore,Unspecified,0.0,0,209,373,243,406,34,33
10952,levle2_23.jpg,fore,Unspecified,0.0,0,252,482,287,512,35,30
10953,levle2_23.jpg,fore,Unspecified,0.0,0,232,433,259,456,27,23
10954,levle0_247.jpg,fore,Unspecified,0.0,0,1489,3087,1627,3271,138,184
10955,levle0_247.jpg,fore,Unspecified,0.0,0,1390,3064,1474,3217,84,153
10956,levle0_247.jpg,fore,Unspecified,0.0,0,1244,3041,1336,3163,92,122
10957,levle0_247.jpg,fore,Unspecified,0.0,0,1359,3217,1474,3355,115,138
10958,levle0_247.jpg,fore,Unspecified,0.0,0,1758,3286,1896,3401,138,115
10959,levle0_521.jpg,fore,Unspecified,0.0,0,1942,2336,2141,2489,199,153
10960,levle0_521.jpg,fore,Unspecified,0.0,0,1053,3125,1267,3263,214,138
10961,levle0_521.jpg,fore,Unspecified,0.0,0,1298,1002,1443,1133,145,131
10962,levle0_521.jpg,fore,Unspecified,0.0,0,1796,566,1911,727,115,161
10963,levle2_183.jpg,fore,Unspecified,0.0,0,2853,1968,2991,2144,138,176
10964,levle2_183.jpg,fore,Unspecified,0.0,0,2501,2443,2754,2550,253,107
10965,levle2_183.jpg,fore,Unspecified,0.0,0,1972,2757,2256,2979,284,222
10966,levle2_183.jpg,fore,Unspecified,0.0,0,2026,2389,2332,2581,306,192
10967,levle2_183.jpg,fore,Unspecified,0.0,0,2133,2274,2332,2336,199,62
10968,levle2_183.jpg,fore,Unspecified,0.0,0,2325,1991,2532,2144,207,153
10969,levle2_183.jpg,fore,Unspecified,0.0,0,1658,3140,1827,3263,169,123
10970,levle2_183.jpg,fore,Unspecified,0.0,0,1581,2635,1827,2811,246,176
10971,levle2_183.jpg,fore,Unspecified,0.0,0,1850,2527,2057,2658,207,131
10972,levle2_183.jpg,fore,Unspecified,0.0,0,1175,2075,1466,2221,291,146
10973,levle2_183.jpg,fore,Unspecified,0.0,0,1612,872,1796,987,184,115
10974,levle2_183.jpg,fore,Unspecified,0.0,0,1528,949,1689,1064,161,115
10975,levle2_183.jpg,fore,Unspecified,0.0,0,1712,359,1834,489,122,130
10976,levle2_183.jpg,fore,Unspecified,0.0,0,1972,343,2225,527,253,184
10977,levle2_183.jpg,fore,Unspecified,0.0,0,2455,1025,2708,1140,253,115
10978,levle2_183.jpg,fore,Unspecified,0.0,0,2700,1163,2930,1301,230,138
10979,levle2_183.jpg,fore,Unspecified,0.0,0,1168,987,1336,1102,168,115
10980,levle2_183.jpg,fore,Unspecified,0.0,0,1030,1278,1252,1409,222,131
10981,levle2_183.jpg,fore,Unspecified,0.0,0,1888,3148,2064,3209,176,61
10982,levle2_183.jpg,fore,Unspecified,0.0,0,1466,2956,1666,3079,200,123
10983,levle2_183.jpg,fore,Unspecified,0.0,0,2593,2068,2876,2359,283,291
10984,levle2_183.jpg,fore,Unspecified,0.0,0,2478,1983,2777,2167,299,184
10985,levle0_253.jpg,fore,Unspecified,0.0,0,1221,2091,1367,2259,146,168
10986,levle2_168.jpg,fore,Unspecified,0.0,0,1397,520,1535,619,138,99
10987,levle2_168.jpg,fore,Unspecified,0.0,0,1267,297,1420,435,153,138
10988,levle2_168.jpg,fore,Unspecified,0.0,0,715,1048,922,1217,207,169
10989,levle2_168.jpg,fore,Unspecified,0.0,0,677,1179,838,1424,161,245
10990,levle2_168.jpg,fore,Unspecified,0.0,0,478,1263,647,1416,169,153
10991,levle2_168.jpg,fore,Unspecified,0.0,0,516,1133,692,1202,176,69
10992,levle2_168.jpg,fore,Unspecified,0.0,0,409,956,524,1056,115,100
10993,levle2_168.jpg,fore,Unspecified,0.0,0,470,788,631,941,161,153
10994,levle2_168.jpg,fore,Unspecified,0.0,0,348,1684,486,1861,138,177
10995,levle2_168.jpg,fore,Unspecified,0.0,0,509,1554,685,1707,176,153
10996,levle2_168.jpg,fore,Unspecified,0.0,0,685,1654,807,1784,122,130
10997,levle2_168.jpg,fore,Unspecified,0.0,0,639,1769,746,1853,107,84
10998,levle2_168.jpg,fore,Unspecified,0.0,0,455,1815,624,1991,169,176
10999,levle2_168.jpg,fore,Unspecified,0.0,0,547,2244,723,2435,176,191
11000,levle2_168.jpg,fore,Unspecified,0.0,0,654,2091,792,2190,138,99
11001,levle2_168.jpg,fore,Unspecified,0.0,0,715,2190,838,2328,123,138
11002,levle2_168.jpg,fore,Unspecified,0.0,0,876,2221,1037,2351,161,130
11003,levle2_168.jpg,fore,Unspecified,0.0,0,1014,2106,1152,2244,138,138
11004,levle2_168.jpg,fore,Unspecified,0.0,0,1183,2114,1329,2244,146,130
11005,levle2_168.jpg,fore,Unspecified,0.0,0,784,1953,961,2167,177,214
11006,levle2_168.jpg,fore,Unspecified,0.0,0,1244,2305,1436,2466,192,161
11007,levle2_168.jpg,fore,Unspecified,0.0,0,1083,2343,1275,2481,192,138
11008,levle2_168.jpg,fore,Unspecified,0.0,0,1022,2428,1122,2550,100,122
11009,levle2_168.jpg,fore,Unspecified,0.0,0,1122,2550,1283,2704,161,154
11010,levle2_168.jpg,fore,Unspecified,0.0,0,532,2696,708,2849,176,153
11011,levle2_168.jpg,fore,Unspecified,0.0,0,585,2849,807,3033,222,184
11012,levle2_168.jpg,fore,Unspecified,0.0,0,777,2987,915,3094,138,107
11013,levle2_168.jpg,fore,Unspecified,0.0,0,1290,2941,1443,3110,153,169
11014,levle2_154.jpg,fore,Unspecified,0.0,0,1474,1163,1574,1301,100,138
11015,levle2_154.jpg,fore,Unspecified,0.0,0,1329,972,1535,1171,206,199
11016,levle2_154.jpg,fore,Unspecified,0.0,0,1505,1064,1643,1186,138,122
11017,levle2_154.jpg,fore,Unspecified,0.0,0,1827,704,1957,857,130,153
11018,levle2_154.jpg,fore,Unspecified,0.0,0,1497,520,1742,704,245,184
11019,levle2_154.jpg,fore,Unspecified,0.0,0,1505,236,1704,405,199,169
11020,levle2_154.jpg,fore,Unspecified,0.0,0,1712,144,1865,282,153,138
11021,levle2_154.jpg,fore,Unspecified,0.0,0,2762,1071,2892,1255,130,184
11022,levle2_154.jpg,fore,Unspecified,0.0,0,2869,1056,3076,1209,207,153
11023,levle2_154.jpg,fore,Unspecified,0.0,0,1283,2259,1405,2389,122,130
11024,levle2_154.jpg,fore,Unspecified,0.0,0,1428,2206,1566,2359,138,153
11025,levle2_154.jpg,fore,Unspecified,0.0,0,1558,2351,1673,2489,115,138
11026,levle2_154.jpg,fore,Unspecified,0.0,0,2179,2420,2286,2489,107,69
11027,levle2_154.jpg,fore,Unspecified,0.0,0,2179,2543,2309,2604,130,61
11028,levle2_154.jpg,fore,Unspecified,0.0,0,2309,2351,2401,2489,92,138
11029,levle2_154.jpg,fore,Unspecified,0.0,0,2363,2297,2486,2366,123,69
11030,levle2_154.jpg,fore,Unspecified,0.0,0,2386,2366,2463,2466,77,100
11031,levle2_154.jpg,fore,Unspecified,0.0,0,2340,2573,2486,2658,146,85
11032,levle2_154.jpg,fore,Unspecified,0.0,0,2302,2635,2440,2734,138,99
11033,levle2_154.jpg,fore,Unspecified,0.0,0,2371,2688,2463,2803,92,115
11034,levle2_154.jpg,fore,Unspecified,0.0,0,2217,2773,2325,2888,108,115
11035,levle2_154.jpg,fore,Unspecified,0.0,0,2562,2811,2677,2934,115,123
11036,levle2_154.jpg,fore,Unspecified,0.0,0,2578,2328,2685,2466,107,138
11037,levle2_154.jpg,fore,Unspecified,0.0,0,2754,2251,2876,2366,122,115
11038,levle2_154.jpg,fore,Unspecified,0.0,0,2662,1991,2723,2144,61,153
11039,levle2_154.jpg,fore,Unspecified,0.0,0,2478,2160,2585,2267,107,107
11040,levle2_154.jpg,fore,Unspecified,0.0,0,2754,1830,2838,1899,84,69
11041,levle2_154.jpg,fore,Unspecified,0.0,0,2892,1707,2984,1845,92,138
11042,levle2_154.jpg,fore,Unspecified,0.0,0,2922,1815,3037,1922,115,107
11043,levle2_154.jpg,fore,Unspecified,0.0,0,2417,374,2509,489,92,115
11044,levle2_154.jpg,fore,Unspecified,0.0,0,1505,2750,1620,2895,115,145
11045,levle2_154.jpg,fore,Unspecified,0.0,0,853,1845,976,2037,123,192
11046,levle2_154.jpg,fore,Unspecified,0.0,0,1122,2121,1244,2251,122,130
11047,levle0_284.jpg,fore,Unspecified,0.0,0,2325,2037,2424,2183,99,146
11048,levle2_140.jpg,fore,Unspecified,0.0,0,1896,596,2026,665,130,69
11049,levle2_140.jpg,fore,Unspecified,0.0,0,1850,635,1934,788,84,153
11050,levle2_140.jpg,fore,Unspecified,0.0,0,1949,704,2049,796,100,92
11051,levle2_140.jpg,fore,Unspecified,0.0,0,1719,596,1834,719,115,123
11052,levle2_140.jpg,fore,Unspecified,0.0,0,1612,604,1712,734,100,130
11053,levle2_140.jpg,fore,Unspecified,0.0,0,1765,520,1873,642,108,122
11054,levle2_140.jpg,fore,Unspecified,0.0,0,1873,374,1988,527,115,153
11055,levle2_140.jpg,fore,Unspecified,0.0,0,1290,665,1382,811,92,146
11056,levle2_140.jpg,fore,Unspecified,0.0,0,1352,527,1505,665,153,138
11057,levle2_140.jpg,fore,Unspecified,0.0,0,1420,420,1566,535,146,115
11058,levle2_140.jpg,fore,Unspecified,0.0,0,2348,1646,2447,1746,99,100
11059,levle2_140.jpg,fore,Unspecified,0.0,0,1880,1876,1995,1991,115,115
11060,levle2_140.jpg,fore,Unspecified,0.0,0,1811,2068,1896,2152,85,84
11061,levle2_140.jpg,fore,Unspecified,0.0,0,1719,2091,1811,2259,92,168
11062,levle2_140.jpg,fore,Unspecified,0.0,0,1604,2045,1712,2183,108,138
11063,levle2_140.jpg,fore,Unspecified,0.0,0,1880,2160,1934,2206,54,46
11064,levle2_140.jpg,fore,Unspecified,0.0,0,1988,2175,2095,2290,107,115
11065,levle2_140.jpg,fore,Unspecified,0.0,0,1980,2251,2072,2351,92,100
11066,levle2_140.jpg,fore,Unspecified,0.0,0,2095,2259,2187,2374,92,115
11067,levle2_140.jpg,fore,Unspecified,0.0,0,2034,2359,2125,2451,91,92
11068,levle2_140.jpg,fore,Unspecified,0.0,0,2003,2405,2110,2481,107,76
11069,levle2_140.jpg,fore,Unspecified,0.0,0,2194,2297,2263,2374,69,77
11070,levle2_140.jpg,fore,Unspecified,0.0,0,2248,2221,2348,2320,100,99
11071,levle2_140.jpg,fore,Unspecified,0.0,0,2263,2359,2355,2466,92,107
11072,levle2_140.jpg,fore,Unspecified,0.0,0,2225,2435,2332,2581,107,146
11073,levle2_140.jpg,fore,Unspecified,0.0,0,2164,2428,2225,2550,61,122
11074,levle2_140.jpg,fore,Unspecified,0.0,0,2233,2098,2325,2221,92,123
11075,levle2_140.jpg,fore,Unspecified,0.0,0,2309,2137,2432,2274,123,137
11076,levle2_140.jpg,fore,Unspecified,0.0,0,2348,2014,2440,2137,92,123
11077,levle2_140.jpg,fore,Unspecified,0.0,0,2179,1960,2325,2114,146,154
11078,levle2_140.jpg,fore,Unspecified,0.0,0,2049,2512,2141,2627,92,115
11079,levle2_140.jpg,fore,Unspecified,0.0,0,2164,2581,2256,2665,92,84
11080,levle2_140.jpg,fore,Unspecified,0.0,0,1903,2673,2087,2796,184,123
11081,levle0_290.jpg,fore,Unspecified,0.0,0,1758,1799,1903,1960,145,161
11082,levle0_290.jpg,fore,Unspecified,0.0,0,2079,1746,2256,1976,177,230
11083,levle0_290.jpg,fore,Unspecified,0.0,0,1880,2167,2049,2351,169,184
11084,levle0_290.jpg,fore,Unspecified,0.0,0,1627,2497,1834,2658,207,161
11085,levle1_518.jpg,fore,Unspecified,0.0,0,1827,1217,1980,1370,153,153
11086,levle1_518.jpg,fore,Unspecified,0.0,0,1788,1102,1988,1209,200,107
11087,levle1_518.jpg,fore,Unspecified,0.0,0,455,2014,647,2183,192,169
11088,levle1_518.jpg,fore,Unspecified,0.0,0,876,2979,1037,3125,161,146
11089,levle1_518.jpg,fore,Unspecified,0.0,0,815,3163,991,3294,176,131
11090,levle1_518.jpg,fore,Unspecified,0.0,0,1244,3102,1413,3209,169,107
11091,levle1_530.jpg,fore,Unspecified,0.0,0,1781,1240,1880,1340,99,100
11092,levle1_530.jpg,fore,Unspecified,0.0,0,1796,1133,1934,1194,138,61
11093,levle1_530.jpg,fore,Unspecified,0.0,0,1689,750,1781,842,92,92
11094,levle1_530.jpg,fore,Unspecified,0.0,0,1658,857,1758,987,100,130
11095,levle1_530.jpg,fore,Unspecified,0.0,0,1842,711,1965,842,123,131
11096,levle1_530.jpg,fore,Unspecified,0.0,0,1903,842,2057,964,154,122
11097,levle1_530.jpg,fore,Unspecified,0.0,0,1397,297,1474,382,77,85
11098,levle1_530.jpg,fore,Unspecified,0.0,0,1321,466,1482,604,161,138
11099,levle1_530.jpg,fore,Unspecified,0.0,0,1512,543,1620,658,108,115
11100,levle1_530.jpg,fore,Unspecified,0.0,0,1045,796,1229,880,184,84
11101,levle1_530.jpg,fore,Unspecified,0.0,0,1474,2926,1604,3048,130,122
11102,levle1_530.jpg,fore,Unspecified,0.0,0,1267,2834,1520,2987,253,153
11103,levle1_530.jpg,fore,Unspecified,0.0,0,1689,2880,1850,2995,161,115
11104,levle1_66.jpg,fore,Unspecified,0.0,0,532,1868,608,1960,76,92
11105,levle1_66.jpg,fore,Unspecified,0.0,0,394,2229,570,2435,176,206
11106,levle1_66.jpg,fore,Unspecified,0.0,0,1474,2903,1650,3079,176,176
11107,levle1_66.jpg,fore,Unspecified,0.0,0,1336,3148,1443,3263,107,115
11108,levle1_66.jpg,fore,Unspecified,0.0,0,1742,3064,1880,3194,138,130
11109,levle1_66.jpg,fore,Unspecified,0.0,0,1229,382,1382,535,153,153
11110,levle1_256.jpg,fore,Unspecified,0.0,0,66,155,74,164,8,9
11111,levle1_256.jpg,fore,Unspecified,0.0,0,54,170,66,185,12,15
11112,levle1_256.jpg,fore,Unspecified,0.0,0,65,169,75,175,10,6
11113,levle1_256.jpg,fore,Unspecified,0.0,0,91,163,101,176,10,13
11114,levle1_256.jpg,fore,Unspecified,0.0,0,73,127,83,140,10,13
11115,levle1_256.jpg,fore,Unspecified,0.0,0,116,168,127,181,11,13
11116,levle1_242.jpg,fore,Unspecified,0.0,0,938,2029,1060,2098,122,69
11117,levle1_242.jpg,fore,Unspecified,0.0,0,953,1907,1083,1983,130,76
11118,levle1_242.jpg,fore,Unspecified,0.0,0,930,1746,1022,1891,92,145
11119,levle1_242.jpg,fore,Unspecified,0.0,0,1175,2374,1298,2489,123,115
11120,levle1_242.jpg,fore,Unspecified,0.0,0,1850,543,1942,673,92,130
11121,levle1_242.jpg,fore,Unspecified,0.0,0,1099,1677,1206,1753,107,76
11122,levle1_242.jpg,fore,Unspecified,0.0,0,1336,2420,1405,2535,69,115
11123,levle1_524.jpg,fore,Unspecified,0.0,0,2340,2206,2524,2397,184,191
11124,levle1_524.jpg,fore,Unspecified,0.0,0,2141,2474,2248,2581,107,107
11125,levle1_524.jpg,fore,Unspecified,0.0,0,2256,2435,2378,2589,122,154
11126,levle1_524.jpg,fore,Unspecified,0.0,0,2562,2098,2708,2229,146,131
11127,levle1_524.jpg,fore,Unspecified,0.0,0,2148,2619,2332,2727,184,108
11128,levle1_524.jpg,fore,Unspecified,0.0,0,2018,2635,2133,2757,115,122
11129,levle1_524.jpg,fore,Unspecified,0.0,0,2049,2865,2133,2934,84,69
11130,levle1_524.jpg,fore,Unspecified,0.0,0,2095,2941,2217,3048,122,107
11131,levle1_524.jpg,fore,Unspecified,0.0,0,1535,2972,1689,3094,154,122
11132,levle1_524.jpg,fore,Unspecified,0.0,0,1926,3087,2011,3179,85,92
11133,levle1_72.jpg,fore,Unspecified,0.0,0,2816,670,3115,961,299,291
11134,levle1_72.jpg,fore,Unspecified,0.0,0,2359,488,2725,820,366,332
11135,levle1_72.jpg,fore,Unspecified,0.0,0,2101,1020,2409,1310,308,290
11136,levle1_72.jpg,fore,Unspecified,0.0,0,1636,1975,1952,2258,316,283
11137,levle1_72.jpg,fore,Unspecified,0.0,0,1395,2183,1702,2374,307,191
11138,levle1_72.jpg,fore,Unspecified,0.0,0,2625,1435,3040,1809,415,374
11139,levle1_72.jpg,fore,Unspecified,0.0,0,2001,2142,2301,2366,300,224
11140,levle1_72.jpg,fore,Unspecified,0.0,0,1179,2516,1578,2782,399,266
11141,levle1_99.jpg,fore,Unspecified,0.0,0,2251,529,2417,770,166,241
11142,levle1_99.jpg,fore,Unspecified,0.0,0,3215,1809,3373,1984,158,175
11143,levle1_99.jpg,fore,Unspecified,0.0,0,2882,1817,3107,2042,225,225
11144,levle1_99.jpg,fore,Unspecified,0.0,0,2625,2624,2708,2773,83,149
11145,levle1_99.jpg,fore,Unspecified,0.0,0,2658,2424,2791,2557,133,133
11146,levle1_99.jpg,fore,Unspecified,0.0,0,2999,2657,3173,2773,174,116
11147,levle1_99.jpg,fore,Unspecified,0.0,0,2774,2682,2882,2806,108,124
11148,levle1_99.jpg,fore,Unspecified,0.0,0,2342,2682,2508,2848,166,166
11149,levle1_295.jpg,fore,Unspecified,0.0,0,1980,2366,2102,2543,122,177
11150,levle1_295.jpg,fore,Unspecified,0.0,0,1850,2274,1980,2420,130,146
11151,levle1_295.jpg,fore,Unspecified,0.0,0,2394,2052,2486,2167,92,115
11152,levle1_295.jpg,fore,Unspecified,0.0,0,2478,2083,2616,2244,138,161
11153,levle1_295.jpg,fore,Unspecified,0.0,0,2547,1953,2700,2121,153,168
11154,levle1_295.jpg,fore,Unspecified,0.0,0,2378,1738,2524,1891,146,153
11155,levle1_295.jpg,fore,Unspecified,0.0,0,2915,2121,3045,2267,130,146
11156,levle1_295.jpg,fore,Unspecified,0.0,0,2187,2144,2363,2359,176,215
11157,levle1_295.jpg,fore,Unspecified,0.0,0,2455,1056,2639,1225,184,169
11158,levle3_145.jpg,fore,,,0,3132,2009,3256,2191,124,182
11159,levle3_145.jpg,fore,,,0,2716,2258,2899,2383,183,125
11160,levle3_145.jpg,fore,,,0,2525,2457,2558,2482,33,25
11161,levle3_145.jpg,fore,,,0,2533,2233,2700,2399,167,166
11162,levle3_145.jpg,fore,,,0,2375,2366,2550,2499,175,133
11163,levle3_145.jpg,fore,,,0,2159,2291,2359,2391,200,100
11164,levle3_145.jpg,fore,,,0,2359,1901,2558,2083,199,182
11165,levle3_145.jpg,fore,,,0,2691,1718,2700,1726,9,8
11166,levle3_145.jpg,fore,,,0,2525,1618,2708,1743,183,125
11167,levle3_145.jpg,fore,,,0,2567,1734,2733,1901,166,167
11168,levle3_145.jpg,fore,,,0,2700,1718,2907,1934,207,216
11169,levle3_145.jpg,fore,,,0,2143,1959,2309,2125,166,166
11170,levle3_145.jpg,fore,,,0,1993,1967,2126,2092,133,125
11171,levle3_145.jpg,fore,,,0,1918,2009,1993,2216,75,207
11172,levle3_145.jpg,fore,,,0,1727,2034,1877,2208,150,174
11173,levle3_145.jpg,fore,,,0,1403,1842,1561,2025,158,183
11174,levle3_145.jpg,fore,,,0,1719,1901,1860,2034,141,133
11175,levle3_145.jpg,fore,,,0,1744,1751,2001,1892,257,141
11176,levle3_145.jpg,fore,,,0,1860,1618,2051,1759,191,141
11177,levle3_145.jpg,fore,,,0,1686,1527,1852,1718,166,191
11178,levle3_145.jpg,fore,,,0,1760,1310,1935,1502,175,192
11179,levle3_145.jpg,fore,,,0,2051,1377,2226,1585,175,208
11180,levle3_145.jpg,fore,,,0,2168,1535,2334,1734,166,199
11181,levle3_145.jpg,fore,,,0,2242,1385,2367,1568,125,183
11182,levle3_145.jpg,fore,,,0,2226,1161,2367,1294,141,133
11183,levle3_145.jpg,fore,,,0,2384,837,2567,1103,183,266
11184,levle3_145.jpg,fore,,,0,2492,795,2542,845,50,50
11185,levle3_145.jpg,fore,,,0,2267,562,2484,779,217,217
11186,levle3_145.jpg,fore,,,0,2691,554,2974,862,283,308
11187,levle3_145.jpg,fore,,,0,3242,882,3346,982,104,100
11188,levle3_145.jpg,fore,,,0,3282,818,3430,922,148,104
11189,levle3_145.jpg,fore,,,0,3182,674,3326,826,144,152
11190,levle3_145.jpg,fore,,,0,1602,2430,1766,2570,164,140
11191,levle3_145.jpg,fore,,,0,1726,2354,1870,2466,144,112
11192,levle3_145.jpg,fore,,,0,1170,2070,1338,2178,168,108
11193,levle3_145.jpg,fore,,,0,1426,2022,1590,2154,164,132
11194,levle3_145.jpg,fore,,,0,1546,2142,1694,2290,148,148
11195,levle3_145.jpg,fore,,,0,1478,1706,1642,1886,164,180
11196,levle3_145.jpg,fore,,,0,1514,1546,1694,1726,180,180
11197,levle3_145.jpg,fore,,,0,1610,1426,1822,1606,212,180
11198,levle3_145.jpg,fore,,,0,1822,1154,1986,1310,164,156
11199,levle3_145.jpg,fore,,,0,2234,902,2394,1098,160,196
11200,levle3_145.jpg,fore,,,0,2646,774,2874,938,228,164
11201,levle3_145.jpg,fore,,,0,2986,638,3166,786,180,148
11202,levle3_145.jpg,fore,,,0,2330,1178,2526,1338,196,160
11203,levle3_145.jpg,fore,,,0,2094,1754,2258,1894,164,140
11204,levle3_145.jpg,fore,,,0,1994,1562,2146,1710,152,148
11205,levle3_145.jpg,fore,,,0,1842,1882,2030,2022,188,140
11206,levle3_145.jpg,fore,,,0,2022,2406,2194,2530,172,124
11207,levle3_145.jpg,fore,,,0,2754,1886,2914,2022,160,136
11208,levle3_145.jpg,fore,,,0,2786,2382,2934,2510,148,128
11209,levle3_145.jpg,fore,,,0,2438,2526,2622,2670,184,144
11210,levle3_145.jpg,fore,,,0,2250,2146,2466,2290,216,144
11211,levle3_145.jpg,fore,,,0,2294,1778,2506,1998,212,220
11212,levle3_145.jpg,fore,,,0,2534,946,2710,1098,176,152
11213,levle1_281.jpg,fore,Unspecified,0.0,0,2125,1891,2271,2068,146,177
11214,levle1_281.jpg,fore,Unspecified,0.0,0,2470,1991,2624,2190,154,199
11215,levle1_281.jpg,fore,Unspecified,0.0,0,2110,2137,2286,2267,176,130
11216,levle1_281.jpg,fore,Unspecified,0.0,0,1980,2037,2148,2160,168,123
11217,levle1_281.jpg,fore,Unspecified,0.0,0,1214,2328,1390,2481,176,153
11218,levle1_281.jpg,fore,Unspecified,0.0,0,1589,2451,1704,2589,115,138
11219,levle1_281.jpg,fore,Unspecified,0.0,0,1903,2880,2118,2995,215,115
11220,levle1_281.jpg,fore,Unspecified,0.0,0,1352,2956,1489,3079,137,123
11221,levle1_281.jpg,fore,Unspecified,0.0,0,1382,3071,1551,3171,169,100
11222,levle1_280.jpg,fore,Unspecified,0.0,0,2256,1838,2401,2006,145,168
11223,levle1_280.jpg,fore,Unspecified,0.0,0,2248,2029,2386,2229,138,200
11224,levle1_280.jpg,fore,Unspecified,0.0,0,1934,2098,2057,2297,123,199
11225,levle1_280.jpg,fore,Unspecified,0.0,0,2087,2083,2202,2251,115,168
11226,levle1_280.jpg,fore,Unspecified,0.0,0,1804,1960,1988,2121,184,161
11227,levle1_280.jpg,fore,Unspecified,0.0,0,1459,2083,1604,2259,145,176
11228,levle1_280.jpg,fore,Unspecified,0.0,0,2133,2351,2302,2543,169,192
11229,levle1_280.jpg,fore,Unspecified,0.0,0,1750,2888,1842,3010,92,122
11230,levle3_144.jpg,fore,,,0,2259,2408,2400,2599,141,191
11231,levle3_144.jpg,fore,,,0,2484,2216,2600,2374,116,158
11232,levle3_144.jpg,fore,,,0,2625,2117,2766,2283,141,166
11233,levle3_144.jpg,fore,,,0,2791,2009,2899,2117,108,108
11234,levle3_144.jpg,fore,,,0,2824,1934,2932,1992,108,58
11235,levle3_144.jpg,fore,,,0,2949,1967,3107,2142,158,175
11236,levle3_144.jpg,fore,,,0,3065,1975,3298,2117,233,142
11237,levle3_144.jpg,fore,,,0,3115,1743,3240,1867,125,124
11238,levle3_144.jpg,fore,,,0,3281,1626,3406,1776,125,150
11239,levle3_144.jpg,fore,,,0,2949,1369,3065,1502,116,133
11240,levle3_144.jpg,fore,,,0,2542,970,2766,1177,224,207
11241,levle3_144.jpg,fore,,,0,2816,1128,3057,1360,241,232
11242,levle3_144.jpg,fore,,,0,3099,2133,3331,2225,232,92
11243,levle3_144.jpg,fore,,,0,3273,2025,3497,2216,224,191
11244,levle3_144.jpg,fore,,,0,2342,2150,2425,2308,83,158
11245,levle3_144.jpg,fore,,,0,2450,2025,2592,2108,142,83
11246,levle3_144.jpg,fore,,,0,2658,1784,2816,1925,158,141
11247,levle3_144.jpg,fore,,,0,2459,2333,2625,2491,166,158
11248,levle3_144.jpg,fore,,,0,2583,2449,2733,2590,150,141
11249,levle3_144.jpg,fore,,,0,2783,2258,2874,2408,91,150
11250,levle3_144.jpg,fore,,,0,2849,2383,2949,2532,100,149
11251,levle3_144.jpg,fore,,,0,2982,2233,3165,2391,183,158
11252,levle3_144.jpg,fore,,,0,2162,2341,2258,2426,96,85
11253,levle3_144.jpg,fore,,,0,2129,2568,2213,2630,84,62
11254,levle3_144.jpg,fore,,,0,2953,2779,3078,2892,125,113
11255,levle3_144.jpg,fore,,,0,3062,1657,3133,1748,71,91
11256,levle3_144.jpg,fore,,,0,2884,1095,2996,1195,112,100
11257,levle3_144.jpg,fore,,,0,2520,2739,2620,2817,100,78
11258,levle3_144.jpg,fore,,,0,2713,2617,2818,2692,105,75
11259,levle3_144.jpg,fore,,,0,2676,2683,2762,2779,86,96
11260,levle3_144.jpg,fore,,,0,2769,2561,2860,2646,91,85
11261,levle3_144.jpg,fore,,,0,3213,2297,3320,2406,107,109
11262,levle3_144.jpg,fore,,,0,3282,2226,3380,2337,98,111
11263,levle3_144.jpg,fore,,,0,3331,1928,3438,2032,107,104
11264,levle3_144.jpg,fore,,,0,2576,2017,2687,2123,111,106
11265,levle3_144.jpg,fore,,,0,3011,1548,3124,1626,113,78
11266,levle3_144.jpg,fore,,,0,2984,1610,3082,1712,98,102
11267,levle3_144.jpg,fore,,,0,2878,1519,2996,1608,118,89
11268,levle3_144.jpg,fore,,,0,2298,892,2429,997,131,105
11269,levle3_144.jpg,fore,,,0,2707,908,2820,1015,113,107
11270,levle3_144.jpg,fore,,,0,2804,906,2944,1055,140,149
11271,levle3_144.jpg,fore,,,0,2864,1859,2980,1968,116,109
11272,levle3_144.jpg,fore,,,0,2229,1719,2322,1812,93,93
11273,levle3_144.jpg,fore,,,0,3118,1872,3227,1979,109,107
11274,levle3_144.jpg,fore,,,0,2762,2179,2880,2281,118,102
11275,levle3_144.jpg,fore,,,0,2853,2141,2978,2237,125,96
11276,levle3_144.jpg,fore,,,0,2633,1921,2744,2010,111,89
11277,levle3_144.jpg,fore,,,0,2522,1921,2636,2021,114,100
11278,levle3_144.jpg,fore,,,0,2380,1992,2467,2077,87,85
11279,levle3_144.jpg,fore,,,0,1891,1827,2027,1941,136,114
11280,levle3_144.jpg,fore,,,0,1664,1861,1800,2046,136,185
11281,levle3_144.jpg,fore,,,0,1769,1788,1907,1930,138,142
11282,levle3_144.jpg,fore,,,0,2324,1821,2436,1917,112,96
11283,levle3_144.jpg,fore,,,0,2369,1906,2469,1983,100,77
11284,levle3_144.jpg,fore,,,0,2271,1926,2373,2048,102,122
11285,levle3_144.jpg,fore,,,0,3264,1803,3387,1932,123,129
11286,levle3_144.jpg,fore,,,0,3460,1757,3544,1879,84,122
11287,levle3_144.jpg,fore,,,0,2504,1130,2627,1232,123,102
11288,levle1_294.jpg,fore,Unspecified,0.0,0,1352,2719,1497,2880,145,161
11289,levle1_294.jpg,fore,Unspecified,0.0,0,1896,2872,2057,3002,161,130
11290,levle1_294.jpg,fore,Unspecified,0.0,0,1512,2857,1612,3002,100,145
11291,levle1_294.jpg,fore,Unspecified,0.0,0,1620,2811,1796,2964,176,153
11292,levle1_294.jpg,fore,Unspecified,0.0,0,1390,2995,1528,3094,138,99
11293,levle1_294.jpg,fore,Unspecified,0.0,0,1413,3102,1528,3194,115,92
11294,levle1_294.jpg,fore,Unspecified,0.0,0,1604,3041,1689,3171,85,130
11295,levle1_294.jpg,fore,Unspecified,0.0,0,999,2956,1168,3087,169,131
11296,levle1_98.jpg,fore,Unspecified,0.0,0,2525,1959,2683,2100,158,141
11297,levle1_98.jpg,fore,Unspecified,0.0,0,2309,2117,2467,2250,158,133
11298,levle1_98.jpg,fore,Unspecified,0.0,0,1968,1934,2085,2034,117,100
11299,levle1_98.jpg,fore,Unspecified,0.0,0,2309,2698,2459,2815,150,117
11300,levle1_98.jpg,fore,Unspecified,0.0,0,2833,2840,2966,2964,133,124
11301,levle1_98.jpg,fore,Unspecified,0.0,0,2608,2815,2774,2939,166,124
11302,levle1_98.jpg,fore,Unspecified,0.0,0,2708,2358,2899,2524,191,166
11303,levle1_98.jpg,fore,Unspecified,0.0,0,2891,2557,3007,2673,116,116
11304,levle1_243.jpg,fore,Unspecified,0.0,0,1122,1914,1206,2052,84,138
11305,levle1_243.jpg,fore,Unspecified,0.0,0,1275,1953,1459,2022,184,69
11306,levle1_243.jpg,fore,Unspecified,0.0,0,1229,2045,1352,2167,123,122
11307,levle1_243.jpg,fore,Unspecified,0.0,0,1168,2183,1329,2274,161,91
11308,levle1_243.jpg,fore,Unspecified,0.0,0,1198,2282,1290,2412,92,130
11309,levle1_243.jpg,fore,Unspecified,0.0,0,1306,2351,1382,2497,76,146
11310,levle1_243.jpg,fore,Unspecified,0.0,0,1420,2420,1512,2527,92,107
11311,levle1_243.jpg,fore,Unspecified,0.0,0,1612,2229,1666,2351,54,122
11312,levle1_243.jpg,fore,Unspecified,0.0,0,1742,2405,1834,2504,92,99
11313,levle1_243.jpg,fore,Unspecified,0.0,0,1681,244,1834,412,153,168
11314,levle1_243.jpg,fore,Unspecified,0.0,0,1413,2658,1512,2819,99,161
11315,levle1_525.jpg,fore,Unspecified,0.0,0,1666,83,1850,259,184,176
11316,levle1_525.jpg,fore,Unspecified,0.0,0,585,1891,715,2060,130,169
11317,levle1_525.jpg,fore,Unspecified,0.0,0,493,2198,616,2290,123,92
11318,levle1_525.jpg,fore,Unspecified,0.0,0,899,2052,1083,2259,184,207
11319,levle1_525.jpg,fore,Unspecified,0.0,0,800,2236,930,2389,130,153
11320,levle1_525.jpg,fore,Unspecified,0.0,0,984,2673,1099,2842,115,169
11321,levle1_525.jpg,fore,Unspecified,0.0,0,1106,2734,1267,2888,161,154
11322,levle1_525.jpg,fore,Unspecified,0.0,0,899,2926,1045,3064,146,138
11323,levle1_67.jpg,fore,Unspecified,0.0,0,248,1784,378,1922,130,138
11324,levle1_67.jpg,fore,Unspecified,0.0,0,1152,589,1352,765,200,176
11325,levle1_67.jpg,fore,Unspecified,0.0,0,286,2229,455,2458,169,229
11326,levle1_67.jpg,fore,Unspecified,0.0,0,1543,3186,1704,3347,161,161
11327,levle1_67.jpg,fore,Unspecified,0.0,0,1696,3102,1811,3278,115,176
11328,levle1_67.jpg,fore,Unspecified,0.0,0,1428,3048,1581,3171,153,123
11329,levle1_67.jpg,fore,Unspecified,0.0,0,1267,3186,1375,3393,108,207
11330,levle1_531.jpg,fore,Unspecified,0.0,0,2210,1684,2332,1784,122,100
11331,levle1_531.jpg,fore,Unspecified,0.0,0,2509,1340,2608,1493,99,153
11332,levle1_531.jpg,fore,Unspecified,0.0,0,899,2819,938,2956,39,137
11333,levle1_531.jpg,fore,Unspecified,0.0,0,968,2857,1045,3010,77,153
11334,levle1_531.jpg,fore,Unspecified,0.0,0,1175,2819,1252,2926,77,107
11335,levle1_531.jpg,fore,Unspecified,0.0,0,1191,3110,1336,3240,145,130
11336,levle1_531.jpg,fore,Unspecified,0.0,0,1413,2857,1543,3018,130,161
11337,levle1_531.jpg,fore,Unspecified,0.0,0,907,2251,1060,2405,153,154
11338,levle1_531.jpg,fore,Unspecified,0.0,0,1045,1209,1152,1370,107,161
11339,levle1_531.jpg,fore,Unspecified,0.0,0,1060,1056,1145,1209,85,153
11340,levle1_531.jpg,fore,Unspecified,0.0,0,1145,1002,1290,1163,145,161
11341,levle1_531.jpg,fore,Unspecified,0.0,0,1313,895,1436,956,123,61
11342,levle1_531.jpg,fore,Unspecified,0.0,0,1221,711,1382,857,161,146
11343,levle1_531.jpg,fore,Unspecified,0.0,0,984,742,1129,857,145,115
11344,levle1_531.jpg,fore,Unspecified,0.0,0,884,849,1068,972,184,123
11345,levle1_531.jpg,fore,Unspecified,0.0,0,1742,228,1873,382,131,154
11346,levle1_531.jpg,fore,Unspecified,0.0,0,2570,1501,2700,1592,130,91
11347,levle1_257.jpg,fore,Unspecified,0.0,0,3025,1915,3077,1968,52,53
11348,levle1_257.jpg,fore,Unspecified,0.0,0,3244,1845,3296,1924,52,79
11349,levle1_257.jpg,fore,Unspecified,0.0,0,3428,1836,3481,1906,53,70
11350,levle1_257.jpg,fore,Unspecified,0.0,0,3358,1836,3437,1915,79,79
11351,levle1_257.jpg,fore,Unspecified,0.0,0,3393,1950,3454,2029,61,79
11352,levle1_257.jpg,fore,Unspecified,0.0,0,3384,2055,3437,2117,53,62
11353,levle1_257.jpg,fore,Unspecified,0.0,0,3402,2125,3489,2204,87,79
11354,levle1_257.jpg,fore,Unspecified,0.0,0,3209,2134,3305,2257,96,123
11355,levle1_257.jpg,fore,Unspecified,0.0,0,3068,2125,3147,2213,79,88
11356,levle1_257.jpg,fore,Unspecified,0.0,0,3419,1152,3472,1266,53,114
11357,levle1_519.jpg,fore,Unspecified,0.0,0,2685,1822,2830,1914,145,92
11358,levle1_519.jpg,fore,Unspecified,0.0,0,2716,1960,2838,2144,122,184
11359,levle1_519.jpg,fore,Unspecified,0.0,0,1459,2688,1635,2811,176,123
11360,levle1_519.jpg,fore,Unspecified,0.0,0,1650,3071,1827,3240,177,169
11361,levle1_519.jpg,fore,Unspecified,0.0,0,1551,3163,1643,3294,92,131
11362,levle1_519.jpg,fore,Unspecified,0.0,0,1942,2466,2072,2650,130,184
11363,levle1_519.jpg,fore,Unspecified,0.0,0,2179,2420,2263,2573,84,153
11364,levle1_519.jpg,fore,Unspecified,0.0,0,2286,2389,2378,2489,92,100
11365,levle1_519.jpg,fore,Unspecified,0.0,0,2248,2527,2340,2658,92,131
11366,levle1_519.jpg,fore,Unspecified,0.0,0,2432,2328,2624,2474,192,146
11367,levle0_291.jpg,fore,Unspecified,0.0,0,961,2351,1214,2543,253,192
11368,levle0_291.jpg,fore,Unspecified,0.0,0,1267,2489,1397,2704,130,215
11369,levle2_141.jpg,fore,Unspecified,0.0,0,463,1539,608,1692,145,153
11370,levle2_141.jpg,fore,Unspecified,0.0,0,248,1845,363,1999,115,154
11371,levle2_141.jpg,fore,Unspecified,0.0,0,524,1991,639,2167,115,176
11372,levle2_141.jpg,fore,Unspecified,0.0,0,578,1891,731,1991,153,100
11373,levle2_141.jpg,fore,Unspecified,0.0,0,692,2175,800,2328,108,153
11374,levle2_141.jpg,fore,Unspecified,0.0,0,593,2221,692,2290,99,69
11375,levle2_141.jpg,fore,Unspecified,0.0,0,570,2305,700,2412,130,107
11376,levle2_141.jpg,fore,Unspecified,0.0,0,547,2443,601,2535,54,92
11377,levle2_141.jpg,fore,Unspecified,0.0,0,639,2397,708,2481,69,84
11378,levle2_141.jpg,fore,Unspecified,0.0,0,738,2320,884,2397,146,77
11379,levle2_141.jpg,fore,Unspecified,0.0,0,784,2206,861,2297,77,91
11380,levle2_141.jpg,fore,Unspecified,0.0,0,769,2382,830,2497,61,115
11381,levle2_141.jpg,fore,Unspecified,0.0,0,930,2443,1022,2527,92,84
11382,levle2_141.jpg,fore,Unspecified,0.0,0,1037,2504,1206,2635,169,131
11383,levle2_141.jpg,fore,Unspecified,0.0,0,1045,2382,1137,2520,92,138
11384,levle2_141.jpg,fore,Unspecified,0.0,0,1160,2512,1329,2635,169,123
11385,levle2_141.jpg,fore,Unspecified,0.0,0,1183,2251,1244,2374,61,123
11386,levle2_141.jpg,fore,Unspecified,0.0,0,1229,2144,1375,2313,146,169
11387,levle2_141.jpg,fore,Unspecified,0.0,0,1352,2075,1443,2183,91,108
11388,levle2_141.jpg,fore,Unspecified,0.0,0,938,2206,1037,2336,99,130
11389,levle2_141.jpg,fore,Unspecified,0.0,0,1122,2098,1214,2244,92,146
11390,levle2_141.jpg,fore,Unspecified,0.0,0,984,2052,1106,2183,122,131
11391,levle2_141.jpg,fore,Unspecified,0.0,0,876,458,961,589,85,131
11392,levle2_141.jpg,fore,Unspecified,0.0,0,1650,543,1750,711,100,168
11393,levle0_285.jpg,fore,Unspecified,0.0,0,2394,2183,2562,2397,168,214
11394,levle2_155.jpg,fore,Unspecified,0.0,0,547,520,670,650,123,130
11395,levle2_155.jpg,fore,Unspecified,0.0,0,938,182,1030,305,92,123
11396,levle2_155.jpg,fore,Unspecified,0.0,0,1359,290,1520,397,161,107
11397,levle2_155.jpg,fore,Unspecified,0.0,0,1183,780,1313,926,130,146
11398,levle2_155.jpg,fore,Unspecified,0.0,0,501,895,677,1041,176,146
11399,levle2_155.jpg,fore,Unspecified,0.0,0,432,1133,486,1179,54,46
11400,levle2_155.jpg,fore,Unspecified,0.0,0,286,1133,417,1332,131,199
11401,levle2_155.jpg,fore,Unspecified,0.0,0,179,849,309,1002,130,153
11402,levle2_155.jpg,fore,Unspecified,0.0,0,202,1370,332,1508,130,138
11403,levle2_155.jpg,fore,Unspecified,0.0,0,263,1661,386,1761,123,100
11404,levle2_155.jpg,fore,Unspecified,0.0,0,233,1807,340,1899,107,92
11405,levle2_155.jpg,fore,Unspecified,0.0,0,524,1508,700,1646,176,138
11406,levle2_155.jpg,fore,Unspecified,0.0,0,961,2366,1122,2458,161,92
11407,levle2_155.jpg,fore,Unspecified,0.0,0,685,2435,830,2543,145,108
11408,levle2_155.jpg,fore,Unspecified,0.0,0,769,2558,899,2719,130,161
11409,levle2_155.jpg,fore,Unspecified,0.0,0,478,2251,547,2382,69,131
11410,levle2_155.jpg,fore,Unspecified,0.0,0,624,2114,708,2259,84,145
11411,levle2_155.jpg,fore,Unspecified,0.0,0,570,1953,708,2106,138,153
11412,levle2_155.jpg,fore,Unspecified,0.0,0,455,1960,601,2075,146,115
11413,levle2_155.jpg,fore,Unspecified,0.0,0,263,1937,378,2052,115,115
11414,levle2_155.jpg,fore,Unspecified,0.0,0,325,1960,455,2129,130,169
11415,levle2_155.jpg,fore,Unspecified,0.0,0,401,2029,516,2183,115,154
11416,levle2_155.jpg,fore,Unspecified,0.0,0,1306,2834,1397,2972,91,138
11417,levle2_155.jpg,fore,Unspecified,0.0,0,1405,2788,1520,2934,115,146
11418,levle2_155.jpg,fore,Unspecified,0.0,0,1528,2888,1627,3025,99,137
11419,levle2_155.jpg,fore,Unspecified,0.0,0,1574,1110,1673,1278,99,168
11420,levle2_155.jpg,fore,Unspecified,0.0,0,1750,1133,1827,1309,77,176
11421,levle2_155.jpg,fore,Unspecified,0.0,0,1689,1018,1765,1133,76,115
11422,levle2_155.jpg,fore,Unspecified,0.0,0,1229,1945,1313,2106,84,161
11423,levle2_155.jpg,fore,Unspecified,0.0,0,1650,2175,1796,2282,146,107
11424,levle2_155.jpg,fore,Unspecified,0.0,0,1252,290,1382,481,130,191
11425,levle2_169.jpg,fore,Unspecified,0.0,0,2164,688,2263,819,99,131
11426,levle2_169.jpg,fore,Unspecified,0.0,0,2018,688,2110,750,92,62
11427,levle2_169.jpg,fore,Unspecified,0.0,0,823,2213,915,2305,92,92
11428,levle2_169.jpg,fore,Unspecified,0.0,0,685,1562,830,1792,145,230
11429,levle2_169.jpg,fore,Unspecified,0.0,0,1060,2512,1214,2650,154,138
11430,levle2_169.jpg,fore,Unspecified,0.0,0,1589,2512,1719,2619,130,107
11431,levle2_169.jpg,fore,Unspecified,0.0,0,1313,2535,1466,2696,153,161
11432,levle2_169.jpg,fore,Unspecified,0.0,0,1727,2880,1865,2972,138,92
11433,levle2_169.jpg,fore,Unspecified,0.0,0,1344,2328,1428,2443,84,115
11434,levle2_169.jpg,fore,Unspecified,0.0,0,1099,2160,1191,2259,92,99
11435,levle2_169.jpg,fore,Unspecified,0.0,0,1482,550,1612,719,130,169
11436,levle2_169.jpg,fore,Unspecified,0.0,0,1252,1163,1359,1324,107,161
11437,levle2_169.jpg,fore,Unspecified,0.0,0,2118,933,2210,1041,92,108
11438,levle2_169.jpg,fore,Unspecified,0.0,0,2348,1156,2501,1263,153,107
11439,levle2_169.jpg,fore,Unspecified,0.0,0,1758,658,1819,757,61,99
11440,levle2_169.jpg,fore,Unspecified,0.0,0,2286,688,2340,773,54,85
11441,levle2_169.jpg,fore,Unspecified,0.0,0,2340,665,2424,773,84,108
11442,levle2_169.jpg,fore,Unspecified,0.0,0,2348,780,2555,926,207,146
11443,levle2_169.jpg,fore,Unspecified,0.0,0,1436,903,1696,1133,260,230
11444,levle2_169.jpg,fore,Unspecified,0.0,0,1420,1194,1658,1363,238,169
11445,levle2_169.jpg,fore,Unspecified,0.0,0,830,1922,945,2106,115,184
11446,levle2_169.jpg,fore,Unspecified,0.0,0,677,1945,792,2045,115,100
11447,levle2_169.jpg,fore,Unspecified,0.0,0,1290,2819,1413,2941,123,122
11448,levle2_169.jpg,fore,Unspecified,0.0,0,1574,2229,1735,2366,161,137
11449,levle2_169.jpg,fore,Unspecified,0.0,0,1643,3156,1750,3301,107,145
11450,levle0_252.jpg,fore,Unspecified,0.0,0,1551,2780,1719,2888,168,108
11451,levle0_252.jpg,fore,Unspecified,0.0,0,1804,2696,1980,2834,176,138
11452,levle0_252.jpg,fore,Unspecified,0.0,0,1375,3056,1543,3248,168,192
11453,levle2_182.jpg,fore,,,0,1099,2842,1275,2995,176,153
11454,levle2_182.jpg,fore,,,0,1290,2865,1428,2972,138,107
11455,levle2_182.jpg,fore,,,0,1313,1830,1428,1960,115,130
11456,levle2_182.jpg,fore,,,0,1581,1723,1788,1953,207,230
11457,levle2_182.jpg,fore,,,0,2034,1991,2110,2098,76,107
11458,levle2_182.jpg,fore,,,0,1980,2060,2141,2236,161,176
11459,levle2_182.jpg,fore,,,0,1834,2098,2011,2336,177,238
11460,levle2_182.jpg,fore,,,0,1911,2259,2072,2458,161,199
11461,levle2_182.jpg,fore,,,0,1903,2979,2034,3125,131,146
11462,levle2_182.jpg,fore,,,0,1275,3002,1459,3194,184,192
11463,levle2_182.jpg,fore,,,0,1160,3125,1252,3217,92,92
11464,levle2_182.jpg,fore,,,0,1765,3018,1919,3194,154,176
11465,levle2_182.jpg,fore,,,0,753,2315,902,2415,149,100
11466,levle2_182.jpg,fore,,,0,1615,2812,1719,2919,104,107
11467,levle2_182.jpg,fore,,,0,1474,1619,1626,1732,152,113
11468,levle2_182.jpg,fore,,,0,1388,1736,1526,1850,138,114
11469,levle2_182.jpg,fore,,,0,1346,936,1471,1029,125,93
11470,levle2_182.jpg,fore,,,0,784,2057,915,2191,131,134
11471,levle2_182.jpg,fore,,,0,843,2629,971,2750,128,121
11472,levle2_182.jpg,fore,,,0,722,1794,871,1925,149,131
11473,levle2_182.jpg,fore,,,0,1057,3032,1198,3170,141,138
11474,levle0_246.jpg,fore,Unspecified,0.0,0,2087,2688,2248,2773,161,85
11475,levle0_246.jpg,fore,Unspecified,0.0,0,2171,2412,2271,2550,100,138
11476,levle0_246.jpg,fore,Unspecified,0.0,0,2578,1700,2700,1930,122,230
11477,levle0_520.jpg,fore,Unspecified,0.0,0,1627,2129,1811,2359,184,230
11478,levle0_520.jpg,fore,Unspecified,0.0,0,999,1899,1129,2006,130,107
11479,levle0_520.jpg,fore,Unspecified,0.0,0,1627,3064,1857,3232,230,168
11480,levle0_508.jpg,fore,Unspecified,0.0,0,807,926,961,1064,154,138
11481,levle0_508.jpg,fore,Unspecified,0.0,0,616,2405,738,2619,122,214
11482,levle2_22.jpg,fore,Unspecified,0.0,0,200,3,227,36,27,33
11483,levle2_22.jpg,fore,Unspecified,0.0,0,251,63,277,88,26,25
11484,levle2_22.jpg,fore,Unspecified,0.0,0,295,112,317,139,22,27
11485,levle2_22.jpg,fore,Unspecified,0.0,0,288,77,312,103,24,26
11486,levle2_22.jpg,fore,Unspecified,0.0,0,208,130,235,154,27,24
11487,levle2_22.jpg,fore,Unspecified,0.0,0,192,166,220,189,28,23
11488,levle2_22.jpg,fore,Unspecified,0.0,0,144,177,167,197,23,20
11489,levle2_22.jpg,fore,Unspecified,0.0,0,148,199,186,243,38,44
11490,levle2_22.jpg,fore,Unspecified,0.0,0,134,234,157,257,23,23
11491,levle2_22.jpg,fore,Unspecified,0.0,0,79,193,96,213,17,20
11492,levle2_22.jpg,fore,Unspecified,0.0,0,84,216,104,239,20,23
11493,levle2_22.jpg,fore,Unspecified,0.0,0,108,191,133,209,25,18
11494,levle2_22.jpg,fore,Unspecified,0.0,0,110,205,127,234,17,29
11495,levle2_22.jpg,fore,Unspecified,0.0,0,235,293,251,320,16,27
11496,levle2_22.jpg,fore,Unspecified,0.0,0,268,278,290,296,22,18
11497,levle2_22.jpg,fore,Unspecified,0.0,0,289,249,324,278,35,29
11498,levle2_22.jpg,fore,Unspecified,0.0,0,342,305,362,331,20,26
11499,levle2_22.jpg,fore,Unspecified,0.0,0,258,392,289,436,31,44
11500,levle2_22.jpg,fore,Unspecified,0.0,0,238,166,262,192,24,26
11501,levle2_22.jpg,fore,Unspecified,0.0,0,170,7,198,30,28,23
11502,levle2_22.jpg,fore,Unspecified,0.0,0,184,271,206,296,22,25
11503,levle2_22.jpg,fore,Unspecified,0.0,0,166,269,191,292,25,23
11504,levle2_22.jpg,fore,Unspecified,0.0,0,43,299,68,334,25,35
11505,levle2_22.jpg,fore,Unspecified,0.0,0,48,348,74,388,26,40
11506,levle2_22.jpg,fore,Unspecified,0.0,0,98,433,126,458,28,25
11507,levle2_22.jpg,fore,Unspecified,0.0,0,152,434,178,458,26,24
11508,levle2_22.jpg,fore,Unspecified,0.0,0,218,430,242,452,24,22
11509,levle2_22.jpg,fore,Unspecified,0.0,0,112,344,140,376,28,32
11510,levle2_36.jpg,fore,Unspecified,0.0,0,1482,2512,1597,2681,115,169
11511,levle2_36.jpg,fore,Unspecified,0.0,0,1543,2987,1681,3163,138,176
11512,levle2_36.jpg,fore,Unspecified,0.0,0,1405,3102,1566,3240,161,138
11513,levle2_36.jpg,fore,Unspecified,0.0,0,1244,3140,1413,3294,169,154
11514,levle2_36.jpg,fore,Unspecified,0.0,0,1122,2313,1237,2451,115,138
11515,levle2_36.jpg,fore,Unspecified,0.0,0,953,2152,1099,2267,146,115
11516,levle2_36.jpg,fore,Unspecified,0.0,0,1152,2006,1298,2144,146,138
11517,levle2_36.jpg,fore,Unspecified,0.0,0,1037,1976,1191,2160,154,184
11518,levle2_36.jpg,fore,Unspecified,0.0,0,884,1937,976,2091,92,154
11519,levle2_36.jpg,fore,Unspecified,0.0,0,731,2244,861,2397,130,153
11520,levle2_36.jpg,fore,Unspecified,0.0,0,930,2328,1007,2481,77,153
11521,levle2_36.jpg,fore,Unspecified,0.0,0,570,2297,631,2481,61,184
11522,levle2_36.jpg,fore,Unspecified,0.0,0,486,2320,601,2458,115,138
11523,levle2_36.jpg,fore,Unspecified,0.0,0,240,2274,378,2428,138,154
11524,levle2_36.jpg,fore,Unspecified,0.0,0,263,1868,424,1976,161,108
11525,levle2_36.jpg,fore,Unspecified,0.0,0,355,1914,539,2029,184,115
11526,levle2_36.jpg,fore,Unspecified,0.0,0,371,1730,486,1853,115,123
11527,levle2_36.jpg,fore,Unspecified,0.0,0,279,1761,348,1853,69,92
11528,levle2_36.jpg,fore,Unspecified,0.0,0,271,1600,409,1784,138,184
11529,levle2_36.jpg,fore,Unspecified,0.0,0,340,1508,516,1677,176,169
11530,levle2_36.jpg,fore,Unspecified,0.0,0,325,1347,501,1569,176,222
11531,levle2_36.jpg,fore,Unspecified,0.0,0,217,1386,363,1547,146,161
11532,levle2_36.jpg,fore,Unspecified,0.0,0,516,1309,647,1493,131,184
11533,levle2_36.jpg,fore,Unspecified,0.0,0,616,1271,777,1455,161,184
11534,levle2_36.jpg,fore,Unspecified,0.0,0,570,1148,723,1317,153,169
11535,levle2_36.jpg,fore,Unspecified,0.0,0,654,1018,769,1148,115,130
11536,levle2_36.jpg,fore,Unspecified,0.0,0,792,1048,953,1232,161,184
11537,levle2_36.jpg,fore,Unspecified,0.0,0,417,1064,555,1202,138,138
11538,levle2_36.jpg,fore,Unspecified,0.0,0,309,1163,470,1340,161,177
11539,levle2_36.jpg,fore,Unspecified,0.0,0,624,581,800,727,176,146
11540,levle2_36.jpg,fore,Unspecified,0.0,0,1306,566,1489,780,183,214
11541,levle2_36.jpg,fore,Unspecified,0.0,0,1382,742,1505,972,123,230
11542,levle2_36.jpg,fore,Unspecified,0.0,0,1489,910,1627,995,138,85
11543,levle2_36.jpg,fore,Unspecified,0.0,0,1604,681,1765,918,161,237
11544,levle2_36.jpg,fore,Unspecified,0.0,0,1827,458,1972,665,145,207
11545,levle2_36.jpg,fore,Unspecified,0.0,0,1857,688,1988,834,131,146
11546,levle2_36.jpg,fore,Unspecified,0.0,0,1949,757,2087,926,138,169
11547,levle2_36.jpg,fore,Unspecified,0.0,0,800,2688,915,2834,115,146
11548,levle2_36.jpg,fore,Unspecified,0.0,0,1405,320,1612,596,207,276
11549,levle0_483.jpg,fore,Unspecified,0.0,0,1612,2734,1712,2865,100,131
11550,levle0_483.jpg,fore,Unspecified,0.0,0,884,1087,991,1294,107,207
11551,levle0_497.jpg,fore,Unspecified,0.0,0,1244,3232,1375,3355,131,123
11552,levle0_440.jpg,fore,Unspecified,0.0,0,2072,2022,2194,2152,122,130
11553,levle0_440.jpg,fore,Unspecified,0.0,0,2194,2711,2363,2834,169,123
11554,levle0_326.jpg,fore,Unspecified,0.0,0,1321,2290,1459,2412,138,122
11555,levle1_135.jpg,fore,Unspecified,0.0,0,447,2489,547,2589,100,100
11556,levle1_135.jpg,fore,Unspecified,0.0,0,570,2581,647,2742,77,161
11557,levle1_135.jpg,fore,Unspecified,0.0,0,692,2558,761,2681,69,123
11558,levle1_135.jpg,fore,Unspecified,0.0,0,777,2627,853,2727,76,100
11559,levle1_135.jpg,fore,Unspecified,0.0,0,700,2727,823,2811,123,84
11560,levle1_135.jpg,fore,Unspecified,0.0,0,555,2888,670,2964,115,76
11561,levle1_135.jpg,fore,Unspecified,0.0,0,968,2941,1068,3087,100,146
11562,levle0_332.jpg,fore,Unspecified,0.0,0,1352,2229,1459,2389,107,160
11563,levle1_121.jpg,fore,Unspecified,0.0,0,1860,770,2001,820,141,50
11564,levle1_121.jpg,fore,Unspecified,0.0,0,2675,770,2766,870,91,100
11565,levle1_121.jpg,fore,Unspecified,0.0,0,2301,1934,2417,2100,116,166
11566,levle1_121.jpg,fore,Unspecified,0.0,0,2874,2782,2999,2906,125,124
11567,levle1_121.jpg,fore,Unspecified,0.0,0,2176,2765,2267,2898,91,133
11568,levle1_121.jpg,fore,Unspecified,0.0,0,2434,2125,2550,2241,116,116
11569,levle0_454.jpg,fore,Unspecified,0.0,0,2424,1930,2608,2121,184,191
11570,levle0_454.jpg,fore,Unspecified,0.0,0,2095,1991,2271,2206,176,215
11571,levle0_27.jpg,fore,Unspecified,0.0,0,1781,2995,1972,3140,191,145
11572,levle1_109.jpg,fore,Unspecified,0.0,0,1960,887,2118,1061,158,174
11573,levle1_109.jpg,fore,Unspecified,0.0,0,2808,429,2932,621,124,192
11574,levle1_109.jpg,fore,Unspecified,0.0,0,2442,2682,2575,2856,133,174
11575,levle1_109.jpg,fore,Unspecified,0.0,0,2774,2765,2899,2923,125,158
11576,levle1_109.jpg,fore,Unspecified,0.0,0,2899,2865,2999,3048,100,183
11577,levle1_109.jpg,fore,Unspecified,0.0,0,2633,3006,2866,3164,233,158
11578,levle1_109.jpg,fore,Unspecified,0.0,0,2442,2441,2550,2599,108,158
11579,levle1_109.jpg,fore,Unspecified,0.0,0,2226,2682,2326,2823,100,141
11580,levle1_109.jpg,fore,Unspecified,0.0,0,2999,388,3173,496,174,108
11581,levle1_109.jpg,fore,Unspecified,0.0,0,3198,1601,3306,1751,108,150
11582,levle1_109.jpg,fore,Unspecified,0.0,0,3148,1759,3281,1851,133,92
11583,levle1_109.jpg,fore,Unspecified,0.0,0,2234,2258,2342,2391,108,133
11584,levle0_468.jpg,fore,Unspecified,0.0,0,302,811,447,865,145,54
11585,levle0_468.jpg,fore,Unspecified,0.0,0,302,2313,409,2397,107,84
11586,levle0_33.jpg,fore,Unspecified,0.0,0,1474,2688,1620,2849,146,161
11587,levle0_33.jpg,fore,Unspecified,0.0,0,1988,2137,2102,2305,114,168
11588,levle1_492.jpg,fore,Unspecified,0.0,0,1704,2198,1804,2305,100,107
11589,levle1_492.jpg,fore,Unspecified,0.0,0,2279,2121,2401,2290,122,169
11590,levle1_492.jpg,fore,Unspecified,0.0,0,2102,2137,2225,2274,123,137
11591,levle1_492.jpg,fore,Unspecified,0.0,0,2079,2267,2240,2382,161,115
11592,levle1_492.jpg,fore,Unspecified,0.0,0,2202,2320,2294,2443,92,123
11593,levle1_492.jpg,fore,Unspecified,0.0,0,2294,2290,2409,2451,115,161
11594,levle1_492.jpg,fore,Unspecified,0.0,0,2018,2374,2148,2512,130,138
11595,levle1_492.jpg,fore,Unspecified,0.0,0,2102,2504,2194,2635,92,131
11596,levle1_492.jpg,fore,Unspecified,0.0,0,2194,2435,2294,2596,100,161
11597,levle1_486.jpg,fore,Unspecified,0.0,0,447,2382,562,2481,115,99
11598,levle1_486.jpg,fore,Unspecified,0.0,0,677,2497,823,2642,146,145
11599,levle1_486.jpg,fore,Unspecified,0.0,0,1727,979,1850,1071,123,92
11600,levle1_486.jpg,fore,Unspecified,0.0,0,1344,2857,1420,3010,76,153
11601,levle1_486.jpg,fore,Unspecified,0.0,0,1505,3102,1597,3179,92,77
11602,levle1_486.jpg,fore,Unspecified,0.0,0,1612,3209,1673,3317,61,108
11603,levle1_486.jpg,fore,Unspecified,0.0,0,784,2995,938,3125,154,130
11604,levle1_486.jpg,fore,Unspecified,0.0,0,1060,3232,1267,3386,207,154
11605,levle3_89.jpg,fore,,,0,1459,1048,1589,1163,130,115
11606,levle3_89.jpg,fore,,,0,1068,2374,1191,2543,123,169
11607,levle3_89.jpg,fore,,,0,1965,2458,2125,2589,160,131
11608,levle3_89.jpg,fore,,,0,1949,2627,2079,2811,130,184
11609,levle3_89.jpg,fore,,,0,2026,1922,2148,2052,122,130
11610,levle3_89.jpg,fore,,,0,1681,3041,1834,3171,153,130
11611,levle3_89.jpg,fore,,,0,1620,3117,1689,3324,69,207
11612,levle3_89.jpg,fore,,,0,1696,3171,1773,3301,77,130
11613,levle3_89.jpg,fore,,,0,1781,3148,1842,3278,61,130
11614,levle3_89.jpg,fore,,,0,1681,3301,1781,3393,100,92
11615,levle3_89.jpg,fore,,,0,1926,3179,2064,3324,138,145
11616,levle3_89.jpg,fore,,,0,2087,3041,2125,3202,38,161
11617,levle3_89.jpg,fore,,,0,1911,2964,2095,3094,184,130
11618,levle3_89.jpg,fore,,,0,1750,2206,1903,2374,153,168
11619,levle3_89.jpg,fore,,,0,1612,2336,1781,2474,169,138
11620,levle3_89.jpg,fore,,,0,1581,2581,1735,2765,154,184
11621,levle3_89.jpg,fore,,,0,1742,2665,1888,2842,146,177
11622,levle3_89.jpg,fore,,,0,1589,2788,1719,2888,130,100
11623,levle3_89.jpg,fore,,,0,1489,2796,1581,2964,92,168
11624,levle3_89.jpg,fore,,,0,1237,2872,1397,2979,160,107
11625,levle3_89.jpg,fore,,,0,1436,2911,1589,3094,153,183
11626,levle3_89.jpg,fore,,,0,1604,2911,1727,3064,123,153
11627,levle3_89.jpg,fore,,,0,1712,2888,1857,3056,145,168
11628,levle3_89.jpg,fore,,,0,1397,3071,1466,3240,69,169
11629,levle3_89.jpg,fore,,,0,1474,3079,1627,3240,153,161
11630,levle3_89.jpg,fore,,,0,1214,995,1321,1140,107,145
11631,levle3_89.jpg,fore,,,0,1382,918,1474,1033,92,115
11632,levle3_89.jpg,fore,,,0,1382,658,1459,773,77,115
11633,levle3_89.jpg,fore,,,0,1735,673,1834,826,99,153
11634,levle3_89.jpg,fore,,,0,1865,589,2003,727,138,138
11635,levle3_89.jpg,fore,,,0,1842,236,1980,343,138,107
11636,levle3_89.jpg,fore,,,0,1551,918,1719,1048,168,130
11637,levle3_89.jpg,fore,,,0,1635,1025,1765,1125,130,100
11638,levle3_89.jpg,fore,,,0,1436,1217,1620,1355,184,138
11639,levle3_89.jpg,fore,,,0,1896,903,2011,1002,115,99
11640,levle3_89.jpg,fore,,,0,1405,527,1497,642,92,115
11641,levle3_89.jpg,fore,,,0,1045,2152,1306,2343,261,191
11642,levle3_89.jpg,fore,,,0,981,1470,1095,1588,114,118
11643,levle3_89.jpg,fore,,,0,915,1274,1022,1360,107,86
11644,levle3_89.jpg,fore,,,0,1299,2584,1405,2681,106,97
11645,levle3_89.jpg,fore,,,0,936,2546,1053,2681,117,135
11646,levle3_89.jpg,fore,,,0,1046,2781,1143,2891,97,110
11647,levle3_89.jpg,fore,,,0,1308,2263,1443,2394,135,131
11648,levle3_89.jpg,fore,,,0,1146,598,1295,691,149,93
11649,levle3_89.jpg,fore,,,0,2315,508,2429,598,114,90
11650,levle3_89.jpg,fore,,,0,2060,936,2195,1074,135,138
11651,levle3_89.jpg,fore,,,0,2329,1053,2457,1184,128,131
11652,levle3_89.jpg,fore,,,0,1729,501,1857,615,128,114
11653,levle3_89.jpg,fore,,,0,1498,470,1629,598,131,128
11654,levle3_89.jpg,fore,,,0,1281,770,1412,874,131,104
11655,levle3_89.jpg,fore,,,0,1422,774,1546,905,124,131
11656,levle3_89.jpg,fore,,,0,1133,905,1257,1001,124,96
11657,levle3_89.jpg,fore,,,0,1505,667,1640,777,135,110
11658,levle3_89.jpg,fore,,,0,1450,1357,1560,1494,110,137
11659,levle3_89.jpg,fore,,,0,2029,405,2212,508,183,103
11660,levle3_89.jpg,fore,,,0,1691,284,1791,394,100,110
11661,levle3_89.jpg,fore,,,0,2046,532,2191,653,145,121
11662,levle3_89.jpg,fore,,,0,2057,2608,2174,2743,117,135
11663,levle3_89.jpg,fore,,,0,2143,2612,2302,2750,159,138
11664,levle3_89.jpg,fore,,,0,2271,3032,2384,3188,113,156
11665,levle1_337.jpg,fore,Unspecified,0.0,0,1566,2888,1704,3041,138,153
11666,levle1_337.jpg,fore,Unspecified,0.0,0,2011,2803,2141,2918,130,115
11667,levle1_337.jpg,fore,Unspecified,0.0,0,2631,2274,2800,2458,169,184
11668,levle1_337.jpg,fore,Unspecified,0.0,0,2256,2842,2371,2964,115,122
11669,levle1_337.jpg,fore,Unspecified,0.0,0,2102,2964,2217,3094,115,130
11670,levle1_337.jpg,fore,Unspecified,0.0,0,2286,2052,2486,2244,200,192
11671,levle0_124.jpg,fore,Unspecified,0.0,0,999,2742,1129,2872,130,130
11672,levle0_124.jpg,fore,Unspecified,0.0,0,869,2895,999,2987,130,92
11673,levle0_124.jpg,fore,Unspecified,0.0,0,807,2979,991,3033,184,54
11674,levle3_76.jpg,fore,,,0,162,18,212,82,50,64
11675,levle3_76.jpg,fore,,,0,68,29,120,71,52,42
11676,levle3_76.jpg,fore,,,0,69,67,113,107,44,40
11677,levle3_76.jpg,fore,,,0,416,247,474,280,58,33
11678,levle3_76.jpg,fore,,,0,381,302,430,325,49,23
11679,levle3_76.jpg,fore,,,0,346,377,381,419,35,42
11680,levle3_76.jpg,fore,,,0,355,403,391,445,36,42
11681,levle3_76.jpg,fore,,,0,470,368,514,407,44,39
11682,levle3_76.jpg,fore,,,0,474,326,520,378,46,52
11683,levle3_76.jpg,fore,,,0,484,299,530,335,46,36
11684,levle3_76.jpg,fore,,,0,555,306,583,339,28,33
11685,levle3_76.jpg,fore,,,0,566,323,591,343,25,20
11686,levle3_76.jpg,fore,,,0,526,364,554,395,28,31
11687,levle3_76.jpg,fore,,,0,565,347,600,386,35,39
11688,levle3_76.jpg,fore,,,0,522,240,552,269,30,29
11689,levle3_76.jpg,fore,,,0,535,267,563,296,28,29
11690,levle3_76.jpg,fore,,,0,580,271,614,302,34,31
11691,levle3_76.jpg,fore,,,0,593,328,628,359,35,31
11692,levle3_76.jpg,fore,,,0,509,325,551,354,42,29
11693,levle3_76.jpg,fore,,,0,485,283,523,302,38,19
11694,levle3_76.jpg,fore,,,0,435,315,475,338,40,23
11695,levle3_76.jpg,fore,,,0,430,354,465,379,35,25
11696,levle3_76.jpg,fore,,,0,437,378,473,412,36,34
11697,levle3_76.jpg,fore,,,0,428,407,459,443,31,36
11698,levle3_76.jpg,fore,,,0,484,396,516,434,32,38
11699,levle3_76.jpg,fore,,,0,459,443,502,473,43,30
11700,levle3_76.jpg,fore,,,0,402,429,438,456,36,27
11701,levle3_76.jpg,fore,,,0,398,391,431,416,33,25
11702,levle3_76.jpg,fore,,,0,373,347,392,374,19,27
11703,levle3_76.jpg,fore,,,0,391,343,431,381,40,38
11704,levle3_76.jpg,fore,,,0,314,375,343,408,29,33
11705,levle3_76.jpg,fore,,,0,314,401,342,438,28,37
11706,levle3_76.jpg,fore,,,0,277,333,311,366,34,33
11707,levle3_76.jpg,fore,,,0,199,257,226,284,27,27
11708,levle3_76.jpg,fore,,,0,271,229,291,254,20,25
11709,levle3_76.jpg,fore,,,0,258,122,287,148,29,26
11710,levle3_76.jpg,fore,,,0,187,96,223,127,36,31
11711,levle3_76.jpg,fore,,,0,273,23,322,65,49,42
11712,levle3_76.jpg,fore,,,0,296,71,338,112,42,41
11713,levle3_76.jpg,fore,,,0,113,248,144,297,31,49
11714,levle3_76.jpg,fore,,,0,26,145,66,187,40,42
11715,levle3_76.jpg,fore,,,0,18,215,40,248,22,33
11716,levle3_76.jpg,fore,,,0,8,83,34,120,26,37
11717,levle3_76.jpg,fore,,,0,19,64,45,91,26,27
11718,levle3_76.jpg,fore,,,0,110,75,151,121,41,46
11719,levle3_76.jpg,fore,,,0,318,309,354,343,36,34
11720,levle3_76.jpg,fore,,,0,218,143,243,173,25,30
11721,levle3_76.jpg,fore,,,0,249,194,280,216,31,22
11722,levle3_76.jpg,fore,,,0,375,276,412,299,37,23
11723,levle3_76.jpg,fore,,,0,38,5,78,34,40,29
11724,levle3_76.jpg,fore,,,0,1,1,33,28,32,27
11725,levle3_76.jpg,fore,,,0,243,78,294,115,51,37
11726,levle1_451.jpg,fore,Unspecified,0.0,0,185,602,225,653,40,51
11727,levle1_451.jpg,fore,Unspecified,0.0,0,306,625,356,673,50,48
11728,levle1_451.jpg,fore,Unspecified,0.0,0,248,653,298,698,50,45
11729,levle1_451.jpg,fore,Unspecified,0.0,0,240,618,278,660,38,42
11730,levle1_451.jpg,fore,Unspecified,0.0,0,261,544,293,575,32,31
11731,levle1_451.jpg,fore,Unspecified,0.0,0,233,512,253,575,20,63
11732,levle1_451.jpg,fore,Unspecified,0.0,0,281,469,311,534,30,65
11733,levle1_451.jpg,fore,Unspecified,0.0,0,137,413,175,439,38,26
11734,levle1_451.jpg,fore,Unspecified,0.0,0,190,408,228,433,38,25
11735,levle1_451.jpg,fore,Unspecified,0.0,0,152,368,190,398,38,30
11736,levle1_445.jpg,fore,Unspecified,0.0,0,2470,2359,2562,2466,92,107
11737,levle1_445.jpg,fore,Unspecified,0.0,0,2156,2765,2279,2911,123,146
11738,levle1_445.jpg,fore,Unspecified,0.0,0,2570,2106,2654,2221,84,115
11739,levle1_445.jpg,fore,Unspecified,0.0,0,2838,2144,2907,2313,69,169
11740,levle1_445.jpg,fore,Unspecified,0.0,0,1558,1416,1666,1539,108,123
11741,levle1_445.jpg,fore,Unspecified,0.0,0,2585,2198,2662,2328,77,130
11742,levle3_62.jpg,fore,,,0,152,357,169,384,17,27
11743,levle3_62.jpg,fore,,,0,202,354,220,376,18,22
11744,levle3_62.jpg,fore,,,0,211,333,234,353,23,20
11745,levle3_62.jpg,fore,,,0,220,309,264,331,44,22
11746,levle3_62.jpg,fore,,,0,192,285,227,310,35,25
11747,levle3_62.jpg,fore,,,0,196,254,242,277,46,23
11748,levle3_62.jpg,fore,,,0,176,265,191,283,15,18
11749,levle3_62.jpg,fore,,,0,89,232,112,255,23,23
11750,levle3_62.jpg,fore,,,0,43,257,87,287,44,30
11751,levle3_62.jpg,fore,,,0,11,235,34,258,23,23
11752,levle3_62.jpg,fore,,,0,19,182,52,209,33,27
11753,levle3_62.jpg,fore,,,0,76,168,102,200,26,32
11754,levle3_62.jpg,fore,,,0,23,124,52,152,29,28
11755,levle3_62.jpg,fore,,,0,255,118,278,142,23,24
11756,levle3_62.jpg,fore,,,0,249,141,271,171,22,30
11757,levle3_62.jpg,fore,,,0,214,197,242,235,28,38
11758,levle3_62.jpg,fore,,,0,187,141,236,164,49,23
11759,levle3_62.jpg,fore,,,0,143,127,174,146,31,19
11760,levle3_62.jpg,fore,,,0,139,145,163,169,24,24
11761,levle3_62.jpg,fore,,,0,113,118,143,138,30,20
11762,levle3_62.jpg,fore,,,0,111,86,130,114,19,28
11763,levle3_62.jpg,fore,,,0,148,62,187,92,39,30
11764,levle3_62.jpg,fore,,,0,81,80,116,107,35,27
11765,levle3_62.jpg,fore,,,0,68,49,99,80,31,31
11766,levle3_62.jpg,fore,,,0,36,59,75,92,39,33
11767,levle3_62.jpg,fore,,,0,152,214,176,241,24,27
11768,levle3_62.jpg,fore,,,0,175,191,198,212,23,21
11769,levle3_62.jpg,fore,,,0,195,173,222,199,27,26
11770,levle3_62.jpg,fore,,,0,86,300,113,322,27,22
11771,levle3_62.jpg,fore,,,0,34,316,88,349,54,33
11772,levle3_62.jpg,fore,,,0,186,327,210,347,24,20
11773,levle3_62.jpg,fore,,,0,176,34,202,51,26,17
11774,levle3_62.jpg,fore,,,0,183,96,203,120,20,24
11775,levle3_62.jpg,fore,,,0,60,22,106,48,46,26
11776,levle3_62.jpg,fore,,,0,203,86,221,111,18,25
11777,levle3_62.jpg,fore,,,0,232,66,248,91,16,25
11778,levle3_62.jpg,fore,,,0,140,257,169,284,29,27
11779,levle3_62.jpg,fore,,,0,116,185,140,232,24,47
11780,levle3_62.jpg,fore,,,0,47,211,78,236,31,25
11781,levle3_62.jpg,fore,,,0,112,339,129,368,17,29
11782,levle3_62.jpg,fore,,,0,122,69,143,90,21,21
11783,levle3_62.jpg,fore,,,0,251,341,270,363,19,22
11784,levle3_62.jpg,fore,,,0,264,342,286,365,22,23
11785,levle3_62.jpg,fore,,,0,269,306,288,331,19,25
11786,levle3_62.jpg,fore,,,0,89,254,114,278,25,24
11787,levle3_62.jpg,fore,,,0,94,387,112,402,18,15
11788,levle3_62.jpg,fore,,,0,88,370,105,383,17,13
11789,levle3_62.jpg,fore,,,0,79,379,90,392,11,13
11790,levle3_62.jpg,fore,,,0,69,393,89,408,20,15
11791,levle3_62.jpg,fore,,,0,224,126,238,145,14,19
11792,levle3_62.jpg,fore,,,0,247,100,263,119,16,19
11793,levle3_62.jpg,fore,,,0,109,270,129,292,20,22
11794,levle3_62.jpg,fore,,,0,57,287,86,312,29,25
11795,levle3_62.jpg,fore,,,0,71,119,85,152,14,33
11796,levle3_62.jpg,fore,,,0,145,414,163,431,18,17
11797,levle3_62.jpg,fore,,,0,172,380,196,402,24,22
11798,levle3_62.jpg,fore,,,0,132,166,154,191,22,25
11799,levle1_323.jpg,fore,Unspecified,0.0,0,279,2504,432,2596,153,92
11800,levle1_323.jpg,fore,Unspecified,0.0,0,363,2236,455,2328,92,92
11801,levle1_323.jpg,fore,Unspecified,0.0,0,938,2527,1060,2658,122,131
11802,levle1_323.jpg,fore,Unspecified,0.0,0,884,2397,1014,2535,130,138
11803,levle1_323.jpg,fore,Unspecified,0.0,0,1175,2550,1321,2665,146,115
11804,levle1_323.jpg,fore,Unspecified,0.0,0,1689,3110,1781,3263,92,153
11805,levle1_323.jpg,fore,Unspecified,0.0,0,1283,1079,1420,1217,137,138
11806,levle1_323.jpg,fore,Unspecified,0.0,0,2072,2190,2187,2328,115,138
11807,levle1_323.jpg,fore,Unspecified,0.0,0,1896,2550,2072,2727,176,177
11808,levle0_130.jpg,fore,Unspecified,0.0,0,2547,910,2654,1033,107,123
11809,levle0_118.jpg,fore,Unspecified,0.0,0,1313,2535,1443,2681,130,146
11810,levle1_479.jpg,fore,Unspecified,0.0,0,1336,757,1367,887,31,130
11811,levle1_479.jpg,fore,Unspecified,0.0,0,1612,711,1727,773,115,62
11812,levle1_479.jpg,fore,Unspecified,0.0,0,1850,2236,1957,2328,107,92
11813,levle1_479.jpg,fore,Unspecified,0.0,0,2263,2259,2378,2366,115,107
11814,levle1_479.jpg,fore,Unspecified,0.0,0,2156,2458,2302,2573,146,115
11815,levle1_479.jpg,fore,Unspecified,0.0,0,2133,2581,2240,2727,107,146
11816,levle1_479.jpg,fore,Unspecified,0.0,0,2164,2734,2256,2903,92,169
11817,levle1_479.jpg,fore,Unspecified,0.0,0,1911,2412,2041,2550,130,138
11818,levle1_479.jpg,fore,Unspecified,0.0,0,1942,2573,2110,2765,168,192
11819,levle1_479.jpg,fore,Unspecified,0.0,0,1474,2926,1635,3025,161,99
11820,levle1_479.jpg,fore,Unspecified,0.0,0,1260,2964,1382,3140,122,176
11821,levle1_327.jpg,fore,Unspecified,0.0,0,1673,2297,1819,2428,146,131
11822,levle1_327.jpg,fore,Unspecified,0.0,0,1658,2742,1811,2895,153,153
11823,levle1_327.jpg,fore,Unspecified,0.0,0,1696,3217,1827,3332,131,115
11824,levle1_327.jpg,fore,Unspecified,0.0,0,1091,3071,1191,3225,100,154
11825,levle1_327.jpg,fore,Unspecified,0.0,0,2271,2412,2409,2558,138,146
11826,levle1_327.jpg,fore,Unspecified,0.0,0,1880,2504,2041,2650,161,146
11827,levle0_134.jpg,fore,Unspecified,0.0,0,2202,2773,2355,2872,153,99
11828,levle3_66.jpg,fore,Unspecified,0.0,0,90,370,122,396,32,26
11829,levle3_66.jpg,fore,Unspecified,0.0,0,159,337,180,363,21,26
11830,levle3_66.jpg,fore,Unspecified,0.0,0,196,378,225,404,29,26
11831,levle3_66.jpg,fore,Unspecified,0.0,0,307,393,327,418,20,25
11832,levle3_66.jpg,fore,Unspecified,0.0,0,257,380,289,413,32,33
11833,levle3_66.jpg,fore,Unspecified,0.0,0,261,427,292,450,31,23
11834,levle3_66.jpg,fore,Unspecified,0.0,0,255,487,286,537,31,50
11835,levle3_66.jpg,fore,Unspecified,0.0,0,225,493,258,529,33,36
11836,levle3_66.jpg,fore,Unspecified,0.0,0,229,428,272,459,43,31
11837,levle3_66.jpg,fore,Unspecified,0.0,0,298,510,329,533,31,23
11838,levle3_66.jpg,fore,Unspecified,0.0,0,327,470,349,496,22,26
11839,levle3_66.jpg,fore,Unspecified,0.0,0,355,481,384,508,29,27
11840,levle3_66.jpg,fore,Unspecified,0.0,0,393,453,410,487,17,34
11841,levle3_66.jpg,fore,Unspecified,0.0,0,422,448,447,474,25,26
11842,levle3_66.jpg,fore,Unspecified,0.0,0,364,401,398,448,34,47
11843,levle3_66.jpg,fore,Unspecified,0.0,0,320,331,356,376,36,45
11844,levle3_66.jpg,fore,Unspecified,0.0,0,330,375,367,407,37,32
11845,levle3_66.jpg,fore,Unspecified,0.0,0,376,372,405,395,29,23
11846,levle3_66.jpg,fore,Unspecified,0.0,0,414,363,453,398,39,35
11847,levle3_66.jpg,fore,Unspecified,0.0,0,355,297,384,329,29,32
11848,levle3_66.jpg,fore,Unspecified,0.0,0,387,292,421,320,34,28
11849,levle3_66.jpg,fore,Unspecified,0.0,0,260,227,313,259,53,32
11850,levle3_66.jpg,fore,Unspecified,0.0,0,332,175,370,204,38,29
11851,levle3_66.jpg,fore,Unspecified,0.0,0,295,135,320,164,25,29
11852,levle3_66.jpg,fore,Unspecified,0.0,0,248,132,280,159,32,27
11853,levle3_66.jpg,fore,Unspecified,0.0,0,277,159,306,187,29,28
11854,levle3_66.jpg,fore,Unspecified,0.0,0,292,197,350,219,58,22
11855,levle3_66.jpg,fore,Unspecified,0.0,0,199,182,248,211,49,29
11856,levle3_66.jpg,fore,Unspecified,0.0,0,182,227,216,256,34,29
11857,levle3_66.jpg,fore,Unspecified,0.0,0,212,219,246,245,34,26
11858,levle3_66.jpg,fore,Unspecified,0.0,0,316,109,349,132,33,23
11859,levle3_66.jpg,fore,Unspecified,0.0,0,228,249,249,279,21,30
11860,levle3_66.jpg,fore,Unspecified,0.0,0,182,262,212,292,30,30
11861,levle3_66.jpg,fore,Unspecified,0.0,0,208,289,234,308,26,19
11862,levle3_66.jpg,fore,Unspecified,0.0,0,254,297,275,315,21,18
11863,levle3_66.jpg,fore,Unspecified,0.0,0,258,315,287,344,29,29
11864,levle3_66.jpg,fore,Unspecified,0.0,0,191,323,211,346,20,23
11865,levle3_66.jpg,fore,Unspecified,0.0,0,180,347,208,375,28,28
11866,levle3_66.jpg,fore,Unspecified,0.0,0,219,343,255,378,36,35
11867,levle3_66.jpg,fore,Unspecified,0.0,0,278,274,321,315,43,41
11868,levle3_66.jpg,fore,Unspecified,0.0,0,321,257,358,306,37,49
11869,levle3_66.jpg,fore,Unspecified,0.0,0,341,242,388,272,47,30
11870,levle3_66.jpg,fore,Unspecified,0.0,0,297,314,329,352,32,38
11871,levle3_66.jpg,fore,Unspecified,0.0,0,300,439,335,461,35,22
11872,levle3_66.jpg,fore,Unspecified,0.0,0,281,464,313,488,32,24
11873,levle3_66.jpg,fore,Unspecified,0.0,0,180,455,238,485,58,30
11874,levle3_66.jpg,fore,Unspecified,0.0,0,190,412,226,444,36,32
11875,levle3_66.jpg,fore,Unspecified,0.0,0,147,413,199,442,52,29
11876,levle3_66.jpg,fore,Unspecified,0.0,0,147,508,180,555,33,47
11877,levle3_66.jpg,fore,Unspecified,0.0,0,196,510,229,539,33,29
11878,levle3_66.jpg,fore,Unspecified,0.0,0,212,534,237,572,25,38
11879,levle3_66.jpg,fore,Unspecified,0.0,0,183,540,220,591,37,51
11880,levle3_66.jpg,fore,Unspecified,0.0,0,456,395,482,425,26,30
11881,levle1_441.jpg,fore,Unspecified,0.0,0,2041,2144,2133,2267,92,123
11882,levle1_441.jpg,fore,Unspecified,0.0,0,2240,2206,2394,2320,154,114
11883,levle1_441.jpg,fore,Unspecified,0.0,0,2585,1654,2708,1830,123,176
11884,levle1_441.jpg,fore,Unspecified,0.0,0,2248,2658,2355,2811,107,153
11885,levle1_441.jpg,fore,Unspecified,0.0,0,2194,2934,2378,3033,184,99
11886,levle1_441.jpg,fore,Unspecified,0.0,0,2509,2673,2601,2780,92,107
11887,levle1_441.jpg,fore,Unspecified,0.0,0,2363,2750,2440,2888,77,138
11888,levle1_441.jpg,fore,Unspecified,0.0,0,2562,2458,2693,2581,131,123
11889,levle1_441.jpg,fore,Unspecified,0.0,0,2784,2366,2876,2497,92,131
11890,levle1_441.jpg,fore,Unspecified,0.0,0,2302,3117,2493,3271,191,154
11891,levle1_441.jpg,fore,Unspecified,0.0,0,2493,2995,2601,3117,108,122
11892,levle1_455.jpg,fore,Unspecified,0.0,0,401,1478,585,1623,184,145
11893,levle1_455.jpg,fore,Unspecified,0.0,0,233,2359,394,2550,161,191
11894,levle1_455.jpg,fore,Unspecified,0.0,0,524,2435,731,2581,207,146
11895,levle1_455.jpg,fore,Unspecified,0.0,0,700,2152,869,2328,169,176
11896,levle1_455.jpg,fore,Unspecified,0.0,0,294,2796,440,2926,146,130
11897,levle1_455.jpg,fore,Unspecified,0.0,0,907,2550,1099,2696,192,146
11898,levle3_72.jpg,fore,,,0,984,239,1023,265,39,26
11899,levle3_72.jpg,fore,,,0,906,161,971,236,65,75
11900,levle3_72.jpg,fore,,,0,1000,142,1049,203,49,61
11901,levle3_72.jpg,fore,,,0,1153,142,1224,210,71,68
11902,levle3_72.jpg,fore,,,0,1237,174,1299,236,62,62
11903,levle3_72.jpg,fore,,,0,1166,86,1215,135,49,49
11904,levle3_72.jpg,fore,,,0,1033,83,1111,145,78,62
11905,levle3_72.jpg,fore,,,0,948,350,991,408,43,58
11906,levle3_72.jpg,fore,,,0,1309,645,1361,678,52,33
11907,levle3_72.jpg,fore,,,0,1406,645,1468,707,62,62
11908,levle3_72.jpg,fore,,,0,1445,704,1501,720,56,16
11909,levle3_72.jpg,fore,,,0,1332,928,1380,967,48,39
11910,levle3_72.jpg,fore,,,0,1341,957,1406,1022,65,65
11911,levle3_72.jpg,fore,,,0,1416,899,1465,954,49,55
11912,levle3_72.jpg,fore,,,0,1234,905,1273,980,39,75
11913,levle3_72.jpg,fore,,,0,1478,502,1546,571,68,69
11914,levle3_72.jpg,fore,,,0,1423,564,1481,626,58,62
11915,levle3_72.jpg,fore,,,0,1163,720,1241,782,78,62
11916,levle3_72.jpg,fore,,,0,1234,739,1296,769,62,30
11917,levle3_72.jpg,fore,,,0,1234,775,1299,804,65,29
11918,levle3_72.jpg,fore,,,0,1351,847,1377,921,26,74
11919,levle3_72.jpg,fore,,,0,1267,853,1328,882,61,29
11920,levle3_72.jpg,fore,,,0,1377,840,1416,873,39,33
11921,levle3_72.jpg,fore,,,0,1390,788,1439,827,49,39
11922,levle3_72.jpg,fore,,,0,1403,873,1462,905,59,32
11923,levle3_72.jpg,fore,,,0,1429,817,1491,856,62,39
11924,levle3_72.jpg,fore,,,0,1439,788,1481,808,42,20
11925,levle3_72.jpg,fore,,,0,1439,723,1507,769,68,46
11926,levle3_72.jpg,fore,,,0,1413,723,1436,769,23,46
11927,levle3_72.jpg,fore,,,0,1374,775,1413,804,39,29
11928,levle3_72.jpg,fore,,,0,1293,720,1328,756,35,36
11929,levle3_72.jpg,fore,,,0,1302,691,1371,743,69,52
11930,levle3_72.jpg,fore,,,0,1332,739,1384,801,52,62
11931,levle3_72.jpg,fore,,,0,1176,665,1215,717,39,52
11932,levle3_72.jpg,fore,,,0,763,691,835,726,72,35
11933,levle3_72.jpg,fore,,,0,805,730,841,772,36,42
11934,levle3_72.jpg,fore,,,0,1234,620,1271,654,37,34
11935,levle3_72.jpg,fore,,,0,1044,237,1092,291,48,54
11936,levle3_72.jpg,fore,,,0,874,110,918,154,44,44
11937,levle3_72.jpg,fore,,,0,941,53,1018,97,77,44
11938,levle3_72.jpg,fore,,,0,1095,185,1158,234,63,49
11939,levle3_72.jpg,fore,,,0,1371,347,1452,408,81,61
11940,levle3_72.jpg,fore,,,0,1488,674,1541,731,53,57
11941,levle3_72.jpg,fore,,,0,1303,1033,1382,1080,79,47
11942,levle3_72.jpg,fore,,,0,1226,1023,1300,1080,74,57
11943,levle3_72.jpg,fore,,,0,1261,803,1323,854,62,51
11944,levle3_72.jpg,fore,,,0,1220,825,1280,880,60,55
11945,levle3_72.jpg,fore,,,0,1277,882,1324,931,47,49
11946,levle3_72.jpg,fore,,,0,737,647,783,693,46,46
11947,levle3_72.jpg,fore,,,0,758,803,812,862,54,59
11948,levle3_72.jpg,fore,,,0,826,251,892,311,66,60
11949,levle3_72.jpg,fore,,,0,1377,597,1414,647,37,50
11950,levle3_72.jpg,fore,,,0,1343,800,1392,845,49,45
11951,levle3_72.jpg,fore,,,0,1366,659,1412,708,46,49
11952,levle3_72.jpg,fore,,,0,1220,668,1268,716,48,48
11953,levle3_72.jpg,fore,,,0,963,267,1017,319,54,52
11954,levle1_333.jpg,fore,Unspecified,0.0,0,892,2481,1014,2673,122,192
11955,levle1_333.jpg,fore,Unspecified,0.0,0,876,2213,1022,2435,146,222
11956,levle1_333.jpg,fore,Unspecified,0.0,0,317,2803,440,3010,123,207
11957,levle1_333.jpg,fore,Unspecified,0.0,0,578,2849,784,3071,206,222
11958,levle1_333.jpg,fore,Unspecified,0.0,0,800,2979,892,3156,92,177
11959,levle1_333.jpg,fore,Unspecified,0.0,0,1175,3079,1290,3194,115,115
11960,levle1_333.jpg,fore,Unspecified,0.0,0,1214,2895,1290,3064,76,169
11961,levle1_333.jpg,fore,Unspecified,0.0,0,1267,3255,1413,3401,146,146
11962,levle0_120.jpg,fore,Unspecified,0.0,0,715,2543,830,2642,115,99
11963,levle0_120.jpg,fore,Unspecified,0.0,0,447,2397,585,2504,138,107
11964,levle0_120.jpg,fore,Unspecified,0.0,0,1306,2842,1436,2956,130,114
11965,levle0_120.jpg,fore,Unspecified,0.0,0,1106,3133,1244,3309,138,176
11966,levle0_108.jpg,fore,Unspecified,0.0,0,1329,849,1436,1002,107,153
11967,levle1_469.jpg,fore,Unspecified,0.0,0,1827,612,1926,719,99,107
11968,levle1_469.jpg,fore,Unspecified,0.0,0,830,1792,968,1868,138,76
11969,levle1_469.jpg,fore,Unspecified,0.0,0,853,1876,999,1999,146,123
11970,levle1_469.jpg,fore,Unspecified,0.0,0,769,1976,869,2129,100,153
11971,levle1_469.jpg,fore,Unspecified,0.0,0,899,2037,1007,2160,108,123
11972,levle1_469.jpg,fore,Unspecified,0.0,0,853,2152,1037,2290,184,138
11973,levle1_469.jpg,fore,Unspecified,0.0,0,907,2274,1030,2443,123,169
11974,levle1_469.jpg,fore,Unspecified,0.0,0,1068,2320,1252,2543,184,223
11975,levle1_469.jpg,fore,Unspecified,0.0,0,2072,3064,2263,3255,191,191
11976,levle1_482.jpg,fore,,,0,1604,2773,1765,2956,161,183
11977,levle1_482.jpg,fore,,,0,1306,2803,1428,2934,122,131
11978,levle1_482.jpg,fore,,,0,1827,2949,2064,3125,237,176
11979,levle1_482.jpg,fore,,,0,1639,3052,1749,3135,110,83
11980,levle1_482.jpg,fore,,,0,1491,2819,1619,2967,128,148
11981,levle1_482.jpg,fore,,,0,1515,3188,1664,3288,149,100
11982,levle1_496.jpg,fore,Unspecified,0.0,0,1719,903,1857,995,138,92
11983,levle1_496.jpg,fore,Unspecified,0.0,0,1949,849,2118,1018,169,169
11984,levle1_496.jpg,fore,Unspecified,0.0,0,1972,1501,2141,1646,169,145
11985,levle1_496.jpg,fore,Unspecified,0.0,0,1750,1393,1880,1508,130,115
11986,levle1_496.jpg,fore,Unspecified,0.0,0,478,2382,608,2543,130,161
11987,levle1_496.jpg,fore,Unspecified,0.0,0,647,2604,807,2773,160,169
11988,levle1_496.jpg,fore,Unspecified,0.0,0,417,2627,524,2742,107,115
11989,levle1_496.jpg,fore,Unspecified,0.0,0,363,2213,455,2366,92,153
11990,levle1_496.jpg,fore,Unspecified,0.0,0,417,3140,532,3271,115,131
11991,levle1_496.jpg,fore,Unspecified,0.0,0,968,3217,1106,3378,138,161
11992,levle0_450.jpg,fore,Unspecified,0.0,0,2087,2405,2233,2527,146,122
11993,levle0_450.jpg,fore,Unspecified,0.0,0,1076,1386,1221,1562,145,176
11994,levle0_450.jpg,fore,Unspecified,0.0,0,1198,3140,1405,3301,207,161
11995,levle0_336.jpg,fore,Unspecified,0.0,0,2217,2650,2363,2757,146,107
11996,levle0_336.jpg,fore,Unspecified,0.0,0,1183,1041,1397,1171,214,130
11997,levle1_125.jpg,fore,Unspecified,0.0,0,1620,2604,1712,2681,92,77
11998,levle1_125.jpg,fore,Unspecified,0.0,0,1765,2665,1842,2750,77,85
11999,levle1_125.jpg,fore,Unspecified,0.0,0,1520,2865,1696,3041,176,176
12000,levle1_125.jpg,fore,Unspecified,0.0,0,1420,2474,1566,2642,146,168
12001,levle1_125.jpg,fore,Unspecified,0.0,0,945,535,1045,635,100,100
12002,levle1_125.jpg,fore,Unspecified,0.0,0,1137,3148,1252,3278,115,130
12003,levle1_125.jpg,fore,Unspecified,0.0,0,1168,2979,1283,3102,115,123
12004,levle1_125.jpg,fore,Unspecified,0.0,0,1114,2880,1229,2956,115,76
12005,levle1_125.jpg,fore,Unspecified,0.0,0,968,2903,1068,3010,100,107
12006,levle1_125.jpg,fore,Unspecified,0.0,0,984,3110,1114,3240,130,130
12007,levle0_322.jpg,fore,Unspecified,0.0,0,2394,1102,2524,1271,130,169
12008,levle0_322.jpg,fore,Unspecified,0.0,0,1436,3056,1620,3156,184,100
12009,levle1_131.jpg,fore,Unspecified,0.0,0,210,1692,294,1815,84,123
12010,levle1_131.jpg,fore,Unspecified,0.0,0,876,2650,1007,2773,131,123
12011,levle1_131.jpg,fore,Unspecified,0.0,0,1405,2060,1528,2206,123,146
12012,levle1_131.jpg,fore,Unspecified,0.0,0,1137,3102,1275,3240,138,138
12013,levle1_131.jpg,fore,Unspecified,0.0,0,1060,3332,1191,3455,131,123
12014,levle1_131.jpg,fore,Unspecified,0.0,0,1352,3179,1482,3248,130,69
12015,levle1_131.jpg,fore,Unspecified,0.0,0,1673,3217,1781,3363,108,146
12016,levle1_131.jpg,fore,Unspecified,0.0,0,1505,3209,1574,3332,69,123
12017,levle1_131.jpg,fore,Unspecified,0.0,0,578,3140,715,3286,137,146
12018,levle1_131.jpg,fore,Unspecified,0.0,0,815,3286,930,3416,115,130
12019,levle1_131.jpg,fore,Unspecified,0.0,0,424,1117,539,1255,115,138
12020,levle0_444.jpg,fore,Unspecified,0.0,0,493,1255,685,1432,192,177
12021,levle0_37.jpg,fore,Unspecified,0.0,0,1244,3125,1459,3255,215,130
12022,levle1_119.jpg,fore,Unspecified,0.0,0,2259,1053,2409,1169,150,116
12023,levle1_119.jpg,fore,Unspecified,0.0,0,1885,654,1952,737,67,83
12024,levle1_119.jpg,fore,Unspecified,0.0,0,1644,537,1752,679,108,142
12025,levle1_119.jpg,fore,Unspecified,0.0,0,1802,1360,1910,1485,108,125
12026,levle1_119.jpg,fore,Unspecified,0.0,0,1594,2125,1802,2275,208,150
12027,levle1_119.jpg,fore,Unspecified,0.0,0,1603,1119,1735,1202,132,83
12028,levle1_119.jpg,fore,Unspecified,0.0,0,1744,720,1844,820,100,100
12029,levle1_119.jpg,fore,Unspecified,0.0,0,1652,845,1735,970,83,125
12030,levle0_23.jpg,fore,Unspecified,0.0,0,1543,2888,1696,3064,153,176
12031,levle0_23.jpg,fore,Unspecified,0.0,0,1443,2336,1566,2435,123,99
12032,levle0_478.jpg,fore,Unspecified,0.0,0,1581,1056,1658,1179,77,123
12033,levle0_493.jpg,fore,Unspecified,0.0,0,1252,581,1420,788,168,207
12034,levle0_493.jpg,fore,Unspecified,0.0,0,1474,489,1666,719,192,230
12035,levle0_493.jpg,fore,Unspecified,0.0,0,1551,1914,1735,2060,184,146
12036,levle0_487.jpg,fore,Unspecified,0.0,0,532,2343,677,2527,145,184
12037,levle0_487.jpg,fore,Unspecified,0.0,0,547,2688,654,2788,107,100
12038,levle0_487.jpg,fore,Unspecified,0.0,0,409,2343,486,2489,77,146
12039,levle0_8.jpg,fore,Unspecified,0.0,0,132,49,160,66,28,17
12040,levle0_524.jpg,fore,Unspecified,0.0,0,1819,573,1988,903,169,330
12041,levle0_524.jpg,fore,Unspecified,0.0,0,455,2504,685,2696,230,192
12042,levle0_524.jpg,fore,Unspecified,0.0,0,876,2727,1206,2926,330,199
12043,levle0_242.jpg,fore,Unspecified,0.0,0,1329,2160,1489,2328,160,168
12044,levle0_242.jpg,fore,Unspecified,0.0,0,1696,2029,1834,2167,138,138
12045,levle2_186.jpg,fore,Unspecified,0.0,0,1344,2091,1466,2206,122,115
12046,levle2_186.jpg,fore,Unspecified,0.0,0,1283,1807,1397,1937,114,130
12047,levle2_186.jpg,fore,Unspecified,0.0,0,608,1432,777,1569,169,137
12048,levle2_186.jpg,fore,Unspecified,0.0,0,532,1508,593,1638,61,130
12049,levle2_186.jpg,fore,Unspecified,0.0,0,1689,972,1880,1156,191,184
12050,levle2_186.jpg,fore,Unspecified,0.0,0,2087,826,2225,987,138,161
12051,levle2_186.jpg,fore,Unspecified,0.0,0,1091,2045,1206,2297,115,252
12052,levle2_186.jpg,fore,Unspecified,0.0,0,922,2068,1083,2282,161,214
12053,levle2_186.jpg,fore,Unspecified,0.0,0,1260,2481,1397,2658,137,177
12054,levle2_186.jpg,fore,Unspecified,0.0,0,884,2397,1076,2581,192,184
12055,levle2_186.jpg,fore,Unspecified,0.0,0,800,2428,922,2535,122,107
12056,levle2_186.jpg,fore,Unspecified,0.0,0,685,2029,846,2290,161,261
12057,levle2_186.jpg,fore,Unspecified,0.0,0,601,2029,715,2190,114,161
12058,levle2_186.jpg,fore,Unspecified,0.0,0,463,1723,601,1861,138,138
12059,levle2_186.jpg,fore,Unspecified,0.0,0,378,1945,501,2060,123,115
12060,levle2_186.jpg,fore,Unspecified,0.0,0,286,2091,378,2236,92,145
12061,levle2_186.jpg,fore,Unspecified,0.0,0,401,2190,463,2320,62,130
12062,levle2_186.jpg,fore,Unspecified,0.0,0,447,2389,578,2573,131,184
12063,levle2_186.jpg,fore,Unspecified,0.0,0,578,2405,685,2489,107,84
12064,levle2_186.jpg,fore,Unspecified,0.0,0,570,2543,670,2711,100,168
12065,levle2_186.jpg,fore,Unspecified,0.0,0,685,2665,815,2780,130,115
12066,levle2_186.jpg,fore,Unspecified,0.0,0,532,2704,639,2811,107,107
12067,levle2_186.jpg,fore,Unspecified,0.0,0,601,2780,715,2888,114,108
12068,levle2_186.jpg,fore,Unspecified,0.0,0,738,2826,899,2956,161,130
12069,levle2_186.jpg,fore,Unspecified,0.0,0,1137,2750,1321,2865,184,115
12070,levle2_186.jpg,fore,Unspecified,0.0,0,976,2911,1083,3071,107,160
12071,levle2_186.jpg,fore,Unspecified,0.0,0,1420,3171,1597,3301,177,130
12072,levle0_256.jpg,fore,Unspecified,0.0,0,1428,2956,1612,3209,184,253
12073,levle0_530.jpg,fore,Unspecified,0.0,0,1267,2895,1397,3041,130,146
12074,levle0_530.jpg,fore,Unspecified,0.0,0,2654,796,2792,933,138,137
12075,levle0_530.jpg,fore,Unspecified,0.0,0,2463,566,2578,773,115,207
12076,levle0_518.jpg,fore,Unspecified,0.0,0,654,2428,846,2612,192,184
12077,levle0_518.jpg,fore,Unspecified,0.0,0,1106,2811,1237,3048,131,237
12078,levle0_518.jpg,fore,Unspecified,0.0,0,1773,995,1934,1186,161,191
12079,levle2_32.jpg,fore,Unspecified,0.0,0,319,163,362,193,43,30
12080,levle2_32.jpg,fore,Unspecified,0.0,0,234,206,283,246,49,40
12081,levle2_32.jpg,fore,Unspecified,0.0,0,229,236,243,255,14,19
12082,levle2_32.jpg,fore,Unspecified,0.0,0,121,195,156,225,35,30
12083,levle2_32.jpg,fore,Unspecified,0.0,0,66,206,93,235,27,29
12084,levle2_32.jpg,fore,Unspecified,0.0,0,135,151,173,178,38,27
12085,levle2_32.jpg,fore,Unspecified,0.0,0,251,158,284,193,33,35
12086,levle2_32.jpg,fore,Unspecified,0.0,0,173,60,213,90,40,30
12087,levle2_32.jpg,fore,Unspecified,0.0,0,156,243,179,274,23,31
12088,levle2_32.jpg,fore,Unspecified,0.0,0,184,258,211,281,27,23
12089,levle2_32.jpg,fore,Unspecified,0.0,0,166,291,196,311,30,20
12090,levle2_32.jpg,fore,Unspecified,0.0,0,249,316,293,343,44,27
12091,levle2_32.jpg,fore,Unspecified,0.0,0,278,348,329,381,51,33
12092,levle2_32.jpg,fore,Unspecified,0.0,0,213,324,246,369,33,45
12093,levle2_32.jpg,fore,Unspecified,0.0,0,41,67,76,100,35,33
12094,levle2_32.jpg,fore,Unspecified,0.0,0,30,5,76,33,46,28
12095,levle2_32.jpg,fore,Unspecified,0.0,0,121,5,174,78,53,73
12096,levle2_32.jpg,fore,Unspecified,0.0,0,304,198,361,233,57,35
12097,levle2_32.jpg,fore,Unspecified,0.0,0,314,226,342,263,28,37
12098,levle2_32.jpg,fore,Unspecified,0.0,0,263,266,298,299,35,33
12099,levle2_32.jpg,fore,Unspecified,0.0,0,165,213,204,255,39,42
12100,levle2_32.jpg,fore,Unspecified,0.0,0,141,313,179,361,38,48
12101,levle2_32.jpg,fore,Unspecified,0.0,0,179,326,223,366,44,40
12102,levle2_32.jpg,fore,Unspecified,0.0,0,50,388,86,427,36,39
12103,levle2_32.jpg,fore,Unspecified,0.0,0,224,399,279,436,55,37
12104,levle2_26.jpg,fore,Unspecified,0.0,0,2148,574,2223,693,75,119
12105,levle2_26.jpg,fore,Unspecified,0.0,0,1841,605,1969,680,128,75
12106,levle2_26.jpg,fore,Unspecified,0.0,0,1749,496,1820,579,71,83
12107,levle2_26.jpg,fore,Unspecified,0.0,0,1648,316,1780,526,132,210
12108,levle2_26.jpg,fore,Unspecified,0.0,0,1605,193,1688,281,83,88
12109,levle2_26.jpg,fore,Unspecified,0.0,0,855,162,960,259,105,97
12110,levle2_26.jpg,fore,Unspecified,0.0,0,719,175,881,355,162,180
12111,levle2_26.jpg,fore,Unspecified,0.0,0,1091,35,1219,193,128,158
12112,levle2_26.jpg,fore,Unspecified,0.0,0,1732,645,1793,706,61,61
12113,levle2_26.jpg,fore,Unspecified,0.0,0,1767,746,1894,816,127,70
12114,levle2_26.jpg,fore,Unspecified,0.0,0,1929,715,1999,829,70,114
12115,levle2_26.jpg,fore,Unspecified,0.0,0,2012,671,2131,781,119,110
12116,levle2_26.jpg,fore,Unspecified,0.0,0,1846,1000,1920,1066,74,66
12117,levle2_26.jpg,fore,Unspecified,0.0,0,1736,987,1811,1061,75,74
12118,levle2_26.jpg,fore,Unspecified,0.0,0,1675,1026,1749,1096,74,70
12119,levle2_26.jpg,fore,Unspecified,0.0,0,1324,1118,1429,1232,105,114
12120,levle2_26.jpg,fore,Unspecified,0.0,0,1276,1035,1350,1096,74,61
12121,levle2_26.jpg,fore,Unspecified,0.0,0,1241,925,1320,1053,79,128
12122,levle2_26.jpg,fore,Unspecified,0.0,0,1148,996,1219,1092,71,96
12123,levle2_26.jpg,fore,Unspecified,0.0,0,1306,899,1429,974,123,75
12124,levle2_26.jpg,fore,Unspecified,0.0,0,1096,763,1184,860,88,97
12125,levle2_26.jpg,fore,Unspecified,0.0,0,1934,474,1977,531,43,57
12126,levle2_26.jpg,fore,Unspecified,0.0,0,1925,873,2039,956,114,83
12127,levle2_26.jpg,fore,Unspecified,0.0,0,1758,873,1850,965,92,92
12128,levle2_26.jpg,fore,Unspecified,0.0,0,1758,811,1798,890,40,79
12129,levle2_26.jpg,fore,Unspecified,0.0,0,1644,846,1727,939,83,93
12130,levle2_26.jpg,fore,Unspecified,0.0,0,1552,925,1600,1022,48,97
12131,levle2_26.jpg,fore,Unspecified,0.0,0,1482,952,1543,1009,61,57
12132,levle2_26.jpg,fore,Unspecified,0.0,0,1561,1004,1653,1101,92,97
12133,levle2_26.jpg,fore,Unspecified,0.0,0,1359,1004,1499,1118,140,114
12134,levle2_26.jpg,fore,Unspecified,0.0,0,1398,798,1486,881,88,83
12135,levle2_26.jpg,fore,Unspecified,0.0,0,1521,763,1587,846,66,83
12136,levle2_26.jpg,fore,Unspecified,0.0,0,1412,693,1469,763,57,70
12137,levle2_26.jpg,fore,Unspecified,0.0,0,1333,675,1407,776,74,101
12138,levle2_26.jpg,fore,Unspecified,0.0,0,1249,737,1333,838,84,101
12139,levle2_26.jpg,fore,Unspecified,0.0,0,1166,680,1271,807,105,127
12140,levle2_26.jpg,fore,Unspecified,0.0,0,1534,539,1635,649,101,110
12141,levle2_26.jpg,fore,Unspecified,0.0,0,1561,640,1653,746,92,106
12142,levle2_151.jpg,fore,Unspecified,0.0,0,884,627,1045,757,161,130
12143,levle2_151.jpg,fore,Unspecified,0.0,0,930,796,1060,903,130,107
12144,levle2_151.jpg,fore,Unspecified,0.0,0,708,558,807,711,99,153
12145,levle2_151.jpg,fore,Unspecified,0.0,0,1443,1769,1566,1861,123,92
12146,levle2_151.jpg,fore,Unspecified,0.0,0,1451,1884,1604,1991,153,107
12147,levle2_151.jpg,fore,Unspecified,0.0,0,1076,1868,1229,2022,153,154
12148,levle2_151.jpg,fore,Unspecified,0.0,0,1152,2190,1290,2320,138,130
12149,levle2_151.jpg,fore,Unspecified,0.0,0,1198,2290,1359,2405,161,115
12150,levle2_151.jpg,fore,Unspecified,0.0,0,1053,2412,1206,2535,153,123
12151,levle2_151.jpg,fore,Unspecified,0.0,0,1267,2397,1352,2504,85,107
12152,levle2_151.jpg,fore,Unspecified,0.0,0,1850,1922,1934,2029,84,107
12153,levle2_151.jpg,fore,Unspecified,0.0,0,1926,1976,2018,2083,92,107
12154,levle2_151.jpg,fore,Unspecified,0.0,0,2079,1914,2202,2022,123,108
12155,levle2_151.jpg,fore,Unspecified,0.0,0,2125,1761,2256,1884,131,123
12156,levle2_151.jpg,fore,Unspecified,0.0,0,1773,2198,1896,2320,123,122
12157,levle2_151.jpg,fore,Unspecified,0.0,0,1957,2183,2110,2297,153,114
12158,levle2_151.jpg,fore,Unspecified,0.0,0,1505,2183,1612,2313,107,130
12159,levle2_151.jpg,fore,Unspecified,0.0,0,1566,2366,1704,2520,138,154
12160,levle2_151.jpg,fore,Unspecified,0.0,0,1597,2213,1735,2313,138,100
12161,levle2_151.jpg,fore,Unspecified,0.0,0,1466,2504,1581,2589,115,85
12162,levle2_151.jpg,fore,Unspecified,0.0,0,1712,2857,1850,3002,138,145
12163,levle2_151.jpg,fore,Unspecified,0.0,0,1727,2727,1811,2788,84,61
12164,levle2_151.jpg,fore,Unspecified,0.0,0,1850,2857,1995,2979,145,122
12165,levle2_151.jpg,fore,Unspecified,0.0,0,1597,2987,1750,3102,153,115
12166,levle0_281.jpg,fore,Unspecified,0.0,0,1666,3079,1850,3248,184,169
12167,levle2_145.jpg,fore,Unspecified,0.0,0,838,2198,876,2320,38,122
12168,levle2_145.jpg,fore,Unspecified,0.0,0,1106,2842,1237,2956,131,114
12169,levle2_145.jpg,fore,Unspecified,0.0,0,1352,2842,1436,2941,84,99
12170,levle2_145.jpg,fore,Unspecified,0.0,0,1650,2366,1719,2458,69,92
12171,levle2_145.jpg,fore,Unspecified,0.0,0,1796,2366,1896,2458,100,92
12172,levle2_145.jpg,fore,Unspecified,0.0,0,2049,2290,2171,2420,122,130
12173,levle2_145.jpg,fore,Unspecified,0.0,0,2294,2382,2394,2481,100,99
12174,levle2_145.jpg,fore,Unspecified,0.0,0,2271,2497,2417,2665,146,168
12175,levle2_145.jpg,fore,Unspecified,0.0,0,2102,2137,2217,2213,115,76
12176,levle2_145.jpg,fore,Unspecified,0.0,0,2034,1792,2164,1914,130,122
12177,levle2_145.jpg,fore,Unspecified,0.0,0,2593,1784,2716,1907,123,123
12178,levle2_145.jpg,fore,Unspecified,0.0,0,2417,1677,2524,1815,107,138
12179,levle2_145.jpg,fore,Unspecified,0.0,0,2455,1539,2570,1623,115,84
12180,levle2_145.jpg,fore,Unspecified,0.0,0,2072,1087,2233,1263,161,176
12181,levle2_145.jpg,fore,Unspecified,0.0,0,2087,933,2233,1064,146,131
12182,levle2_145.jpg,fore,Unspecified,0.0,0,1528,834,1673,1010,145,176
12183,levle2_145.jpg,fore,Unspecified,0.0,0,1420,1041,1551,1148,131,107
12184,levle2_145.jpg,fore,Unspecified,0.0,0,2034,2711,2148,2811,114,100
12185,levle2_145.jpg,fore,Unspecified,0.0,0,1995,2520,2156,2688,161,168
12186,levle2_145.jpg,fore,Unspecified,0.0,0,1260,3117,1367,3294,107,177
12187,levle2_145.jpg,fore,Unspecified,0.0,0,1704,2474,1804,2581,100,107
12188,levle0_295.jpg,fore,Unspecified,0.0,0,1168,2535,1260,2711,92,176
12189,levle0_295.jpg,fore,Unspecified,0.0,0,961,2160,1122,2343,161,183
12190,levle0_295.jpg,fore,Unspecified,0.0,0,1911,2068,2018,2229,107,161
12191,levle2_179.jpg,fore,,,0,761,696,984,834,223,138
12192,levle2_179.jpg,fore,,,0,2210,1501,2340,1638,130,137
12193,levle2_179.jpg,fore,,,0,2248,2267,2447,2405,199,138
12194,levle2_179.jpg,fore,,,0,1926,2297,2125,2443,199,146
12195,levle2_179.jpg,fore,,,0,1765,2221,2011,2336,246,115
12196,levle2_179.jpg,fore,,,0,2011,2075,2309,2290,298,215
12197,levle2_179.jpg,fore,,,0,2217,1876,2516,2083,299,207
12198,levle2_179.jpg,fore,,,0,1865,2619,2095,2765,230,146
12199,levle2_179.jpg,fore,,,0,1566,2497,1865,2673,299,176
12200,levle2_179.jpg,fore,,,0,1750,2773,1972,2911,222,138
12201,levle2_179.jpg,fore,,,0,2501,2504,2762,2658,261,154
12202,levle2_179.jpg,fore,,,0,2340,2857,2532,2979,192,122
12203,levle2_179.jpg,fore,,,0,1405,3240,1612,3386,207,146
12204,levle2_179.jpg,fore,,,0,1405,880,1919,1194,514,314
12205,levle2_179.jpg,fore,,,0,509,604,761,926,252,322
12206,levle2_179.jpg,fore,,,0,2657,1346,2781,1491,124,145
12207,levle2_179.jpg,fore,,,0,1546,2157,1688,2274,142,117
12208,levle2_179.jpg,fore,,,0,1777,2663,1933,2801,156,138
12209,levle2_179.jpg,fore,,,0,1160,3308,1305,3432,145,124
12210,levle2_179.jpg,fore,,,0,1681,3198,1867,3315,186,117
12211,levle2_179.jpg,fore,,,0,2029,2622,2215,2770,186,148
12212,levle1_253.jpg,fore,Unspecified,0.0,0,1260,642,1436,811,176,169
12213,levle1_253.jpg,fore,Unspecified,0.0,0,876,2604,991,2727,115,123
12214,levle1_253.jpg,fore,Unspecified,0.0,0,899,2780,1068,2956,169,176
12215,levle1_253.jpg,fore,Unspecified,0.0,0,807,2934,938,3041,131,107
12216,levle1_253.jpg,fore,Unspecified,0.0,0,1060,2443,1168,2612,108,169
12217,levle1_253.jpg,fore,Unspecified,0.0,0,1091,2911,1214,3025,123,114
12218,levle1_535.jpg,fore,Unspecified,0.0,0,1283,2512,1436,2658,153,146
12219,levle1_535.jpg,fore,Unspecified,0.0,0,1129,2834,1283,2956,154,122
12220,levle1_535.jpg,fore,Unspecified,0.0,0,1260,3041,1436,3202,176,161
12221,levle1_535.jpg,fore,Unspecified,0.0,0,1359,2849,1512,3025,153,176
12222,levle1_535.jpg,fore,Unspecified,0.0,0,1267,2734,1413,2803,146,69
12223,levle1_535.jpg,fore,Unspecified,0.0,0,1765,2788,1911,2911,146,123
12224,levle1_63.jpg,fore,Unspecified,0.0,0,2608,926,2731,1056,123,130
12225,levle1_63.jpg,fore,Unspecified,0.0,0,2463,788,2555,910,92,122
12226,levle1_63.jpg,fore,Unspecified,0.0,0,2286,727,2463,880,177,153
12227,levle1_63.jpg,fore,Unspecified,0.0,0,2034,550,2187,673,153,123
12228,levle1_63.jpg,fore,Unspecified,0.0,0,2386,1217,2524,1324,138,107
12229,levle1_63.jpg,fore,Unspecified,0.0,0,2677,1462,2792,1539,115,77
12230,levle1_63.jpg,fore,Unspecified,0.0,0,1888,3140,2057,3286,169,146
12231,levle1_63.jpg,fore,Unspecified,0.0,0,2034,3079,2256,3217,222,138
12232,levle1_521.jpg,fore,Unspecified,0.0,0,2440,2167,2547,2251,107,84
12233,levle1_521.jpg,fore,Unspecified,0.0,0,2355,2320,2493,2458,138,138
12234,levle1_521.jpg,fore,Unspecified,0.0,0,1911,2803,2087,2949,176,146
12235,levle1_521.jpg,fore,Unspecified,0.0,0,1980,3025,2148,3202,168,177
12236,levle1_521.jpg,fore,Unspecified,0.0,0,2164,2895,2309,3041,145,146
12237,levle1_521.jpg,fore,Unspecified,0.0,0,1367,3217,1497,3324,130,107
12238,levle1_521.jpg,fore,Unspecified,0.0,0,1313,3301,1443,3447,130,146
12239,levle1_77.jpg,fore,Unspecified,0.0,0,3365,471,3514,662,149,191
12240,levle1_77.jpg,fore,Unspecified,0.0,0,3456,197,3614,338,158,141
12241,levle1_77.jpg,fore,Unspecified,0.0,0,3232,1011,3389,1177,157,166
12242,levle1_77.jpg,fore,Unspecified,0.0,0,3489,878,3705,1094,216,216
12243,levle1_77.jpg,fore,Unspecified,0.0,0,3506,1385,3655,1626,149,241
12244,levle1_77.jpg,fore,Unspecified,0.0,0,3223,1626,3389,1801,166,175
12245,levle1_77.jpg,fore,Unspecified,0.0,0,3090,1718,3240,1909,150,191
12246,levle1_77.jpg,fore,Unspecified,0.0,0,3032,1535,3232,1693,200,158
12247,levle1_77.jpg,fore,Unspecified,0.0,0,3281,1967,3473,2191,192,224
12248,levle1_77.jpg,fore,Unspecified,0.0,0,3481,2050,3647,2258,166,208
12249,levle1_77.jpg,fore,Unspecified,0.0,0,2475,1917,2658,2117,183,200
12250,levle1_77.jpg,fore,Unspecified,0.0,0,2450,1701,2641,1867,191,166
12251,levle1_77.jpg,fore,Unspecified,0.0,0,2899,2108,3057,2316,158,208
12252,levle1_77.jpg,fore,Unspecified,0.0,0,3040,2025,3198,2175,158,150
12253,levle1_77.jpg,fore,Unspecified,0.0,0,3123,2241,3215,2366,92,125
12254,levle1_77.jpg,fore,Unspecified,0.0,0,3057,2374,3232,2590,175,216
12255,levle1_77.jpg,fore,Unspecified,0.0,0,2849,2349,2991,2491,142,142
12256,levle1_77.jpg,fore,Unspecified,0.0,0,3348,2391,3456,2574,108,183
12257,levle1_77.jpg,fore,Unspecified,0.0,0,3614,1593,3905,1809,291,216
12258,levle1_247.jpg,fore,Unspecified,0.0,0,616,2259,708,2366,92,107
12259,levle1_247.jpg,fore,Unspecified,0.0,0,539,2397,700,2512,161,115
12260,levle1_247.jpg,fore,Unspecified,0.0,0,884,2267,976,2405,92,138
12261,levle1_247.jpg,fore,Unspecified,0.0,0,754,2229,884,2351,130,122
12262,levle1_247.jpg,fore,Unspecified,0.0,0,1214,2489,1344,2619,130,130
12263,levle1_247.jpg,fore,Unspecified,0.0,0,1237,3071,1367,3186,130,115
12264,levle1_247.jpg,fore,Unspecified,0.0,0,1758,773,1827,857,69,84
12265,levle1_247.jpg,fore,Unspecified,0.0,0,1934,926,2049,1064,115,138
12266,levle1_247.jpg,fore,Unspecified,0.0,0,1919,1370,2011,1508,92,138
12267,levle1_247.jpg,fore,Unspecified,0.0,0,1873,1516,2041,1631,168,115
12268,levle1_247.jpg,fore,Unspecified,0.0,0,2003,765,2102,903,99,138
12269,levle1_509.jpg,fore,Unspecified,0.0,0,1704,1271,1765,1393,61,122
12270,levle1_509.jpg,fore,Unspecified,0.0,0,1037,865,1229,1025,192,160
12271,levle1_509.jpg,fore,Unspecified,0.0,0,1505,489,1635,627,130,138
12272,levle1_509.jpg,fore,Unspecified,0.0,0,1543,1002,1681,1087,138,85
12273,levle1_509.jpg,fore,Unspecified,0.0,0,616,1907,715,2075,99,168
12274,levle1_509.jpg,fore,Unspecified,0.0,0,1298,2995,1420,3110,122,115
12275,levle1_509.jpg,fore,Unspecified,0.0,0,1329,3102,1428,3202,99,100
12276,levle1_509.jpg,fore,Unspecified,0.0,0,1604,3102,1735,3255,131,153
12277,levle1_509.jpg,fore,Unspecified,0.0,0,1942,2972,2064,3171,122,199
12278,levle1_290.jpg,fore,Unspecified,0.0,0,1420,2282,1574,2466,154,184
12279,levle1_290.jpg,fore,Unspecified,0.0,0,1604,2719,1781,2888,177,169
12280,levle1_290.jpg,fore,Unspecified,0.0,0,1520,2888,1643,3025,123,137
12281,levle1_290.jpg,fore,Unspecified,0.0,0,1581,3048,1765,3240,184,192
12282,levle1_290.jpg,fore,Unspecified,0.0,0,922,2704,1122,2865,200,161
12283,levle1_290.jpg,fore,Unspecified,0.0,0,1627,2359,1811,2527,184,168
12284,levle3_140.jpg,fore,,,0,100,73,115,84,15,11
12285,levle3_140.jpg,fore,,,0,108,58,118,65,10,7
12286,levle3_140.jpg,fore,,,0,97,42,114,58,17,16
12287,levle3_140.jpg,fore,,,0,134,45,149,58,15,13
12288,levle3_140.jpg,fore,,,0,119,72,137,85,18,13
12289,levle3_140.jpg,fore,,,0,106,94,119,108,13,14
12290,levle3_140.jpg,fore,,,0,124,98,135,111,11,13
12291,levle3_140.jpg,fore,,,0,66,62,84,82,18,20
12292,levle3_140.jpg,fore,,,0,36,77,54,90,18,13
12293,levle3_140.jpg,fore,,,0,25,74,39,94,14,20
12294,levle3_140.jpg,fore,,,0,38,94,53,111,15,17
12295,levle3_140.jpg,fore,,,0,51,108,68,126,17,18
12296,levle3_140.jpg,fore,,,0,66,113,88,134,22,21
12297,levle3_140.jpg,fore,,,0,73,97,85,114,12,17
12298,levle3_140.jpg,fore,,,0,93,132,103,148,10,16
12299,levle3_140.jpg,fore,,,0,101,139,117,159,16,20
12300,levle3_140.jpg,fore,,,0,114,138,129,149,15,11
12301,levle3_140.jpg,fore,,,0,76,148,89,159,13,11
12302,levle3_140.jpg,fore,,,0,60,156,70,165,10,9
12303,levle3_140.jpg,fore,,,0,67,146,80,157,13,11
12304,levle3_140.jpg,fore,,,0,55,133,65,146,10,13
12305,levle3_140.jpg,fore,,,0,65,128,78,146,13,18
12306,levle3_140.jpg,fore,,,0,68,166,82,179,14,13
12307,levle3_140.jpg,fore,,,0,83,158,92,168,9,10
12308,levle3_140.jpg,fore,,,0,93,163,103,174,10,11
12309,levle3_140.jpg,fore,,,0,110,161,124,173,14,12
12310,levle3_140.jpg,fore,,,0,106,181,117,196,11,15
12311,levle3_140.jpg,fore,,,0,142,143,163,165,21,22
12312,levle3_140.jpg,fore,,,0,48,163,58,175,10,12
12313,levle3_140.jpg,fore,,,0,53,190,67,208,14,18
12314,levle3_140.jpg,fore,,,0,70,192,80,201,10,9
12315,levle3_140.jpg,fore,,,0,147,166,165,177,18,11
12316,levle3_140.jpg,fore,,,0,141,182,155,195,14,13
12317,levle3_140.jpg,fore,,,0,128,174,144,186,16,12
12318,levle3_140.jpg,fore,,,0,130,189,138,197,8,8
12319,levle3_140.jpg,fore,,,0,120,194,128,202,8,8
12320,levle3_140.jpg,fore,,,0,91,205,101,216,10,11
12321,levle3_140.jpg,fore,,,0,40,190,54,202,14,12
12322,levle3_140.jpg,fore,,,0,88,178,102,188,14,10
12323,levle3_140.jpg,fore,,,0,59,34,70,49,11,15
12324,levle3_140.jpg,fore,,,0,41,61,62,81,21,20
12325,levle3_140.jpg,fore,,,0,152,76,165,90,13,14
12326,levle3_140.jpg,fore,,,0,152,59,163,72,11,13
12327,levle3_140.jpg,fore,,,0,157,31,168,49,11,18
12328,levle3_140.jpg,fore,,,0,145,110,154,121,9,11
12329,levle3_140.jpg,fore,,,0,125,160,140,171,15,11
12330,levle3_140.jpg,fore,,,0,69,199,82,214,13,15
12331,levle3_140.jpg,fore,,,0,80,198,90,210,10,12
12332,levle3_140.jpg,fore,,,0,92,191,105,207,13,16
12333,levle3_140.jpg,fore,,,0,58,173,68,182,10,9
12334,levle3_140.jpg,fore,,,0,60,182,70,190,10,8
12335,levle3_140.jpg,fore,,,0,41,149,56,161,15,12
12336,levle3_140.jpg,fore,,,0,46,125,58,138,12,13
12337,levle3_140.jpg,fore,,,0,60,95,72,106,12,11
12338,levle1_284.jpg,fore,Unspecified,0.0,0,1436,1991,1581,2106,145,115
12339,levle1_284.jpg,fore,Unspecified,0.0,0,1597,2083,1696,2251,99,168
12340,levle1_284.jpg,fore,Unspecified,0.0,0,1237,2137,1382,2282,145,145
12341,levle1_284.jpg,fore,Unspecified,0.0,0,1719,2114,1865,2290,146,176
12342,levle1_284.jpg,fore,Unspecified,0.0,0,1857,1914,1988,2098,131,184
12343,levle1_284.jpg,fore,Unspecified,0.0,0,1543,2857,1650,2995,107,138
12344,levle1_88.jpg,fore,Unspecified,0.0,0,2999,1044,3223,1194,224,150
12345,levle1_88.jpg,fore,Unspecified,0.0,0,3473,1177,3647,1385,174,208
12346,levle1_88.jpg,fore,Unspecified,0.0,0,3331,1410,3531,1576,200,166
12347,levle1_88.jpg,fore,Unspecified,0.0,0,3398,1726,3564,1909,166,183
12348,levle1_88.jpg,fore,Unspecified,0.0,0,3074,1585,3215,1726,141,141
12349,levle1_88.jpg,fore,Unspecified,0.0,0,3007,1884,3232,2067,225,183
12350,levle1_88.jpg,fore,Unspecified,0.0,0,3722,1917,3996,2175,274,258
12351,levle1_89.jpg,fore,Unspecified,0.0,0,3473,1028,3614,1236,141,208
12352,levle1_89.jpg,fore,Unspecified,0.0,0,2916,1477,3157,1709,241,232
12353,levle1_89.jpg,fore,Unspecified,0.0,0,2974,1709,3090,1842,116,133
12354,levle1_89.jpg,fore,Unspecified,0.0,0,3082,2025,3115,2067,33,42
12355,levle1_89.jpg,fore,Unspecified,0.0,0,2916,1842,3140,2042,224,200
12356,levle1_89.jpg,fore,Unspecified,0.0,0,2874,1202,3123,1410,249,208
12357,levle1_89.jpg,fore,Unspecified,0.0,0,3913,1460,4063,1610,150,150
12358,levle1_89.jpg,fore,Unspecified,0.0,0,2616,2167,2774,2349,158,182
12359,levle1_285.jpg,fore,Unspecified,0.0,0,1681,1922,1827,2075,146,153
12360,levle1_285.jpg,fore,Unspecified,0.0,0,1566,2037,1750,2167,184,130
12361,levle1_285.jpg,fore,Unspecified,0.0,0,1742,2903,1911,3079,169,176
12362,levle1_285.jpg,fore,Unspecified,0.0,0,1896,2665,2026,2819,130,154
12363,levle1_285.jpg,fore,Unspecified,0.0,0,1375,2451,1459,2596,84,145
12364,levle1_285.jpg,fore,Unspecified,0.0,0,1114,2366,1244,2489,130,123
12365,levle1_285.jpg,fore,Unspecified,0.0,0,1206,2236,1306,2351,100,115
12366,levle1_285.jpg,fore,Unspecified,0.0,0,1298,2926,1428,3041,130,115
12367,levle1_285.jpg,fore,Unspecified,0.0,0,1336,3033,1459,3140,123,107
12368,levle3_141.jpg,fore,,,0,191,131,203,140,12,9
12369,levle3_141.jpg,fore,,,0,183,137,189,149,6,12
12370,levle3_141.jpg,fore,,,0,176,144,183,157,7,13
12371,levle3_141.jpg,fore,,,0,184,156,200,169,16,13
12372,levle3_141.jpg,fore,,,0,171,126,184,139,13,13
12373,levle3_141.jpg,fore,,,0,158,135,167,147,9,12
12374,levle3_141.jpg,fore,,,0,146,152,160,168,14,16
12375,levle3_141.jpg,fore,,,0,103,90,112,104,9,14
12376,levle3_141.jpg,fore,,,0,126,100,137,111,11,11
12377,levle3_141.jpg,fore,,,0,111,60,128,73,17,13
12378,levle3_141.jpg,fore,,,0,95,81,104,93,9,12
12379,levle3_141.jpg,fore,,,0,80,91,91,104,11,13
12380,levle3_141.jpg,fore,,,0,81,71,95,83,14,12
12381,levle3_141.jpg,fore,,,0,83,38,97,49,14,11
12382,levle3_141.jpg,fore,,,0,95,30,110,42,15,12
12383,levle3_141.jpg,fore,,,0,69,16,83,31,14,15
12384,levle3_141.jpg,fore,,,0,55,31,72,44,17,13
12385,levle3_141.jpg,fore,,,0,39,56,51,71,12,15
12386,levle3_141.jpg,fore,,,0,111,10,125,18,14,8
12387,levle3_141.jpg,fore,,,0,95,5,109,18,14,13
12388,levle3_141.jpg,fore,,,0,122,25,133,40,11,15
12389,levle3_141.jpg,fore,,,0,132,34,145,44,13,10
12390,levle3_141.jpg,fore,,,0,190,39,204,51,14,12
12391,levle3_141.jpg,fore,,,0,177,65,191,76,14,11
12392,levle3_141.jpg,fore,,,0,176,80,187,95,11,15
12393,levle3_141.jpg,fore,,,0,213,148,223,161,10,13
12394,levle3_141.jpg,fore,,,0,243,145,255,160,12,15
12395,levle3_141.jpg,fore,,,0,121,147,132,163,11,16
12396,levle3_141.jpg,fore,,,0,141,137,152,152,11,15
12397,levle3_141.jpg,fore,,,0,166,108,178,122,12,14
12398,levle3_141.jpg,fore,,,0,145,100,155,114,10,14
12399,levle3_141.jpg,fore,,,0,133,108,147,128,14,20
12400,levle3_141.jpg,fore,,,0,135,86,149,102,14,16
12401,levle3_141.jpg,fore,,,0,116,91,120,104,4,13
12402,levle3_141.jpg,fore,,,0,123,93,129,103,6,10
12403,levle3_141.jpg,fore,,,0,101,120,115,134,14,14
12404,levle3_141.jpg,fore,,,0,62,91,75,110,13,19
12405,levle3_141.jpg,fore,,,0,50,77,59,95,9,18
12406,levle3_141.jpg,fore,,,0,61,80,71,93,10,13
12407,levle3_141.jpg,fore,,,0,68,70,82,84,14,14
12408,levle3_141.jpg,fore,,,0,81,54,97,69,16,15
12409,levle3_141.jpg,fore,,,0,51,47,62,59,11,12
12410,levle3_141.jpg,fore,,,0,68,46,84,56,16,10
12411,levle3_141.jpg,fore,,,0,39,19,49,30,10,11
12412,levle3_141.jpg,fore,,,0,30,4,49,21,19,17
12413,levle3_141.jpg,fore,,,0,62,4,74,11,12,7
12414,levle3_141.jpg,fore,,,0,173,17,187,29,14,12
12415,levle3_141.jpg,fore,,,0,191,23,204,32,13,9
12416,levle3_141.jpg,fore,,,0,110,50,126,62,16,12
12417,levle3_141.jpg,fore,,,0,117,74,125,86,8,12
12418,levle3_141.jpg,fore,,,0,125,74,134,82,9,8
12419,levle3_141.jpg,fore,,,0,205,144,215,154,10,10
12420,levle3_141.jpg,fore,,,0,213,129,228,142,15,13
12421,levle3_141.jpg,fore,,,0,89,103,97,112,8,9
12422,levle3_141.jpg,fore,,,0,98,57,111,67,13,10
12423,levle3_141.jpg,fore,,,0,60,57,73,66,13,9
12424,levle3_141.jpg,fore,,,0,77,1,89,7,12,6
12425,levle3_141.jpg,fore,,,0,119,1,129,8,10,7
12426,levle3_141.jpg,fore,,,0,207,64,223,75,16,11
12427,levle3_141.jpg,fore,,,0,151,125,164,136,13,11
12428,levle3_141.jpg,fore,,,0,92,123,101,135,9,12
12429,levle3_141.jpg,fore,,,0,111,19,122,32,11,13
12430,levle3_141.jpg,fore,,,0,89,23,99,29,10,6
12431,levle1_291.jpg,fore,Unspecified,0.0,0,1520,1968,1627,2137,107,169
12432,levle1_291.jpg,fore,Unspecified,0.0,0,1482,2313,1704,2443,222,130
12433,levle1_291.jpg,fore,Unspecified,0.0,0,1704,2060,1873,2213,169,153
12434,levle1_291.jpg,fore,Unspecified,0.0,0,1719,2274,1819,2374,100,100
12435,levle1_291.jpg,fore,Unspecified,0.0,0,1857,2328,1942,2512,85,184
12436,levle1_291.jpg,fore,Unspecified,0.0,0,1903,2190,2072,2359,169,169
12437,levle1_291.jpg,fore,Unspecified,0.0,0,1658,2826,1834,2964,176,138
12438,levle1_291.jpg,fore,Unspecified,0.0,0,2026,2788,2064,2926,38,138
12439,levle1_291.jpg,fore,Unspecified,0.0,0,2079,2979,2233,3117,154,138
12440,levle1_508.jpg,fore,Unspecified,0.0,0,1489,2811,1604,2926,115,115
12441,levle1_508.jpg,fore,Unspecified,0.0,0,1022,757,1099,819,77,62
12442,levle1_508.jpg,fore,Unspecified,0.0,0,984,2520,1083,2658,99,138
12443,levle1_508.jpg,fore,Unspecified,0.0,0,1037,2956,1214,3025,177,69
12444,levle1_508.jpg,fore,Unspecified,0.0,0,1083,3048,1214,3148,131,100
12445,levle1_508.jpg,fore,Unspecified,0.0,0,1221,3102,1344,3209,123,107
12446,levle1_508.jpg,fore,Unspecified,0.0,0,968,3087,1076,3171,108,84
12447,levle1_508.jpg,fore,Unspecified,0.0,0,1014,3163,1106,3255,92,92
12448,levle1_508.jpg,fore,Unspecified,0.0,0,830,3079,915,3171,85,92
12449,levle1_508.jpg,fore,Unspecified,0.0,0,731,3025,807,3186,76,161
12450,levle1_508.jpg,fore,Unspecified,0.0,0,1673,2796,1796,2895,123,99
12451,levle1_508.jpg,fore,Unspecified,0.0,0,1620,2903,1727,3048,107,145
12452,levle1_508.jpg,fore,Unspecified,0.0,0,1750,2934,1873,3025,123,91
12453,levle1_76.jpg,fore,,,0,3398,429,3506,604,108,175
12454,levle1_76.jpg,fore,,,0,3273,911,3464,1044,191,133
12455,levle1_76.jpg,fore,,,0,3265,1377,3448,1618,183,241
12456,levle1_76.jpg,fore,,,0,3115,1568,3306,1859,191,291
12457,levle1_76.jpg,fore,,,0,2508,1518,2708,1734,200,216
12458,levle1_76.jpg,fore,,,0,2362,3110,2502,3226,140,116
12459,levle1_520.jpg,fore,Unspecified,0.0,0,823,1999,976,2137,153,138
12460,levle1_520.jpg,fore,Unspecified,0.0,0,539,2811,700,2972,161,161
12461,levle1_520.jpg,fore,Unspecified,0.0,0,715,3064,830,3209,115,145
12462,levle1_520.jpg,fore,Unspecified,0.0,0,1405,3056,1543,3202,138,146
12463,levle1_520.jpg,fore,Unspecified,0.0,0,1191,3056,1382,3179,191,123
12464,levle1_520.jpg,fore,Unspecified,0.0,0,876,3140,1037,3309,161,169
12465,levle1_246.jpg,fore,Unspecified,0.0,0,2317,2504,2409,2627,92,123
12466,levle1_246.jpg,fore,Unspecified,0.0,0,2309,2650,2424,2757,115,107
12467,levle1_246.jpg,fore,Unspecified,0.0,0,2417,2573,2524,2688,107,115
12468,levle1_246.jpg,fore,Unspecified,0.0,0,2217,2589,2317,2704,100,115
12469,levle1_246.jpg,fore,Unspecified,0.0,0,2164,2389,2325,2520,161,131
12470,levle1_246.jpg,fore,Unspecified,0.0,0,2034,2382,2171,2497,137,115
12471,levle1_246.jpg,fore,Unspecified,0.0,0,1988,2512,2148,2642,160,130
12472,levle1_246.jpg,fore,Unspecified,0.0,0,2049,2658,2156,2742,107,84
12473,levle1_246.jpg,fore,Unspecified,0.0,0,2102,2757,2263,2888,161,131
12474,levle1_246.jpg,fore,Unspecified,0.0,0,984,788,1053,910,69,122
12475,levle1_246.jpg,fore,Unspecified,0.0,0,869,949,999,1064,130,115
12476,levle1_246.jpg,fore,Unspecified,0.0,0,1244,1217,1413,1363,169,146
12477,levle1_246.jpg,fore,Unspecified,0.0,0,1091,1324,1198,1439,107,115
12478,levle1_252.jpg,fore,Unspecified,0.0,0,792,1332,953,1478,161,146
12479,levle1_252.jpg,fore,Unspecified,0.0,0,869,1592,1053,1792,184,200
12480,levle1_252.jpg,fore,Unspecified,0.0,0,654,1907,784,2029,130,122
12481,levle1_252.jpg,fore,Unspecified,0.0,0,670,2811,784,2964,114,153
12482,levle1_252.jpg,fore,Unspecified,0.0,0,1206,2972,1344,3117,138,145
12483,levle1_252.jpg,fore,Unspecified,0.0,0,1191,2796,1313,2934,122,138
12484,levle1_252.jpg,fore,Unspecified,0.0,0,1865,3209,2018,3355,153,146
12485,levle1_62.jpg,fore,Unspecified,0.0,0,2332,1156,2486,1355,154,199
12486,levle1_62.jpg,fore,Unspecified,0.0,0,1811,2305,1957,2451,146,146
12487,levle1_62.jpg,fore,Unspecified,0.0,0,1880,3048,1972,3156,92,108
12488,levle1_62.jpg,fore,Unspecified,0.0,0,1712,3171,1850,3309,138,138
12489,levle1_62.jpg,fore,Unspecified,0.0,0,1451,1194,1543,1324,92,130
12490,levle1_62.jpg,fore,Unspecified,0.0,0,1635,619,1750,711,115,92
12491,levle1_62.jpg,fore,Unspecified,0.0,0,1888,535,1980,650,92,115
12492,levle1_62.jpg,fore,Unspecified,0.0,0,1727,504,1827,581,100,77
12493,levle1_62.jpg,fore,Unspecified,0.0,0,2156,650,2286,788,130,138
12494,levle1_62.jpg,fore,Unspecified,0.0,0,1359,834,1489,956,130,122
12495,levle1_534.jpg,fore,Unspecified,0.0,0,647,1087,792,1179,145,92
12496,levle1_534.jpg,fore,Unspecified,0.0,0,1413,750,1543,849,130,99
12497,levle1_534.jpg,fore,Unspecified,0.0,0,1367,175,1474,282,107,107
12498,levle1_534.jpg,fore,Unspecified,0.0,0,493,2106,662,2229,169,123
12499,levle1_534.jpg,fore,Unspecified,0.0,0,371,2558,463,2696,92,138
12500,levle1_534.jpg,fore,Unspecified,0.0,0,463,2535,585,2742,122,207
12501,levle1_534.jpg,fore,Unspecified,0.0,0,700,2527,853,2688,153,161
12502,levle1_534.jpg,fore,Unspecified,0.0,0,593,2796,738,2926,145,130
12503,levle1_534.jpg,fore,Unspecified,0.0,0,961,2251,1076,2328,115,77
12504,levle2_178.jpg,fore,,,0,2118,1822,2317,1960,199,138
12505,levle2_178.jpg,fore,,,0,1589,1025,1827,1240,238,215
12506,levle2_178.jpg,fore,,,0,1811,941,1957,1102,146,161
12507,levle2_178.jpg,fore,,,0,1827,481,2057,704,230,223
12508,levle2_178.jpg,fore,,,0,616,1301,899,1455,283,154
12509,levle2_178.jpg,fore,,,0,463,2083,639,2206,176,123
12510,levle2_178.jpg,fore,,,0,355,2190,509,2313,154,123
12511,levle2_178.jpg,fore,,,0,394,2573,555,2788,161,215
12512,levle2_178.jpg,fore,,,0,539,2221,662,2359,123,138
12513,levle2_178.jpg,fore,,,0,616,2420,815,2550,199,130
12514,levle2_178.jpg,fore,,,0,769,2236,907,2328,138,92
12515,levle2_178.jpg,fore,,,0,938,2251,1099,2382,161,131
12516,levle2_178.jpg,fore,,,0,1405,2060,1535,2175,130,115
12517,levle2_178.jpg,fore,,,0,1175,2535,1367,2734,192,199
12518,levle2_178.jpg,fore,,,0,777,2642,869,2803,92,161
12519,levle2_178.jpg,fore,,,0,1397,2895,1474,2995,77,100
12520,levle2_178.jpg,fore,,,0,1022,3010,1237,3140,215,130
12521,levle2_178.jpg,fore,,,0,1083,3117,1267,3232,184,115
12522,levle2_178.jpg,fore,,,0,1290,3179,1397,3286,107,107
12523,levle2_178.jpg,fore,,,0,1405,3179,1551,3324,146,145
12524,levle2_178.jpg,fore,,,0,426,2288,543,2391,117,103
12525,levle0_294.jpg,fore,Unspecified,0.0,0,1344,2665,1612,2911,268,246
12526,levle0_294.jpg,fore,Unspecified,0.0,0,1352,3056,1581,3179,229,123
12527,levle2_144.jpg,fore,Unspecified,0.0,0,1558,926,1689,1056,131,130
12528,levle2_144.jpg,fore,Unspecified,0.0,0,2125,1018,2332,1186,207,168
12529,levle2_144.jpg,fore,Unspecified,0.0,0,2340,1202,2501,1317,161,115
12530,levle2_144.jpg,fore,Unspecified,0.0,0,2463,1439,2616,1585,153,146
12531,levle2_144.jpg,fore,Unspecified,0.0,0,2616,1807,2815,1907,199,100
12532,levle2_144.jpg,fore,Unspecified,0.0,0,2539,1554,2677,1677,138,123
12533,levle2_144.jpg,fore,Unspecified,0.0,0,2087,1968,2217,2129,130,161
12534,levle2_144.jpg,fore,Unspecified,0.0,0,1857,1999,2041,2137,184,138
12535,levle2_144.jpg,fore,Unspecified,0.0,0,2057,2106,2256,2274,199,168
12536,levle2_144.jpg,fore,Unspecified,0.0,0,2217,2167,2355,2290,138,123
12537,levle2_144.jpg,fore,Unspecified,0.0,0,2332,2183,2532,2343,200,160
12538,levle2_144.jpg,fore,Unspecified,0.0,0,800,2244,961,2405,161,161
12539,levle2_144.jpg,fore,Unspecified,0.0,0,1673,2405,1880,2512,207,107
12540,levle2_144.jpg,fore,Unspecified,0.0,0,1650,2550,1773,2673,123,123
12541,levle2_144.jpg,fore,Unspecified,0.0,0,1796,2558,1957,2704,161,146
12542,levle2_144.jpg,fore,Unspecified,0.0,0,1880,2420,2079,2566,199,146
12543,levle2_144.jpg,fore,Unspecified,0.0,0,2102,2673,2271,2826,169,153
12544,levle2_144.jpg,fore,Unspecified,0.0,0,2263,2366,2371,2489,108,123
12545,levle2_144.jpg,fore,Unspecified,0.0,0,1689,2979,1834,3102,145,123
12546,levle2_144.jpg,fore,Unspecified,0.0,0,1988,3125,2034,3171,46,46
12547,levle2_144.jpg,fore,Unspecified,0.0,0,1420,2842,1612,2987,192,145
12548,levle2_144.jpg,fore,Unspecified,0.0,0,1229,3025,1352,3179,123,154
12549,levle2_144.jpg,fore,Unspecified,0.0,0,1237,3194,1436,3309,199,115
12550,levle2_144.jpg,fore,Unspecified,0.0,0,1060,2918,1198,3102,138,184
12551,levle2_144.jpg,fore,Unspecified,0.0,0,1620,3056,1735,3163,115,107
12552,levle0_280.jpg,fore,Unspecified,0.0,0,2302,1592,2532,1707,230,115
12553,levle0_280.jpg,fore,Unspecified,0.0,0,2394,1769,2631,1845,237,76
12554,levle0_280.jpg,fore,Unspecified,0.0,0,1811,2382,2072,2665,261,283
12555,levle2_150.jpg,fore,Unspecified,0.0,0,2133,1838,2271,1945,138,107
12556,levle2_150.jpg,fore,Unspecified,0.0,0,2179,1907,2294,2114,115,207
12557,levle2_150.jpg,fore,Unspecified,0.0,0,2294,1876,2409,2006,115,130
12558,levle2_150.jpg,fore,Unspecified,0.0,0,1972,1983,2156,2114,184,131
12559,levle2_150.jpg,fore,Unspecified,0.0,0,2064,2129,2156,2313,92,184
12560,levle2_150.jpg,fore,Unspecified,0.0,0,2110,2106,2256,2190,146,84
12561,levle2_150.jpg,fore,Unspecified,0.0,0,2148,2190,2348,2351,200,161
12562,levle2_150.jpg,fore,Unspecified,0.0,0,1811,2160,1934,2274,123,114
12563,levle2_150.jpg,fore,Unspecified,0.0,0,1420,2221,1505,2320,85,99
12564,levle2_150.jpg,fore,Unspecified,0.0,0,1321,1876,1474,2022,153,146
12565,levle2_150.jpg,fore,Unspecified,0.0,0,1888,2688,2064,2819,176,131
12566,levle2_150.jpg,fore,Unspecified,0.0,0,1911,2826,2041,2964,130,138
12567,levle2_150.jpg,fore,Unspecified,0.0,0,1727,2780,1842,2872,115,92
12568,levle2_150.jpg,fore,Unspecified,0.0,0,1796,2934,1926,3094,130,160
12569,levle2_150.jpg,fore,Unspecified,0.0,0,501,1976,670,2091,169,115
12570,levle2_150.jpg,fore,Unspecified,0.0,0,593,2075,746,2244,153,169
12571,levle2_150.jpg,fore,Unspecified,0.0,0,922,489,1030,619,108,130
12572,levle2_150.jpg,fore,Unspecified,0.0,0,823,558,922,681,99,123
12573,levle2_150.jpg,fore,Unspecified,0.0,0,1390,2366,1551,2466,161,100
12574,levle2_150.jpg,fore,Unspecified,0.0,0,2294,1524,2386,1631,92,107
12575,levle2_150.jpg,fore,Unspecified,0.0,0,2309,1746,2424,1830,115,84
12576,levle2_27.jpg,fore,Unspecified,0.0,0,1322,476,1390,548,68,72
12577,levle2_27.jpg,fore,Unspecified,0.0,0,1387,532,1465,603,78,71
12578,levle2_27.jpg,fore,Unspecified,0.0,0,1247,327,1325,395,78,68
12579,levle2_27.jpg,fore,Unspecified,0.0,0,1185,382,1263,473,78,91
12580,levle2_27.jpg,fore,Unspecified,0.0,0,1312,226,1377,275,65,49
12581,levle2_27.jpg,fore,Unspecified,0.0,0,1098,262,1166,363,68,101
12582,levle2_27.jpg,fore,Unspecified,0.0,0,968,275,1046,366,78,91
12583,levle2_27.jpg,fore,Unspecified,0.0,0,909,220,968,285,59,65
12584,levle2_27.jpg,fore,Unspecified,0.0,0,861,275,952,363,91,88
12585,levle2_27.jpg,fore,Unspecified,0.0,0,786,259,900,363,114,104
12586,levle2_27.jpg,fore,Unspecified,0.0,0,643,324,711,398,68,74
12587,levle2_27.jpg,fore,Unspecified,0.0,0,565,327,646,411,81,84
12588,levle2_27.jpg,fore,Unspecified,0.0,0,565,249,620,320,55,71
12589,levle2_27.jpg,fore,Unspecified,0.0,0,789,395,870,454,81,59
12590,levle2_27.jpg,fore,Unspecified,0.0,0,630,447,718,515,88,68
12591,levle2_27.jpg,fore,Unspecified,0.0,0,487,398,555,467,68,69
12592,levle2_27.jpg,fore,Unspecified,0.0,0,461,457,519,522,58,65
12593,levle2_27.jpg,fore,Unspecified,0.0,0,750,506,822,580,72,74
12594,levle2_27.jpg,fore,Unspecified,0.0,0,831,619,913,681,82,62
12595,levle2_27.jpg,fore,Unspecified,0.0,0,584,528,649,597,65,69
12596,levle2_27.jpg,fore,Unspecified,0.0,0,1137,915,1231,977,94,62
12597,levle2_27.jpg,fore,Unspecified,0.0,0,1455,613,1514,662,59,49
12598,levle2_27.jpg,fore,Unspecified,0.0,0,1588,610,1650,675,62,65
12599,levle2_27.jpg,fore,Unspecified,0.0,0,464,798,526,873,62,75
12600,levle2_27.jpg,fore,Unspecified,0.0,0,399,548,484,636,85,88
12601,levle2_27.jpg,fore,Unspecified,0.0,0,464,587,558,665,94,78
12602,levle0_519.jpg,fore,Unspecified,0.0,0,1466,2857,1673,3018,207,161
12603,levle2_33.jpg,fore,Unspecified,0.0,0,1007,1723,1099,1861,92,138
12604,levle2_33.jpg,fore,Unspecified,0.0,0,830,1738,922,1861,92,123
12605,levle2_33.jpg,fore,Unspecified,0.0,0,2279,2305,2440,2443,161,138
12606,levle2_33.jpg,fore,Unspecified,0.0,0,2064,2512,2332,2727,268,215
12607,levle2_33.jpg,fore,Unspecified,0.0,0,2294,2481,2440,2604,146,123
12608,levle2_33.jpg,fore,Unspecified,0.0,0,2225,2083,2386,2305,161,222
12609,levle2_33.jpg,fore,Unspecified,0.0,0,2325,1991,2509,2190,184,199
12610,levle2_33.jpg,fore,Unspecified,0.0,0,2440,2068,2585,2229,145,161
12611,levle2_33.jpg,fore,Unspecified,0.0,0,2562,2037,2777,2213,215,176
12612,levle2_33.jpg,fore,Unspecified,0.0,0,1405,2995,1466,3094,61,99
12613,levle2_33.jpg,fore,Unspecified,0.0,0,2593,1684,2716,1784,123,100
12614,levle2_33.jpg,fore,Unspecified,0.0,0,2624,1508,2800,1654,176,146
12615,levle2_33.jpg,fore,Unspecified,0.0,0,2570,964,2754,1186,184,222
12616,levle2_33.jpg,fore,Unspecified,0.0,0,2110,742,2279,949,169,207
12617,levle2_33.jpg,fore,Unspecified,0.0,0,2256,803,2440,1041,184,238
12618,levle2_33.jpg,fore,Unspecified,0.0,0,2309,14,2401,137,92,123
12619,levle2_33.jpg,fore,Unspecified,0.0,0,2210,106,2378,328,168,222
12620,levle2_33.jpg,fore,Unspecified,0.0,0,2309,443,2417,604,108,161
12621,levle2_33.jpg,fore,Unspecified,0.0,0,2125,504,2240,627,115,123
12622,levle2_33.jpg,fore,Unspecified,0.0,0,1620,2236,1735,2336,115,100
12623,levle2_33.jpg,fore,Unspecified,0.0,0,1497,1891,1589,1968,92,77
12624,levle2_33.jpg,fore,Unspecified,0.0,0,1804,2926,1942,3018,138,92
12625,levle2_33.jpg,fore,Unspecified,0.0,0,1650,3102,1773,3248,123,146
12626,levle2_33.jpg,fore,Unspecified,0.0,0,1888,3102,2011,3301,123,199
12627,levle0_257.jpg,fore,Unspecified,0.0,0,1313,3064,1474,3209,161,145
12628,levle2_187.jpg,fore,Unspecified,0.0,0,2286,1776,2386,1914,100,138
12629,levle2_187.jpg,fore,Unspecified,0.0,0,2386,1715,2486,1868,100,153
12630,levle2_187.jpg,fore,Unspecified,0.0,0,2463,1669,2555,1784,92,115
12631,levle2_187.jpg,fore,Unspecified,0.0,0,2777,1953,2915,2083,138,130
12632,levle2_187.jpg,fore,Unspecified,0.0,0,2830,2221,2953,2351,123,130
12633,levle2_187.jpg,fore,Unspecified,0.0,0,2662,2137,2792,2336,130,199
12634,levle2_187.jpg,fore,Unspecified,0.0,0,2716,2313,2838,2443,122,130
12635,levle2_187.jpg,fore,Unspecified,0.0,0,2739,2412,2823,2520,84,108
12636,levle2_187.jpg,fore,Unspecified,0.0,0,2593,2458,2784,2673,191,215
12637,levle2_187.jpg,fore,Unspecified,0.0,0,2693,2635,2784,2765,91,130
12638,levle2_187.jpg,fore,Unspecified,0.0,0,2233,2343,2325,2443,92,100
12639,levle2_187.jpg,fore,Unspecified,0.0,0,2286,2251,2371,2374,85,123
12640,levle2_187.jpg,fore,Unspecified,0.0,0,2378,1884,2478,2006,100,122
12641,levle2_187.jpg,fore,Unspecified,0.0,0,2478,1899,2601,2045,123,146
12642,levle2_187.jpg,fore,Unspecified,0.0,0,1942,1945,2087,2137,145,192
12643,levle2_187.jpg,fore,Unspecified,0.0,0,1934,2466,2079,2642,145,176
12644,levle2_187.jpg,fore,Unspecified,0.0,0,1880,2696,2034,2826,154,130
12645,levle2_187.jpg,fore,Unspecified,0.0,0,2110,2704,2164,2842,54,138
12646,levle2_187.jpg,fore,Unspecified,0.0,0,2156,2734,2240,2872,84,138
12647,levle2_187.jpg,fore,Unspecified,0.0,0,2233,2696,2371,2819,138,123
12648,levle2_187.jpg,fore,Unspecified,0.0,0,2363,2681,2501,2788,138,107
12649,levle2_187.jpg,fore,Unspecified,0.0,0,2432,2765,2555,2911,123,146
12650,levle2_187.jpg,fore,Unspecified,0.0,0,2317,2780,2432,2872,115,92
12651,levle2_187.jpg,fore,Unspecified,0.0,0,2256,2849,2409,3033,153,184
12652,levle2_187.jpg,fore,Unspecified,0.0,0,1750,3064,1873,3186,123,122
12653,levle2_187.jpg,fore,Unspecified,0.0,0,1911,2987,2041,3148,130,161
12654,levle2_187.jpg,fore,Unspecified,0.0,0,1260,796,1382,995,122,199
12655,levle0_531.jpg,fore,Unspecified,0.0,0,1359,2964,1512,3133,153,169
12656,levle0_531.jpg,fore,Unspecified,0.0,0,1528,2918,1620,3018,92,100
12657,levle0_531.jpg,fore,Unspecified,0.0,0,1788,2872,1972,3048,184,176
12658,levle0_243.jpg,fore,Unspecified,0.0,0,876,704,961,773,85,69
12659,levle0_9.jpg,fore,Unspecified,0.0,0,24,195,58,234,34,39
12660,levle0_9.jpg,fore,Unspecified,0.0,0,61,181,113,225,52,44
12661,levle0_486.jpg,fore,Unspecified,0.0,0,1934,2543,2133,2665,199,122
12662,levle0_486.jpg,fore,Unspecified,0.0,0,1750,1117,1850,1248,100,131
12663,levle0_492.jpg,fore,Unspecified,0.0,0,1635,2811,1773,2941,138,130
12664,levle0_22.jpg,fore,Unspecified,0.0,0,1765,2458,1857,2573,92,115
12665,levle0_22.jpg,fore,Unspecified,0.0,0,2118,2236,2279,2412,161,176
12666,levle0_36.jpg,fore,Unspecified,0.0,0,2141,2673,2210,2796,69,123
12667,levle0_36.jpg,fore,Unspecified,0.0,0,1819,2665,1911,2780,92,115
12668,levle0_36.jpg,fore,Unspecified,0.0,0,2294,2458,2386,2596,92,138
12669,levle0_36.jpg,fore,Unspecified,0.0,0,2830,2022,2984,2160,154,138
12670,levle0_36.jpg,fore,Unspecified,0.0,0,2884,2183,2999,2389,115,206
12671,levle1_118.jpg,fore,Unspecified,0.0,0,2932,1053,3115,1161,183,108
12672,levle1_118.jpg,fore,Unspecified,0.0,0,3256,646,3373,803,117,157
12673,levle1_118.jpg,fore,Unspecified,0.0,0,3265,1269,3431,1377,166,108
12674,levle1_118.jpg,fore,Unspecified,0.0,0,3115,2042,3306,2216,191,174
12675,levle1_118.jpg,fore,Unspecified,0.0,0,3232,2216,3348,2383,116,167
12676,levle1_118.jpg,fore,Unspecified,0.0,0,3481,2441,3597,2624,116,183
12677,levle1_118.jpg,fore,Unspecified,0.0,0,2459,2915,2625,3048,166,133
12678,levle1_118.jpg,fore,Unspecified,0.0,0,2600,3014,2716,3131,116,117
12679,levle1_118.jpg,fore,Unspecified,0.0,0,2907,2948,3065,3089,158,141
12680,levle1_118.jpg,fore,Unspecified,0.0,0,2700,2366,2841,2574,141,208
12681,levle1_118.jpg,fore,Unspecified,0.0,0,2342,2432,2492,2507,150,75
12682,levle1_118.jpg,fore,Unspecified,0.0,0,2550,2474,2691,2574,141,100
12683,levle1_130.jpg,fore,Unspecified,0.0,0,731,1715,869,1884,138,169
12684,levle1_130.jpg,fore,Unspecified,0.0,0,723,2734,876,2895,153,161
12685,levle1_130.jpg,fore,Unspecified,0.0,0,1957,2083,2102,2244,145,161
12686,levle1_130.jpg,fore,Unspecified,0.0,0,1643,2987,1735,3110,92,123
12687,levle1_130.jpg,fore,Unspecified,0.0,0,1650,3225,1719,3347,69,122
12688,levle1_130.jpg,fore,Unspecified,0.0,0,1934,3002,1988,3148,54,146
12689,levle1_130.jpg,fore,Unspecified,0.0,0,1827,3033,1880,3179,53,146
12690,levle0_323.jpg,fore,Unspecified,0.0,0,1083,512,1275,650,192,138
12691,levle0_323.jpg,fore,Unspecified,0.0,0,1919,995,2141,1217,222,222
12692,levle0_451.jpg,fore,Unspecified,0.0,0,984,1025,1137,1148,153,123
12693,levle0_451.jpg,fore,Unspecified,0.0,0,1183,1271,1283,1370,100,99
12694,levle1_642.jpg,fore,Unspecified,0.0,0,69,132,81,145,12,13
12695,levle1_642.jpg,fore,Unspecified,0.0,0,54,130,64,138,10,8
12696,levle1_642.jpg,fore,Unspecified,0.0,0,47,140,58,146,11,6
12697,levle1_642.jpg,fore,Unspecified,0.0,0,55,153,64,162,9,9
12698,levle1_642.jpg,fore,Unspecified,0.0,0,48,58,61,66,13,8
12699,levle1_642.jpg,fore,Unspecified,0.0,0,43,71,57,89,14,18
12700,levle1_124.jpg,fore,Unspecified,0.0,0,2849,654,3007,754,158,100
12701,levle1_124.jpg,fore,Unspecified,0.0,0,3365,1485,3522,1601,157,116
12702,levle1_124.jpg,fore,Unspecified,0.0,0,3256,1626,3381,1809,125,183
12703,levle1_124.jpg,fore,Unspecified,0.0,0,3032,2233,3173,2399,141,166
12704,levle1_124.jpg,fore,Unspecified,0.0,0,3215,2482,3340,2665,125,183
12705,levle1_124.jpg,fore,Unspecified,0.0,0,2716,2142,2899,2324,183,182
12706,levle1_124.jpg,fore,Unspecified,0.0,0,3165,936,3281,1036,116,100
12707,levle0_337.jpg,fore,Unspecified,0.0,0,2263,2336,2371,2497,108,161
12708,levle1_497.jpg,fore,Unspecified,0.0,0,1850,1853,1988,2029,138,176
12709,levle1_497.jpg,fore,Unspecified,0.0,0,754,2083,869,2206,115,123
12710,levle1_497.jpg,fore,Unspecified,0.0,0,884,2137,1014,2305,130,168
12711,levle1_497.jpg,fore,Unspecified,0.0,0,800,2474,953,2665,153,191
12712,levle1_497.jpg,fore,Unspecified,0.0,0,869,2964,999,3087,130,123
12713,levle1_497.jpg,fore,Unspecified,0.0,0,1160,3140,1275,3271,115,131
12714,levle1_497.jpg,fore,Unspecified,0.0,0,1589,2359,1735,2573,146,214
12715,levle1_497.jpg,fore,Unspecified,0.0,0,1635,2037,1788,2213,153,176
12716,levle1_483.jpg,fore,,,0,823,2880,968,3018,145,138
12717,levle1_483.jpg,fore,,,0,1091,2811,1229,2918,138,107
12718,levle1_483.jpg,fore,,,0,1329,2949,1612,3171,283,222
12719,levle1_483.jpg,fore,,,0,1043,3194,1167,3291,124,97
12720,levle1_483.jpg,fore,,,0,1002,2888,1133,2967,131,79
12721,levle1_483.jpg,fore,,,0,1088,2988,1191,3088,103,100
12722,levle1_468.jpg,fore,Unspecified,0.0,0,585,1922,823,2037,238,115
12723,levle1_468.jpg,fore,Unspecified,0.0,0,493,2037,685,2198,192,161
12724,levle1_468.jpg,fore,Unspecified,0.0,0,432,2213,639,2274,207,61
12725,levle1_468.jpg,fore,Unspecified,0.0,0,624,2229,715,2359,91,130
12726,levle1_468.jpg,fore,Unspecified,0.0,0,692,2474,777,2665,85,191
12727,levle1_468.jpg,fore,Unspecified,0.0,0,784,2489,984,2704,200,215
12728,levle1_468.jpg,fore,Unspecified,0.0,0,961,2374,1091,2512,130,138
12729,levle1_468.jpg,fore,Unspecified,0.0,0,1083,2696,1214,2888,131,192
12730,levle1_468.jpg,fore,Unspecified,0.0,0,1237,2734,1382,2857,145,123
12731,levle1_468.jpg,fore,Unspecified,0.0,0,1765,3163,1911,3363,146,200
12732,levle0_109.jpg,fore,Unspecified,0.0,0,2041,2405,2225,2596,184,191
12733,levle1_454.jpg,fore,Unspecified,0.0,0,1758,1945,1988,2022,230,77
12734,levle1_454.jpg,fore,Unspecified,0.0,0,2486,2144,2570,2236,84,92
12735,levle1_454.jpg,fore,Unspecified,0.0,0,2509,2535,2647,2665,138,130
12736,levle1_454.jpg,fore,Unspecified,0.0,0,2440,2389,2593,2520,153,131
12737,levle1_454.jpg,fore,Unspecified,0.0,0,2746,2520,2892,2635,146,115
12738,levle1_454.jpg,fore,Unspecified,0.0,0,2562,1776,2754,1999,192,223
12739,levle0_121.jpg,fore,Unspecified,0.0,0,424,1163,516,1317,92,154
12740,levle0_121.jpg,fore,Unspecified,0.0,0,424,2527,601,2635,177,108
12741,levle0_121.jpg,fore,Unspecified,0.0,0,800,2389,945,2527,145,138
12742,levle0_121.jpg,fore,Unspecified,0.0,0,1689,3071,1827,3248,138,177
12743,levle0_121.jpg,fore,Unspecified,0.0,0,1535,849,1666,1002,131,153
12744,levle1_332.jpg,fore,Unspecified,0.0,0,2034,1332,2156,1524,122,192
12745,levle1_332.jpg,fore,Unspecified,0.0,0,815,2366,915,2497,100,131
12746,levle1_332.jpg,fore,Unspecified,0.0,0,700,2343,777,2497,77,154
12747,levle1_332.jpg,fore,Unspecified,0.0,0,401,2642,524,2773,123,131
12748,levle1_332.jpg,fore,Unspecified,0.0,0,1122,2903,1244,3056,122,153
12749,levle1_332.jpg,fore,Unspecified,0.0,0,1382,3194,1558,3355,176,161
12750,levle1_332.jpg,fore,Unspecified,0.0,0,1244,3133,1336,3286,92,153
12751,levle3_73.jpg,fore,,,0,1023,249,1085,314,62,65
12752,levle3_73.jpg,fore,,,0,864,190,913,242,49,52
12753,levle3_73.jpg,fore,,,0,792,164,861,226,69,62
12754,levle3_73.jpg,fore,,,0,831,129,857,168,26,39
12755,levle3_73.jpg,fore,,,0,874,132,942,197,68,65
12756,levle3_73.jpg,fore,,,0,864,350,893,369,29,19
12757,levle3_73.jpg,fore,,,0,750,278,805,320,55,42
12758,levle3_73.jpg,fore,,,0,695,428,744,476,49,48
12759,levle3_73.jpg,fore,,,0,718,480,766,528,48,48
12760,levle3_73.jpg,fore,,,0,679,502,724,554,45,52
12761,levle3_73.jpg,fore,,,0,766,483,831,525,65,42
12762,levle3_73.jpg,fore,,,0,747,525,802,564,55,39
12763,levle3_73.jpg,fore,,,0,815,545,848,616,33,71
12764,levle3_73.jpg,fore,,,0,861,564,939,629,78,65
12765,levle3_73.jpg,fore,,,0,727,603,812,636,85,33
12766,levle3_73.jpg,fore,,,0,649,584,714,629,65,45
12767,levle3_73.jpg,fore,,,0,666,554,714,597,48,43
12768,levle3_73.jpg,fore,,,0,614,538,669,593,55,55
12769,levle3_73.jpg,fore,,,0,588,623,656,671,68,48
12770,levle3_73.jpg,fore,,,0,562,590,601,619,39,29
12771,levle3_73.jpg,fore,,,0,584,593,636,623,52,30
12772,levle3_73.jpg,fore,,,0,558,496,614,538,56,42
12773,levle3_73.jpg,fore,,,0,575,535,604,597,29,62
12774,levle3_73.jpg,fore,,,0,510,476,571,515,61,39
12775,levle3_73.jpg,fore,,,0,558,424,604,493,46,69
12776,levle3_73.jpg,fore,,,0,601,476,653,551,52,75
12777,levle3_73.jpg,fore,,,0,610,408,630,447,20,39
12778,levle3_73.jpg,fore,,,0,604,281,659,330,55,49
12779,levle3_73.jpg,fore,,,0,799,301,844,333,45,32
12780,levle3_73.jpg,fore,,,0,1566,428,1644,506,78,78
12781,levle3_73.jpg,fore,,,0,1618,486,1692,551,74,65
12782,levle3_73.jpg,fore,,,0,1715,684,1757,733,42,49
12783,levle3_73.jpg,fore,,,0,1582,723,1588,730,6,7
12784,levle3_73.jpg,fore,,,0,1510,649,1569,707,59,58
12785,levle3_73.jpg,fore,,,0,1514,772,1553,811,39,39
12786,levle3_73.jpg,fore,,,0,1468,723,1536,778,68,55
12787,levle3_73.jpg,fore,,,0,688,320,753,382,65,62
12788,levle3_73.jpg,fore,,,0,620,353,675,424,55,71
12789,levle3_73.jpg,fore,,,0,627,405,701,480,74,75
12790,levle3_73.jpg,fore,,,0,802,616,883,681,81,65
12791,levle3_73.jpg,fore,,,0,831,678,900,752,69,74
12792,levle3_73.jpg,fore,,,0,818,456,875,508,57,52
12793,levle3_73.jpg,fore,,,0,863,371,924,422,61,51
12794,levle3_73.jpg,fore,,,0,972,260,1023,319,51,59
12795,levle3_73.jpg,fore,,,0,700,382,757,422,57,40
12796,levle3_73.jpg,fore,,,0,506,565,558,620,52,55
12797,levle3_73.jpg,fore,,,0,1552,817,1606,871,54,54
12798,levle3_73.jpg,fore,,,0,375,677,435,728,60,51
12799,levle3_73.jpg,fore,,,0,541,622,583,683,42,61
12800,levle3_73.jpg,fore,,,0,672,622,741,676,69,54
12801,levle3_73.jpg,fore,,,0,764,693,831,774,67,81
12802,levle3_67.jpg,fore,,,0,332,600,349,621,17,21
12803,levle3_67.jpg,fore,,,0,102,384,134,424,32,40
12804,levle3_67.jpg,fore,,,0,216,571,254,611,38,40
12805,levle3_67.jpg,fore,,,0,352,585,387,621,35,36
12806,levle3_67.jpg,fore,,,0,268,503,310,543,42,40
12807,levle3_67.jpg,fore,,,0,289,572,335,617,46,45
12808,levle3_67.jpg,fore,,,0,234,477,264,505,30,28
12809,levle3_67.jpg,fore,,,0,245,458,281,485,36,27
12810,levle3_67.jpg,fore,,,0,289,407,324,444,35,37
12811,levle3_67.jpg,fore,,,0,219,422,242,458,23,36
12812,levle3_67.jpg,fore,,,0,150,427,179,456,29,29
12813,levle3_67.jpg,fore,,,0,163,410,200,445,37,35
12814,levle3_67.jpg,fore,,,0,150,470,186,496,36,26
12815,levle3_67.jpg,fore,,,0,150,500,190,526,40,26
12816,levle3_67.jpg,fore,,,0,95,485,124,522,29,37
12817,levle3_67.jpg,fore,,,0,108,540,142,578,34,38
12818,levle3_67.jpg,fore,,,0,167,551,206,594,39,43
12819,levle3_67.jpg,fore,,,0,148,380,185,409,37,29
12820,levle3_67.jpg,fore,,,0,171,337,214,363,43,26
12821,levle3_67.jpg,fore,,,0,170,308,197,343,27,35
12822,levle3_67.jpg,fore,,,0,125,349,173,393,48,44
12823,levle3_67.jpg,fore,,,0,124,326,154,346,30,20
12824,levle3_67.jpg,fore,,,0,87,357,116,383,29,26
12825,levle3_67.jpg,fore,,,0,131,265,180,300,49,35
12826,levle3_67.jpg,fore,,,0,125,240,153,266,28,26
12827,levle3_67.jpg,fore,,,0,188,211,206,240,18,29
12828,levle3_67.jpg,fore,,,0,219,194,258,227,39,33
12829,levle3_67.jpg,fore,,,0,231,289,278,334,47,45
12830,levle3_67.jpg,fore,,,0,295,254,330,283,35,29
12831,levle3_67.jpg,fore,,,0,249,225,287,253,38,28
12832,levle3_67.jpg,fore,,,0,185,256,234,285,49,29
12833,levle3_67.jpg,fore,,,0,238,369,281,409,43,40
12834,levle3_67.jpg,fore,,,0,108,207,148,233,40,26
12835,levle3_67.jpg,fore,,,0,150,168,174,190,24,22
12836,levle3_67.jpg,fore,,,0,179,153,214,194,35,41
12837,levle3_67.jpg,fore,,,0,300,326,336,361,36,35
12838,levle3_67.jpg,fore,,,0,214,507,254,546,40,39
12839,levle3_67.jpg,fore,,,0,315,522,349,559,34,37
12840,levle3_67.jpg,fore,,,0,372,623,405,648,33,25
12841,levle3_67.jpg,fore,,,0,267,585,292,607,25,22
12842,levle3_67.jpg,fore,,,0,111,447,131,472,20,25
12843,levle3_67.jpg,fore,,,0,122,425,145,449,23,24
12844,levle3_67.jpg,fore,,,0,67,340,88,366,21,26
12845,levle3_67.jpg,fore,,,0,84,320,113,340,29,20
12846,levle3_67.jpg,fore,,,0,84,401,112,434,28,33
12847,levle3_67.jpg,fore,,,0,276,475,314,500,38,25
12848,levle3_67.jpg,fore,,,0,209,383,243,419,34,36
12849,levle3_67.jpg,fore,,,0,210,358,239,384,29,26
12850,levle3_67.jpg,fore,,,0,229,336,257,364,28,28
12851,levle3_67.jpg,fore,,,0,252,267,284,298,32,31
12852,levle3_67.jpg,fore,,,0,279,285,301,314,22,29
12853,levle3_67.jpg,fore,,,0,387,583,419,610,32,27
12854,levle0_135.jpg,fore,Unspecified,0.0,0,1965,1700,2110,1868,145,168
12855,levle0_135.jpg,fore,Unspecified,0.0,0,2555,1853,2662,2006,107,153
12856,levle0_135.jpg,fore,Unspecified,0.0,0,2286,2305,2409,2412,123,107
12857,levle1_326.jpg,fore,Unspecified,0.0,0,1819,2052,1926,2206,107,154
12858,levle1_326.jpg,fore,Unspecified,0.0,0,1758,2274,1911,2451,153,177
12859,levle1_326.jpg,fore,Unspecified,0.0,0,2455,2014,2585,2129,130,115
12860,levle1_326.jpg,fore,Unspecified,0.0,0,1321,3156,1436,3332,115,176
12861,levle1_326.jpg,fore,Unspecified,0.0,0,1451,3263,1558,3409,107,146
12862,levle1_326.jpg,fore,Unspecified,0.0,0,1819,3217,1896,3340,77,123
12863,levle1_326.jpg,fore,Unspecified,0.0,0,1942,3225,2079,3347,137,122
12864,levle1_440.jpg,fore,Unspecified,0.0,0,2746,1853,2823,1976,77,123
12865,levle1_440.jpg,fore,Unspecified,0.0,0,2624,1669,2762,1830,138,161
12866,levle1_440.jpg,fore,Unspecified,0.0,0,2118,2129,2225,2259,107,130
12867,levle1_440.jpg,fore,Unspecified,0.0,0,2348,2206,2455,2336,107,130
12868,levle1_440.jpg,fore,Unspecified,0.0,0,2202,2558,2325,2665,123,107
12869,levle1_440.jpg,fore,Unspecified,0.0,0,1850,2750,1995,2895,145,145
12870,levle1_440.jpg,fore,Unspecified,0.0,0,2256,2673,2363,2796,107,123
12871,levle1_440.jpg,fore,Unspecified,0.0,0,2363,2773,2463,2857,100,84
12872,levle1_440.jpg,fore,Unspecified,0.0,0,2463,2581,2570,2696,107,115
12873,levle1_440.jpg,fore,Unspecified,0.0,0,2486,2696,2616,2780,130,84
12874,levle1_440.jpg,fore,Unspecified,0.0,0,2601,2474,2754,2604,153,130
12875,levle1_440.jpg,fore,Unspecified,0.0,0,2624,2359,2746,2481,122,122
12876,levle3_71.jpg,fore,,,0,412,42,440,69,28,27
12877,levle3_71.jpg,fore,,,0,299,79,320,104,21,25
12878,levle3_71.jpg,fore,,,0,298,105,319,125,21,20
12879,levle3_71.jpg,fore,,,0,302,159,331,183,29,24
12880,levle3_71.jpg,fore,,,0,329,153,350,175,21,22
12881,levle3_71.jpg,fore,,,0,356,142,387,158,31,16
12882,levle3_71.jpg,fore,,,0,268,132,287,159,19,27
12883,levle3_71.jpg,fore,,,0,249,194,273,202,24,8
12884,levle3_71.jpg,fore,,,0,267,215,297,234,30,19
12885,levle3_71.jpg,fore,,,0,273,232,297,248,24,16
12886,levle3_71.jpg,fore,,,0,284,243,304,264,20,21
12887,levle3_71.jpg,fore,,,0,271,246,287,263,16,17
12888,levle3_71.jpg,fore,,,0,326,257,342,270,16,13
12889,levle3_71.jpg,fore,,,0,341,259,362,283,21,24
12890,levle3_71.jpg,fore,,,0,335,278,351,293,16,15
12891,levle3_71.jpg,fore,,,0,338,295,363,310,25,15
12892,levle3_71.jpg,fore,,,0,303,276,320,297,17,21
12893,levle3_71.jpg,fore,,,0,279,289,302,314,23,25
12894,levle3_71.jpg,fore,,,0,388,303,410,327,22,24
12895,levle3_71.jpg,fore,,,0,449,290,473,307,24,17
12896,levle3_71.jpg,fore,,,0,409,242,441,260,32,18
12897,levle3_71.jpg,fore,,,0,247,57,265,75,18,18
12898,levle3_71.jpg,fore,,,0,217,42,238,64,21,22
12899,levle3_71.jpg,fore,,,0,189,64,207,80,18,16
12900,levle3_71.jpg,fore,,,0,206,80,224,100,18,20
12901,levle3_71.jpg,fore,,,0,183,90,209,123,26,33
12902,levle3_71.jpg,fore,,,0,126,72,146,93,20,21
12903,levle3_71.jpg,fore,,,0,151,66,174,91,23,25
12904,levle3_71.jpg,fore,,,0,150,37,184,63,34,26
12905,levle3_71.jpg,fore,,,0,102,21,129,46,27,25
12906,levle3_71.jpg,fore,,,0,80,6,108,27,28,21
12907,levle3_71.jpg,fore,,,0,251,29,275,52,24,23
12908,levle3_71.jpg,fore,,,0,358,79,384,103,26,24
12909,levle3_71.jpg,fore,,,0,332,110,363,133,31,23
12910,levle3_71.jpg,fore,,,0,333,141,337,146,4,5
12911,levle3_71.jpg,fore,,,0,359,165,381,185,22,20
12912,levle3_71.jpg,fore,,,0,362,196,385,222,23,26
12913,levle3_71.jpg,fore,,,0,381,244,403,267,22,23
12914,levle3_71.jpg,fore,,,0,312,233,329,259,17,26
12915,levle3_71.jpg,fore,,,0,273,174,311,212,38,38
12916,levle3_71.jpg,fore,,,0,256,263,271,286,15,23
12917,levle3_71.jpg,fore,,,0,192,237,213,261,21,24
12918,levle3_71.jpg,fore,,,0,183,148,198,174,15,26
12919,levle3_71.jpg,fore,,,0,227,104,246,120,19,16
12920,levle3_71.jpg,fore,,,0,23,51,63,89,40,38
12921,levle3_71.jpg,fore,,,0,162,4,192,35,30,31
12922,levle3_71.jpg,fore,,,0,225,0,255,28,30,28
12923,levle3_71.jpg,fore,,,0,259,0,305,29,46,29
12924,levle3_71.jpg,fore,,,0,340,15,364,37,24,22
12925,levle3_71.jpg,fore,,,0,340,203,361,224,21,21
12926,levle3_71.jpg,fore,,,0,361,291,382,317,21,26
12927,levle3_71.jpg,fore,,,0,333,43,361,67,28,24
12928,levle3_71.jpg,fore,,,0,391,277,416,302,25,25
12929,levle3_71.jpg,fore,,,0,116,95,136,115,20,20
12930,levle3_71.jpg,fore,,,0,159,104,183,137,24,33
12931,levle1_330.jpg,fore,Unspecified,0.0,0,1229,1363,1390,1547,161,184
12932,levle1_330.jpg,fore,Unspecified,0.0,0,1919,2635,2049,2780,130,145
12933,levle1_330.jpg,fore,Unspecified,0.0,0,2171,2619,2279,2765,108,146
12934,levle1_330.jpg,fore,Unspecified,0.0,0,2378,2642,2532,2750,154,108
12935,levle1_330.jpg,fore,Unspecified,0.0,0,2417,2481,2493,2642,76,161
12936,levle1_330.jpg,fore,Unspecified,0.0,0,2133,2811,2256,2926,123,115
12937,levle1_330.jpg,fore,Unspecified,0.0,0,2332,2903,2463,3056,131,153
12938,levle0_123.jpg,fore,Unspecified,0.0,0,2647,1248,2807,1386,160,138
12939,levle1_456.jpg,fore,Unspecified,0.0,0,1827,780,1949,895,122,115
12940,levle1_456.jpg,fore,Unspecified,0.0,0,2125,796,2317,926,192,130
12941,levle1_456.jpg,fore,Unspecified,0.0,0,2677,2022,2807,2229,130,207
12942,levle1_456.jpg,fore,Unspecified,0.0,0,1903,3056,2072,3255,169,199
12943,levle1_456.jpg,fore,Unspecified,0.0,0,1397,2964,1520,3094,123,130
12944,levle1_456.jpg,fore,Unspecified,0.0,0,1834,2926,2011,3079,177,153
12945,levle1_456.jpg,fore,Unspecified,0.0,0,2608,2428,2792,2642,184,214
12946,levle1_442.jpg,fore,Unspecified,0.0,0,501,1907,585,2022,84,115
12947,levle1_442.jpg,fore,Unspecified,0.0,0,547,2213,708,2359,161,146
12948,levle1_442.jpg,fore,Unspecified,0.0,0,555,2374,677,2504,122,130
12949,levle1_442.jpg,fore,Unspecified,0.0,0,202,2489,332,2596,130,107
12950,levle1_442.jpg,fore,Unspecified,0.0,0,225,2589,386,2734,161,145
12951,levle1_442.jpg,fore,Unspecified,0.0,0,715,2619,846,2711,131,92
12952,levle1_442.jpg,fore,Unspecified,0.0,0,991,2964,1099,3110,108,146
12953,levle1_442.jpg,fore,Unspecified,0.0,0,861,2750,984,2842,123,92
12954,levle1_442.jpg,fore,Unspecified,0.0,0,409,2842,601,3018,192,176
12955,levle1_442.jpg,fore,Unspecified,0.0,0,1214,3140,1329,3240,115,100
12956,levle1_324.jpg,fore,Unspecified,0.0,0,1880,1393,1995,1539,115,146
12957,levle1_324.jpg,fore,Unspecified,0.0,0,532,2428,677,2658,145,230
12958,levle1_324.jpg,fore,Unspecified,0.0,0,892,2382,968,2543,76,161
12959,levle1_324.jpg,fore,Unspecified,0.0,0,1198,2489,1306,2635,108,146
12960,levle1_324.jpg,fore,Unspecified,0.0,0,1413,2382,1551,2520,138,138
12961,levle1_324.jpg,fore,Unspecified,0.0,0,1405,3171,1505,3309,100,138
12962,levle1_324.jpg,fore,Unspecified,0.0,0,1428,2543,1535,2665,107,122
12963,levle0_137.jpg,fore,Unspecified,0.0,0,2049,2336,2202,2504,153,168
12964,levle3_65.jpg,fore,,,0,277,125,289,139,12,14
12965,levle3_65.jpg,fore,,,0,152,42,178,74,26,32
12966,levle3_65.jpg,fore,,,0,195,107,211,129,16,22
12967,levle3_65.jpg,fore,,,0,15,109,43,138,28,29
12968,levle3_65.jpg,fore,,,0,12,141,31,172,19,31
12969,levle3_65.jpg,fore,,,0,125,46,146,71,21,25
12970,levle3_65.jpg,fore,,,0,89,20,110,42,21,22
12971,levle3_65.jpg,fore,,,0,125,125,148,153,23,28
12972,levle3_65.jpg,fore,,,0,144,11,169,27,25,16
12973,levle3_65.jpg,fore,,,0,87,0,103,12,16,12
12974,levle3_65.jpg,fore,,,0,49,32,71,53,22,21
12975,levle3_65.jpg,fore,,,0,100,54,127,79,27,25
12976,levle3_65.jpg,fore,,,0,14,40,40,62,26,22
12977,levle3_65.jpg,fore,,,0,2,7,37,33,35,26
12978,levle3_65.jpg,fore,,,0,23,78,48,107,25,29
12979,levle3_65.jpg,fore,,,0,5,89,22,112,17,23
12980,levle3_65.jpg,fore,,,0,37,104,57,131,20,27
12981,levle3_65.jpg,fore,,,0,56,92,79,125,23,33
12982,levle3_65.jpg,fore,,,0,80,96,104,124,24,28
12983,levle3_65.jpg,fore,,,0,130,108,144,122,14,14
12984,levle3_65.jpg,fore,,,0,64,131,85,147,21,16
12985,levle3_65.jpg,fore,,,0,28,198,52,224,24,26
12986,levle3_65.jpg,fore,,,0,25,163,47,190,22,27
12987,levle3_65.jpg,fore,,,0,58,163,89,187,31,24
12988,levle3_65.jpg,fore,,,0,93,177,119,208,26,31
12989,levle3_65.jpg,fore,,,0,68,207,83,225,15,18
12990,levle3_65.jpg,fore,,,0,80,220,101,242,21,22
12991,levle3_65.jpg,fore,,,0,98,210,126,233,28,23
12992,levle3_65.jpg,fore,,,0,117,226,138,253,21,27
12993,levle3_65.jpg,fore,,,0,125,199,156,223,31,24
12994,levle3_65.jpg,fore,,,0,141,226,159,248,18,22
12995,levle3_65.jpg,fore,,,0,191,268,215,292,24,24
12996,levle3_65.jpg,fore,,,0,218,250,240,277,22,27
12997,levle3_65.jpg,fore,,,0,237,273,252,286,15,13
12998,levle3_65.jpg,fore,,,0,237,288,255,303,18,15
12999,levle3_65.jpg,fore,,,0,218,284,240,304,22,20
13000,levle3_65.jpg,fore,,,0,217,95,230,122,13,27
13001,levle3_65.jpg,fore,,,0,181,85,202,107,21,22
13002,levle3_65.jpg,fore,,,0,153,144,172,162,19,18
13003,levle3_65.jpg,fore,,,0,135,254,156,284,21,30
13004,levle3_65.jpg,fore,,,0,174,33,203,59,29,26
13005,levle3_65.jpg,fore,,,0,144,70,161,89,17,19
13006,levle3_65.jpg,fore,,,0,181,107,195,122,14,15
13007,levle3_65.jpg,fore,,,0,57,15,76,31,19,16
13008,levle3_65.jpg,fore,,,0,68,2,85,15,17,13
13009,levle3_65.jpg,fore,,,0,1,37,11,55,10,18
13010,levle3_65.jpg,fore,,,0,228,83,247,99,19,16
13011,levle3_65.jpg,fore,,,0,286,98,301,112,15,14
13012,levle3_65.jpg,fore,,,0,161,238,177,253,16,15
13013,levle3_65.jpg,fore,,,0,181,175,198,196,17,21
13014,levle3_65.jpg,fore,,,0,157,183,181,196,24,13
13015,levle3_65.jpg,fore,,,0,168,164,183,181,15,17
13016,levle3_65.jpg,fore,,,0,1,137,8,153,7,16
13017,levle3_65.jpg,fore,,,0,130,8,143,22,13,14
13018,levle3_65.jpg,fore,,,0,149,109,165,126,16,17
13019,levle3_65.jpg,fore,,,0,159,98,175,112,16,14
13020,levle3_65.jpg,fore,,,0,136,99,152,110,16,11
13021,levle3_65.jpg,fore,,,0,67,235,78,245,11,10
13022,levle3_65.jpg,fore,,,0,64,225,79,238,15,13
13023,levle3_65.jpg,fore,,,0,8,183,21,198,13,15
13024,levle3_65.jpg,fore,,,0,179,214,203,232,24,18
13025,levle3_65.jpg,fore,,,0,63,153,79,168,16,15
13026,levle3_65.jpg,fore,,,0,261,271,277,284,16,13
13027,levle3_65.jpg,fore,,,0,94,122,113,137,19,15
13028,levle3_65.jpg,fore,,,0,93,145,113,167,20,22
13029,levle3_59.jpg,fore,,,0,43,278,86,321,43,43
13030,levle3_59.jpg,fore,,,0,78,248,131,278,53,30
13031,levle3_59.jpg,fore,,,0,119,246,165,274,46,28
13032,levle3_59.jpg,fore,,,0,82,301,141,355,59,54
13033,levle3_59.jpg,fore,,,0,52,357,94,396,42,39
13034,levle3_59.jpg,fore,,,0,88,364,116,392,28,28
13035,levle3_59.jpg,fore,,,0,52,477,121,532,69,55
13036,levle3_59.jpg,fore,,,0,62,418,110,475,48,57
13037,levle3_59.jpg,fore,,,0,112,467,153,502,41,35
13038,levle3_59.jpg,fore,,,0,106,567,110,571,4,4
13039,levle3_59.jpg,fore,,,0,123,542,159,599,36,57
13040,levle3_59.jpg,fore,,,0,143,337,194,380,51,43
13041,levle3_59.jpg,fore,,,0,175,274,244,337,69,63
13042,levle3_59.jpg,fore,,,0,196,325,242,394,46,69
13043,levle3_59.jpg,fore,,,0,169,414,236,451,67,37
13044,levle3_59.jpg,fore,,,0,228,447,287,496,59,49
13045,levle3_59.jpg,fore,,,0,224,502,257,548,33,46
13046,levle3_59.jpg,fore,,,0,269,518,311,554,42,36
13047,levle3_59.jpg,fore,,,0,228,561,293,642,65,81
13048,levle3_59.jpg,fore,,,0,307,577,346,626,39,49
13049,levle3_59.jpg,fore,,,0,389,508,458,554,69,46
13050,levle3_59.jpg,fore,,,0,348,552,395,601,47,49
13051,levle3_59.jpg,fore,,,0,407,447,448,481,41,34
13052,levle3_59.jpg,fore,,,0,415,406,468,451,53,45
13053,levle3_59.jpg,fore,,,0,468,437,502,481,34,44
13054,levle3_59.jpg,fore,,,0,419,355,474,424,55,69
13055,levle3_59.jpg,fore,,,0,385,317,437,374,52,57
13056,levle3_59.jpg,fore,,,0,324,514,364,567,40,53
13057,levle3_59.jpg,fore,,,0,295,453,330,494,35,41
13058,levle3_59.jpg,fore,,,0,311,445,360,477,49,32
13059,levle3_59.jpg,fore,,,0,370,412,387,429,17,17
13060,levle3_59.jpg,fore,,,0,332,355,344,368,12,13
13061,levle3_59.jpg,fore,,,0,263,305,326,370,63,65
13062,levle3_59.jpg,fore,,,0,125,87,179,132,54,45
13063,levle3_59.jpg,fore,,,0,27,2,84,65,57,63
13064,levle3_59.jpg,fore,,,0,72,108,119,158,47,50
13065,levle3_59.jpg,fore,,,0,204,122,257,173,53,51
13066,levle3_59.jpg,fore,,,0,236,136,287,185,51,49
13067,levle3_59.jpg,fore,,,0,285,211,348,260,63,49
13068,levle3_59.jpg,fore,,,0,338,217,385,272,47,55
13069,levle3_59.jpg,fore,,,0,104,162,194,227,90,65
13070,levle3_59.jpg,fore,,,0,161,532,193,573,32,41
13071,levle3_59.jpg,fore,,,0,25,135,70,176,45,41
13072,levle3_59.jpg,fore,,,0,1,80,38,111,37,31
13073,levle3_59.jpg,fore,,,0,55,541,97,576,42,35
13074,levle3_59.jpg,fore,,,0,14,505,64,558,50,53
13075,levle3_59.jpg,fore,,,0,144,642,176,679,32,37
13076,levle3_59.jpg,fore,,,0,133,384,182,423,49,39
13077,levle3_59.jpg,fore,,,0,306,368,341,408,35,40
13078,levle3_59.jpg,fore,,,0,206,222,250,265,44,43
13079,levle3_59.jpg,fore,,,0,314,638,342,668,28,30
13080,levle3_59.jpg,fore,,,0,184,692,224,735,40,43
13081,levle3_59.jpg,fore,,,0,184,656,241,682,57,26
13082,levle3_59.jpg,fore,,,0,266,678,306,712,40,34
13083,levle3_59.jpg,fore,,,0,263,431,297,469,34,38
13084,levle3_59.jpg,fore,,,0,131,498,166,525,35,27
13085,levle3_59.jpg,fore,,,0,247,360,302,403,55,43
13086,levle3_59.jpg,fore,,,0,168,151,220,201,52,50
13087,levle3_59.jpg,fore,,,0,1,445,37,493,36,48
13088,levle1_318.jpg,fore,Unspecified,0.0,0,1459,2412,1666,2543,207,131
13089,levle1_318.jpg,fore,Unspecified,0.0,0,1727,2956,1888,3156,161,200
13090,levle1_318.jpg,fore,Unspecified,0.0,0,2455,3002,2662,3186,207,184
13091,levle1_318.jpg,fore,Unspecified,0.0,0,2677,2842,2823,3010,146,168
13092,levle1_318.jpg,fore,Unspecified,0.0,0,2915,2297,3053,2443,138,146
13093,levle1_318.jpg,fore,Unspecified,0.0,0,1827,474,1972,612,145,138
13094,levle1_318.jpg,fore,Unspecified,0.0,0,2378,1769,2555,1922,177,153
13095,levle1_495.jpg,fore,Unspecified,0.0,0,325,1753,501,1914,176,161
13096,levle1_495.jpg,fore,Unspecified,0.0,0,685,2167,838,2305,153,138
13097,levle1_495.jpg,fore,Unspecified,0.0,0,601,2359,715,2481,114,122
13098,levle1_495.jpg,fore,Unspecified,0.0,0,853,2282,968,2435,115,153
13099,levle1_495.jpg,fore,Unspecified,0.0,0,815,2466,884,2527,69,61
13100,levle1_495.jpg,fore,Unspecified,0.0,0,846,2451,953,2558,107,107
13101,levle1_495.jpg,fore,Unspecified,0.0,0,976,2435,1114,2527,138,92
13102,levle1_495.jpg,fore,Unspecified,0.0,0,1076,2520,1191,2650,115,130
13103,levle1_481.jpg,fore,Unspecified,0.0,0,1283,2091,1436,2229,153,138
13104,levle1_481.jpg,fore,Unspecified,0.0,0,1060,2091,1244,2244,184,153
13105,levle1_481.jpg,fore,Unspecified,0.0,0,892,2474,1014,2558,122,84
13106,levle1_481.jpg,fore,Unspecified,0.0,0,624,2543,807,2642,183,99
13107,levle1_481.jpg,fore,Unspecified,0.0,0,715,2727,853,2842,138,115
13108,levle1_481.jpg,fore,Unspecified,0.0,0,440,2343,662,2520,222,177
13109,levle2_9.jpg,fore,Unspecified,0.0,0,166,141,190,157,24,16
13110,levle2_9.jpg,fore,Unspecified,0.0,0,152,148,179,170,27,22
13111,levle2_9.jpg,fore,Unspecified,0.0,0,155,112,182,138,27,26
13112,levle2_9.jpg,fore,Unspecified,0.0,0,124,95,151,120,27,25
13113,levle2_9.jpg,fore,Unspecified,0.0,0,103,106,127,132,24,26
13114,levle2_9.jpg,fore,Unspecified,0.0,0,80,82,120,109,40,27
13115,levle2_9.jpg,fore,Unspecified,0.0,0,97,172,117,185,20,13
13116,levle2_9.jpg,fore,Unspecified,0.0,0,121,196,143,212,22,16
13117,levle2_9.jpg,fore,Unspecified,0.0,0,87,205,122,227,35,22
13118,levle2_9.jpg,fore,Unspecified,0.0,0,120,233,145,252,25,19
13119,levle2_9.jpg,fore,Unspecified,0.0,0,106,243,136,267,30,24
13120,levle2_9.jpg,fore,Unspecified,0.0,0,109,299,138,312,29,13
13121,levle2_9.jpg,fore,Unspecified,0.0,0,75,313,104,334,29,21
13122,levle2_9.jpg,fore,Unspecified,0.0,0,105,336,127,355,22,19
13123,levle2_9.jpg,fore,Unspecified,0.0,0,116,355,146,386,30,31
13124,levle2_9.jpg,fore,Unspecified,0.0,0,146,329,165,351,19,22
13125,levle2_9.jpg,fore,Unspecified,0.0,0,155,356,176,382,21,26
13126,levle2_9.jpg,fore,Unspecified,0.0,0,199,305,224,328,25,23
13127,levle2_9.jpg,fore,Unspecified,0.0,0,211,334,242,358,31,24
13128,levle2_9.jpg,fore,Unspecified,0.0,0,291,264,319,284,28,20
13129,levle2_9.jpg,fore,Unspecified,0.0,0,321,275,345,308,24,33
13130,levle2_9.jpg,fore,Unspecified,0.0,0,244,176,278,203,34,27
13131,levle2_9.jpg,fore,Unspecified,0.0,0,241,205,276,242,35,37
13132,levle2_9.jpg,fore,Unspecified,0.0,0,274,216,302,237,28,21
13133,levle2_9.jpg,fore,Unspecified,0.0,0,266,239,297,268,31,29
13134,levle2_9.jpg,fore,Unspecified,0.0,0,251,246,267,267,16,21
13135,levle2_9.jpg,fore,Unspecified,0.0,0,210,239,230,256,20,17
13136,levle2_9.jpg,fore,Unspecified,0.0,0,198,250,219,277,21,27
13137,levle2_9.jpg,fore,Unspecified,0.0,0,248,275,271,292,23,17
13138,levle2_9.jpg,fore,Unspecified,0.0,0,241,288,266,311,25,23
13139,levle2_9.jpg,fore,Unspecified,0.0,0,58,250,86,267,28,17
13140,levle2_9.jpg,fore,Unspecified,0.0,0,93,263,118,283,25,20
13141,levle2_9.jpg,fore,Unspecified,0.0,0,54,275,78,299,24,24
13142,levle2_9.jpg,fore,Unspecified,0.0,0,59,207,83,226,24,19
13143,levle0_447.jpg,fore,Unspecified,0.0,0,1367,964,1489,1148,122,184
13144,levle0_447.jpg,fore,Unspecified,0.0,0,1612,1110,1788,1255,176,145
13145,levle0_447.jpg,fore,Unspecified,0.0,0,1589,2895,1742,3102,153,207
13146,levle0_447.jpg,fore,Unspecified,0.0,0,1765,2903,1926,3133,161,230
13147,levle0_321.jpg,fore,Unspecified,0.0,0,1122,2880,1260,3048,138,168
13148,levle0_321.jpg,fore,Unspecified,0.0,0,1995,1830,2148,2098,153,268
13149,levle1_132.jpg,fore,Unspecified,0.0,0,1237,619,1359,727,122,108
13150,levle1_132.jpg,fore,Unspecified,0.0,0,2524,2160,2662,2313,138,153
13151,levle1_132.jpg,fore,Unspecified,0.0,0,1229,2527,1352,2642,123,115
13152,levle1_132.jpg,fore,Unspecified,0.0,0,1819,2742,1934,2865,115,123
13153,levle1_132.jpg,fore,Unspecified,0.0,0,2156,2888,2325,3056,169,168
13154,levle1_132.jpg,fore,Unspecified,0.0,0,1834,3087,1926,3217,92,130
13155,levle1_132.jpg,fore,Unspecified,0.0,0,1972,2941,2133,3110,161,169
13156,levle1_132.jpg,fore,Unspecified,0.0,0,1528,3125,1658,3225,130,100
13157,levle0_335.jpg,fore,Unspecified,0.0,0,1995,2351,2164,2497,169,146
13158,levle1_126.jpg,fore,Unspecified,0.0,0,1145,2619,1214,2688,69,69
13159,levle1_126.jpg,fore,Unspecified,0.0,0,1260,2704,1298,2796,38,92
13160,levle1_126.jpg,fore,Unspecified,0.0,0,1183,2918,1313,3064,130,146
13161,levle1_126.jpg,fore,Unspecified,0.0,0,953,2972,1022,3064,69,92
13162,levle1_126.jpg,fore,Unspecified,0.0,0,915,3125,1022,3248,107,123
13163,levle1_126.jpg,fore,Unspecified,0.0,0,1145,2251,1260,2382,115,131
13164,levle1_126.jpg,fore,Unspecified,0.0,0,1505,2443,1604,2535,99,92
13165,levle1_640.jpg,fore,Unspecified,0.0,0,111,120,123,128,12,8
13166,levle1_640.jpg,fore,Unspecified,0.0,0,111,109,122,115,11,6
13167,levle1_640.jpg,fore,Unspecified,0.0,0,121,127,130,135,9,8
13168,levle1_640.jpg,fore,Unspecified,0.0,0,117,139,128,150,11,11
13169,levle1_640.jpg,fore,Unspecified,0.0,0,110,150,121,158,11,8
13170,levle1_640.jpg,fore,Unspecified,0.0,0,132,179,147,193,15,14
13171,levle1_640.jpg,fore,Unspecified,0.0,0,64,122,75,135,11,13
13172,levle0_453.jpg,fore,Unspecified,0.0,0,922,949,1068,1079,146,130
13173,levle0_453.jpg,fore,Unspecified,0.0,0,1635,1838,1750,1960,115,122
13174,levle0_20.jpg,fore,Unspecified,0.0,0,55,102,75,128,20,26
13175,levle0_20.jpg,fore,Unspecified,0.0,0,35,37,54,57,19,20
13176,levle0_20.jpg,fore,Unspecified,0.0,0,91,79,109,100,18,21
13177,levle0_309.jpg,fore,Unspecified,0.0,0,1934,1025,2064,1156,130,131
13178,levle0_34.jpg,fore,Unspecified,0.0,0,1911,2520,2049,2642,138,122
13179,levle0_34.jpg,fore,Unspecified,0.0,0,2524,1960,2639,2121,115,161
13180,levle0_484.jpg,fore,Unspecified,0.0,0,2217,2198,2340,2366,123,168
13181,levle0_484.jpg,fore,Unspecified,0.0,0,1781,3079,1942,3301,161,222
13182,levle0_255.jpg,fore,Unspecified,0.0,0,1237,1807,1397,1983,160,176
13183,levle0_255.jpg,fore,Unspecified,0.0,0,1620,2083,1727,2259,107,176
13184,levle2_185.jpg,fore,Unspecified,0.0,0,2401,1163,2516,1271,115,108
13185,levle2_185.jpg,fore,Unspecified,0.0,0,2263,895,2409,1041,146,146
13186,levle2_185.jpg,fore,Unspecified,0.0,0,2011,979,2125,1125,114,146
13187,levle2_185.jpg,fore,Unspecified,0.0,0,1888,819,2049,1018,161,199
13188,levle2_185.jpg,fore,Unspecified,0.0,0,1344,658,1474,826,130,168
13189,levle2_185.jpg,fore,Unspecified,0.0,0,1474,497,1635,665,161,168
13190,levle2_185.jpg,fore,Unspecified,0.0,0,2087,443,2256,589,169,146
13191,levle2_185.jpg,fore,Unspecified,0.0,0,1060,665,1183,796,123,131
13192,levle2_185.jpg,fore,Unspecified,0.0,0,1934,1677,2087,1830,153,153
13193,levle2_185.jpg,fore,Unspecified,0.0,0,2110,1416,2286,1562,176,146
13194,levle2_185.jpg,fore,Unspecified,0.0,0,2279,1730,2447,1861,168,131
13195,levle2_185.jpg,fore,Unspecified,0.0,0,2263,1822,2386,1945,123,123
13196,levle2_185.jpg,fore,Unspecified,0.0,0,2447,1707,2585,1861,138,154
13197,levle2_185.jpg,fore,Unspecified,0.0,0,2509,1508,2601,1592,92,84
13198,levle2_185.jpg,fore,Unspecified,0.0,0,2302,1960,2440,2083,138,123
13199,levle2_185.jpg,fore,Unspecified,0.0,0,2340,2213,2470,2351,130,138
13200,levle2_185.jpg,fore,Unspecified,0.0,0,2440,2083,2524,2190,84,107
13201,levle2_185.jpg,fore,Unspecified,0.0,0,2072,2236,2164,2336,92,100
13202,levle2_185.jpg,fore,Unspecified,0.0,0,2034,2091,2164,2167,130,76
13203,levle2_185.jpg,fore,Unspecified,0.0,0,1742,2704,1865,2834,123,130
13204,levle2_185.jpg,fore,Unspecified,0.0,0,1865,2803,1988,2964,123,161
13205,levle2_185.jpg,fore,Unspecified,0.0,0,1988,2757,2118,2911,130,154
13206,levle2_185.jpg,fore,Unspecified,0.0,0,2118,2734,2217,2895,99,161
13207,levle2_185.jpg,fore,Unspecified,0.0,0,2294,2773,2447,2918,153,145
13208,levle2_185.jpg,fore,Unspecified,0.0,0,1865,3018,1988,3117,123,99
13209,levle2_185.jpg,fore,Unspecified,0.0,0,1650,3079,1827,3232,177,153
13210,levle2_185.jpg,fore,Unspecified,0.0,0,1237,3048,1367,3225,130,177
13211,levle2_185.jpg,fore,Unspecified,0.0,0,1482,3148,1627,3271,145,123
13212,levle2_185.jpg,fore,Unspecified,0.0,0,1474,2903,1604,3025,130,122
13213,levle2_185.jpg,fore,Unspecified,0.0,0,1068,1194,1191,1332,123,138
13214,levle2_185.jpg,fore,Unspecified,0.0,0,1083,972,1260,1148,177,176
13215,levle2_185.jpg,fore,Unspecified,0.0,0,1827,2144,1980,2328,153,184
13216,levle2_19.jpg,fore,Unspecified,0.0,0,152,111,163,127,11,16
13217,levle2_19.jpg,fore,Unspecified,0.0,0,111,124,125,136,14,12
13218,levle2_19.jpg,fore,Unspecified,0.0,0,103,112,119,129,16,17
13219,levle2_19.jpg,fore,Unspecified,0.0,0,92,183,99,194,7,11
13220,levle2_19.jpg,fore,Unspecified,0.0,0,103,182,111,194,8,12
13221,levle2_19.jpg,fore,Unspecified,0.0,0,125,131,140,144,15,13
13222,levle2_19.jpg,fore,Unspecified,0.0,0,189,55,201,63,12,8
13223,levle2_19.jpg,fore,Unspecified,0.0,0,196,15,214,26,18,11
13224,levle2_19.jpg,fore,Unspecified,0.0,0,167,0,180,9,13,9
13225,levle2_19.jpg,fore,Unspecified,0.0,0,181,4,195,21,14,17
13226,levle2_19.jpg,fore,Unspecified,0.0,0,168,14,184,27,16,13
13227,levle2_19.jpg,fore,Unspecified,0.0,0,168,36,184,49,16,13
13228,levle2_19.jpg,fore,Unspecified,0.0,0,125,37,136,45,11,8
13229,levle2_19.jpg,fore,Unspecified,0.0,0,112,33,125,48,13,15
13230,levle2_19.jpg,fore,Unspecified,0.0,0,107,47,118,54,11,7
13231,levle2_19.jpg,fore,Unspecified,0.0,0,119,51,128,63,9,12
13232,levle2_19.jpg,fore,Unspecified,0.0,0,90,49,101,58,11,9
13233,levle2_19.jpg,fore,Unspecified,0.0,0,87,36,97,49,10,13
13234,levle2_19.jpg,fore,Unspecified,0.0,0,66,99,82,111,16,12
13235,levle2_19.jpg,fore,Unspecified,0.0,0,165,51,176,66,11,15
13236,levle2_19.jpg,fore,Unspecified,0.0,0,139,84,155,96,16,12
13237,levle2_19.jpg,fore,Unspecified,0.0,0,156,84,170,92,14,8
13238,levle2_19.jpg,fore,Unspecified,0.0,0,121,67,131,75,10,8
13239,levle2_19.jpg,fore,Unspecified,0.0,0,171,26,184,38,13,12
13240,levle2_19.jpg,fore,Unspecified,0.0,0,149,44,161,55,12,11
13241,levle2_19.jpg,fore,Unspecified,0.0,0,133,54,151,72,18,18
13242,levle2_19.jpg,fore,Unspecified,0.0,0,143,69,157,83,14,14
13243,levle2_19.jpg,fore,Unspecified,0.0,0,124,75,133,86,9,11
13244,levle2_19.jpg,fore,Unspecified,0.0,0,112,82,127,97,15,15
13245,levle2_19.jpg,fore,Unspecified,0.0,0,110,62,120,73,10,11
13246,levle2_19.jpg,fore,Unspecified,0.0,0,102,57,112,69,10,12
13247,levle2_19.jpg,fore,Unspecified,0.0,0,89,89,101,105,12,16
13248,levle2_19.jpg,fore,Unspecified,0.0,0,67,67,80,80,13,13
13249,levle2_19.jpg,fore,Unspecified,0.0,0,113,157,127,172,14,15
13250,levle2_19.jpg,fore,Unspecified,0.0,0,127,180,146,198,19,18
13251,levle0_241.jpg,fore,Unspecified,0.0,0,1329,711,1497,956,168,245
13252,levle0_241.jpg,fore,Unspecified,0.0,0,1160,2964,1321,3232,161,268
13253,levle0_527.jpg,fore,Unspecified,0.0,0,938,2274,1129,2405,191,131
13254,levle0_527.jpg,fore,Unspecified,0.0,0,1037,2512,1198,2719,161,207
13255,levle0_527.jpg,fore,Unspecified,0.0,0,1796,2972,1903,3125,107,153
13256,levle0_527.jpg,fore,Unspecified,0.0,0,1344,3041,1474,3194,130,153
13257,levle2_25.jpg,fore,Unspecified,0.0,0,157,112,178,136,21,24
13258,levle2_25.jpg,fore,Unspecified,0.0,0,34,117,79,156,45,39
13259,levle2_25.jpg,fore,Unspecified,0.0,0,103,17,157,69,54,52
13260,levle2_25.jpg,fore,Unspecified,0.0,0,171,12,211,47,40,35
13261,levle2_25.jpg,fore,Unspecified,0.0,0,97,210,131,240,34,30
13262,levle2_25.jpg,fore,Unspecified,0.0,0,187,229,226,261,39,32
13263,levle2_25.jpg,fore,Unspecified,0.0,0,315,218,343,256,28,38
13264,levle2_25.jpg,fore,Unspecified,0.0,0,336,265,371,301,35,36
13265,levle2_25.jpg,fore,Unspecified,0.0,0,302,286,338,322,36,36
13266,levle2_25.jpg,fore,Unspecified,0.0,0,323,321,348,357,25,36
13267,levle2_25.jpg,fore,Unspecified,0.0,0,203,353,230,370,27,17
13268,levle2_25.jpg,fore,Unspecified,0.0,0,227,331,251,357,24,26
13269,levle2_25.jpg,fore,Unspecified,0.0,0,244,286,266,309,22,23
13270,levle2_25.jpg,fore,Unspecified,0.0,0,263,342,287,370,24,28
13271,levle2_25.jpg,fore,Unspecified,0.0,0,230,386,248,414,18,28
13272,levle2_25.jpg,fore,Unspecified,0.0,0,236,413,266,446,30,33
13273,levle2_25.jpg,fore,Unspecified,0.0,0,272,413,294,435,22,22
13274,levle2_25.jpg,fore,Unspecified,0.0,0,299,426,324,454,25,28
13275,levle2_25.jpg,fore,Unspecified,0.0,0,320,370,336,397,16,27
13276,levle2_25.jpg,fore,Unspecified,0.0,0,316,127,348,164,32,37
13277,levle2_25.jpg,fore,Unspecified,0.0,0,185,173,219,202,34,29
13278,levle2_25.jpg,fore,Unspecified,0.0,0,151,174,179,214,28,40
13279,levle2_25.jpg,fore,Unspecified,0.0,0,250,196,288,222,38,26
13280,levle2_25.jpg,fore,Unspecified,0.0,0,248,230,300,270,52,40
13281,levle2_25.jpg,fore,Unspecified,0.0,0,234,245,254,273,20,28
13282,levle2_25.jpg,fore,Unspecified,0.0,0,203,276,223,296,20,20
13283,levle2_25.jpg,fore,Unspecified,0.0,0,48,329,72,354,24,25
13284,levle2_25.jpg,fore,Unspecified,0.0,0,147,373,198,407,51,34
13285,levle2_25.jpg,fore,Unspecified,0.0,0,270,311,300,335,30,24
13286,levle0_269.jpg,fore,Unspecified,0.0,0,562,2604,708,2757,146,153
13287,levle0_269.jpg,fore,Unspecified,0.0,0,853,2581,976,2719,123,138
13288,levle0_269.jpg,fore,Unspecified,0.0,0,945,2443,1091,2589,146,146
13289,levle2_31.jpg,fore,Unspecified,0.0,0,211,50,233,88,22,38
13290,levle2_31.jpg,fore,Unspecified,0.0,0,173,52,198,72,25,20
13291,levle2_31.jpg,fore,Unspecified,0.0,0,165,65,198,95,33,30
13292,levle2_31.jpg,fore,Unspecified,0.0,0,166,140,203,171,37,31
13293,levle2_31.jpg,fore,Unspecified,0.0,0,136,141,165,176,29,35
13294,levle2_31.jpg,fore,Unspecified,0.0,0,171,193,216,245,45,52
13295,levle2_31.jpg,fore,Unspecified,0.0,0,258,188,291,223,33,35
13296,levle2_31.jpg,fore,Unspecified,0.0,0,204,288,234,314,30,26
13297,levle2_31.jpg,fore,Unspecified,0.0,0,183,326,221,344,38,18
13298,levle2_31.jpg,fore,Unspecified,0.0,0,174,346,199,373,25,27
13299,levle2_31.jpg,fore,Unspecified,0.0,0,130,256,163,291,33,35
13300,levle2_31.jpg,fore,Unspecified,0.0,0,101,274,148,311,47,37
13301,levle2_31.jpg,fore,Unspecified,0.0,0,100,304,140,336,40,32
13302,levle2_31.jpg,fore,Unspecified,0.0,0,88,373,128,404,40,31
13303,levle2_31.jpg,fore,Unspecified,0.0,0,155,422,184,451,29,29
13304,levle2_31.jpg,fore,Unspecified,0.0,0,181,422,206,444,25,22
13305,levle2_31.jpg,fore,Unspecified,0.0,0,198,451,219,487,21,36
13306,levle2_31.jpg,fore,Unspecified,0.0,0,221,459,249,487,28,28
13307,levle2_31.jpg,fore,Unspecified,0.0,0,253,452,296,494,43,42
13308,levle2_31.jpg,fore,Unspecified,0.0,0,263,299,296,338,33,39
13309,levle2_31.jpg,fore,Unspecified,0.0,0,244,339,261,361,17,22
13310,levle2_31.jpg,fore,Unspecified,0.0,0,214,353,249,374,35,21
13311,levle2_31.jpg,fore,Unspecified,0.0,0,249,369,274,386,25,17
13312,levle2_31.jpg,fore,Unspecified,0.0,0,208,369,239,406,31,37
13313,levle2_31.jpg,fore,Unspecified,0.0,0,146,308,171,331,25,23
13314,levle2_31.jpg,fore,Unspecified,0.0,0,118,336,146,363,28,27
13315,levle2_31.jpg,fore,Unspecified,0.0,0,143,343,173,381,30,38
13316,levle2_31.jpg,fore,Unspecified,0.0,0,101,398,130,427,29,29
13317,levle2_31.jpg,fore,Unspecified,0.0,0,130,404,158,439,28,35
13318,levle0_296.jpg,fore,Unspecified,0.0,0,1183,650,1375,796,192,146
13319,levle0_296.jpg,fore,Unspecified,0.0,0,2225,1815,2394,1968,169,153
13320,levle2_146.jpg,fore,,,0,210,1516,309,1615,99,99
13321,levle2_146.jpg,fore,,,0,309,1493,447,1615,138,122
13322,levle2_146.jpg,fore,,,0,470,1730,639,1830,169,100
13323,levle2_146.jpg,fore,,,0,317,1960,424,2114,107,154
13324,levle2_146.jpg,fore,,,0,547,2098,677,2274,130,176
13325,levle2_146.jpg,fore,,,0,685,2045,784,2175,99,130
13326,levle2_146.jpg,fore,,,0,1007,1868,1137,1999,130,131
13327,levle2_146.jpg,fore,,,0,1030,2052,1191,2175,161,123
13328,levle2_146.jpg,fore,,,0,807,2221,899,2320,92,99
13329,levle2_146.jpg,fore,,,0,670,2259,838,2397,168,138
13330,levle2_146.jpg,fore,,,0,830,2313,930,2420,100,107
13331,levle2_146.jpg,fore,,,0,884,2382,1007,2497,123,115
13332,levle2_146.jpg,fore,,,0,984,2167,1137,2251,153,84
13333,levle2_146.jpg,fore,,,0,1290,2236,1428,2351,138,115
13334,levle2_146.jpg,fore,,,0,984,2550,1152,2742,168,192
13335,levle2_146.jpg,fore,,,0,1106,2305,1275,2412,169,107
13336,levle2_146.jpg,fore,,,0,562,1156,685,1294,123,138
13337,levle2_146.jpg,fore,,,0,692,1240,815,1363,123,123
13338,levle2_146.jpg,fore,,,0,823,926,961,1041,138,115
13339,levle2_146.jpg,fore,,,0,899,1041,1030,1186,131,145
13340,levle2_146.jpg,fore,,,0,884,2163,1002,2281,118,118
13341,levle0_282.jpg,fore,Unspecified,0.0,0,1306,2895,1543,3102,237,207
13342,levle2_152.jpg,fore,Unspecified,0.0,0,1574,1907,1681,2022,107,115
13343,levle2_152.jpg,fore,Unspecified,0.0,0,1750,2075,1873,2175,123,100
13344,levle2_152.jpg,fore,Unspecified,0.0,0,991,1930,1137,2045,146,115
13345,levle2_152.jpg,fore,Unspecified,0.0,0,853,1983,922,2075,69,92
13346,levle2_152.jpg,fore,Unspecified,0.0,0,938,2068,1030,2129,92,61
13347,levle2_152.jpg,fore,Unspecified,0.0,0,938,2160,1060,2305,122,145
13348,levle2_152.jpg,fore,Unspecified,0.0,0,1275,2029,1382,2137,107,108
13349,levle2_152.jpg,fore,Unspecified,0.0,0,1206,2098,1283,2190,77,92
13350,levle2_152.jpg,fore,Unspecified,0.0,0,1214,2229,1344,2359,130,130
13351,levle2_152.jpg,fore,Unspecified,0.0,0,1329,2474,1459,2612,130,138
13352,levle2_152.jpg,fore,Unspecified,0.0,0,1405,2389,1543,2489,138,100
13353,levle2_152.jpg,fore,Unspecified,0.0,0,1696,2374,1773,2428,77,54
13354,levle2_152.jpg,fore,Unspecified,0.0,0,1804,2374,1919,2466,115,92
13355,levle2_152.jpg,fore,Unspecified,0.0,0,1781,2198,1888,2305,107,107
13356,levle2_152.jpg,fore,Unspecified,0.0,0,1581,2497,1650,2612,69,115
13357,levle2_152.jpg,fore,Unspecified,0.0,0,1689,2458,1827,2558,138,100
13358,levle2_152.jpg,fore,Unspecified,0.0,0,1397,2581,1543,2688,146,107
13359,levle2_152.jpg,fore,Unspecified,0.0,0,1114,2642,1252,2734,138,92
13360,levle2_152.jpg,fore,Unspecified,0.0,0,1306,2773,1405,2934,99,161
13361,levle2_152.jpg,fore,Unspecified,0.0,0,1045,2949,1237,3025,192,76
13362,levle2_152.jpg,fore,Unspecified,0.0,0,1489,3018,1666,3140,177,122
13363,levle2_152.jpg,fore,Unspecified,0.0,0,1604,2290,1689,2382,85,92
13364,levle1_244.jpg,fore,Unspecified,0.0,0,1214,2236,1336,2343,122,107
13365,levle1_244.jpg,fore,Unspecified,0.0,0,1244,2336,1428,2512,184,176
13366,levle1_244.jpg,fore,Unspecified,0.0,0,1344,2121,1535,2282,191,161
13367,levle1_244.jpg,fore,Unspecified,0.0,0,1206,1991,1367,2121,161,130
13368,levle1_244.jpg,fore,Unspecified,0.0,0,1505,2412,1658,2581,153,169
13369,levle1_244.jpg,fore,Unspecified,0.0,0,1520,2688,1635,2842,115,154
13370,levle1_244.jpg,fore,Unspecified,0.0,0,1198,336,1397,466,199,130
13371,levle1_74.jpg,fore,Unspecified,0.0,0,2475,662,2650,862,175,200
13372,levle1_74.jpg,fore,Unspecified,0.0,0,2242,903,2459,1119,217,216
13373,levle1_74.jpg,fore,Unspecified,0.0,0,2035,895,2176,1086,141,191
13374,levle1_74.jpg,fore,Unspecified,0.0,0,2267,1161,2450,1360,183,199
13375,levle1_74.jpg,fore,Unspecified,0.0,0,2517,1061,2691,1244,174,183
13376,levle1_74.jpg,fore,Unspecified,0.0,0,2650,1244,2816,1418,166,174
13377,levle1_74.jpg,fore,Unspecified,0.0,0,2849,1551,3049,1743,200,192
13378,levle1_74.jpg,fore,Unspecified,0.0,0,2982,803,3148,1036,166,233
13379,levle1_74.jpg,fore,Unspecified,0.0,0,3522,779,3680,978,158,199
13380,levle1_74.jpg,fore,Unspecified,0.0,0,2982,1984,3165,2191,183,207
13381,levle1_74.jpg,fore,Unspecified,0.0,0,2849,2216,3065,2432,216,216
13382,levle1_74.jpg,fore,Unspecified,0.0,0,2916,2432,3148,2707,232,275
13383,levle1_522.jpg,fore,Unspecified,0.0,0,1007,2259,1122,2374,115,115
13384,levle1_522.jpg,fore,Unspecified,0.0,0,1030,2512,1122,2704,92,192
13385,levle1_522.jpg,fore,Unspecified,0.0,0,1191,2520,1298,2673,107,153
13386,levle1_522.jpg,fore,Unspecified,0.0,0,2309,1240,2409,1432,100,192
13387,levle1_522.jpg,fore,Unspecified,0.0,0,2079,3209,2210,3324,131,115
13388,levle1_522.jpg,fore,Unspecified,0.0,0,1336,2573,1497,2727,161,154
13389,levle1_60.jpg,fore,Unspecified,0.0,0,141,221,172,253,31,32
13390,levle1_60.jpg,fore,Unspecified,0.0,0,156,395,202,433,46,38
13391,levle1_60.jpg,fore,Unspecified,0.0,0,274,371,312,405,38,34
13392,levle1_60.jpg,fore,Unspecified,0.0,0,349,518,387,550,38,32
13393,levle1_60.jpg,fore,Unspecified,0.0,0,374,380,433,446,59,66
13394,levle1_60.jpg,fore,Unspecified,0.0,0,520,407,590,452,70,45
13395,levle1_60.jpg,fore,Unspecified,0.0,0,559,467,603,511,44,44
13396,levle1_60.jpg,fore,Unspecified,0.0,0,476,649,533,692,57,43
13397,levle1_60.jpg,fore,Unspecified,0.0,0,578,704,637,764,59,60
13398,levle1_60.jpg,fore,Unspecified,0.0,0,538,758,591,798,53,40
13399,levle1_536.jpg,fore,Unspecified,0.0,0,2148,2642,2286,2819,138,177
13400,levle1_536.jpg,fore,Unspecified,0.0,0,2309,2811,2447,2949,138,138
13401,levle1_536.jpg,fore,Unspecified,0.0,0,2194,2979,2363,3186,169,207
13402,levle1_536.jpg,fore,Unspecified,0.0,0,2003,2956,2079,3087,76,131
13403,levle1_536.jpg,fore,Unspecified,0.0,0,2455,2903,2593,3071,138,168
13404,levle1_536.jpg,fore,Unspecified,0.0,0,2700,2711,2807,2826,107,115
13405,levle1_536.jpg,fore,Unspecified,0.0,0,2677,2543,2784,2711,107,168
13406,levle1_250.jpg,fore,Unspecified,0.0,0,578,2037,738,2160,160,123
13407,levle1_250.jpg,fore,Unspecified,0.0,0,447,2144,601,2274,154,130
13408,levle1_250.jpg,fore,Unspecified,0.0,0,1076,2512,1183,2619,107,107
13409,levle1_250.jpg,fore,Unspecified,0.0,0,899,2711,999,2842,100,131
13410,levle1_250.jpg,fore,Unspecified,0.0,0,999,3087,1068,3186,69,99
13411,levle1_250.jpg,fore,Unspecified,0.0,0,1129,3133,1252,3317,123,184
13412,levle1_250.jpg,fore,Unspecified,0.0,0,1290,3225,1359,3332,69,107
13413,levle1_278.jpg,fore,Unspecified,0.0,0,1382,880,1466,1018,84,138
13414,levle1_278.jpg,fore,Unspecified,0.0,0,1060,2190,1191,2366,131,176
13415,levle1_278.jpg,fore,Unspecified,0.0,0,1068,2796,1145,2979,77,183
13416,levle1_278.jpg,fore,Unspecified,0.0,0,1436,2428,1505,2566,69,138
13417,levle1_48.jpg,fore,Unspecified,0.0,0,1850,428,1965,520,115,92
13418,levle1_48.jpg,fore,Unspecified,0.0,0,2011,420,2102,589,91,169
13419,levle1_48.jpg,fore,Unspecified,0.0,0,2141,374,2271,489,130,115
13420,levle1_48.jpg,fore,Unspecified,0.0,0,2187,489,2332,604,145,115
13421,levle1_48.jpg,fore,Unspecified,0.0,0,1221,2359,1382,2497,161,138
13422,levle1_48.jpg,fore,Unspecified,0.0,0,991,2160,1152,2351,161,191
13423,levle1_48.jpg,fore,Unspecified,0.0,0,792,1976,976,2068,184,92
13424,levle1_48.jpg,fore,Unspecified,0.0,0,769,2106,938,2259,169,153
13425,levle1_48.jpg,fore,Unspecified,0.0,0,570,1960,746,2083,176,123
13426,levle1_48.jpg,fore,Unspecified,0.0,0,2003,2803,2179,3002,176,199
13427,levle1_287.jpg,fore,Unspecified,0.0,0,968,2251,1076,2389,108,138
13428,levle1_287.jpg,fore,Unspecified,0.0,0,1037,2029,1244,2160,207,131
13429,levle1_287.jpg,fore,Unspecified,0.0,0,1122,2144,1252,2267,130,123
13430,levle1_287.jpg,fore,Unspecified,0.0,0,1129,2259,1283,2451,154,192
13431,levle1_287.jpg,fore,Unspecified,0.0,0,1260,2727,1375,2872,115,145
13432,levle1_287.jpg,fore,Unspecified,0.0,0,1160,2826,1275,2926,115,100
13433,levle1_287.jpg,fore,Unspecified,0.0,0,1244,3025,1474,3171,230,146
13434,levle1_287.jpg,fore,Unspecified,0.0,0,647,1309,846,1539,199,230
13435,levle1_287.jpg,fore,Unspecified,0.0,0,884,2037,999,2244,115,207
13436,levle3_143.jpg,fore,,,0,857,694,916,752,59,58
13437,levle3_143.jpg,fore,,,0,695,252,757,324,62,72
13438,levle3_143.jpg,fore,,,0,896,736,978,837,82,101
13439,levle3_143.jpg,fore,,,0,822,765,883,814,61,49
13440,levle3_143.jpg,fore,,,0,870,834,965,895,95,61
13441,levle3_143.jpg,fore,,,0,896,925,952,1009,56,84
13442,levle3_143.jpg,fore,,,0,815,905,864,964,49,59
13443,levle3_143.jpg,fore,,,0,763,824,844,899,81,75
13444,levle3_143.jpg,fore,,,0,718,895,783,960,65,65
13445,levle3_143.jpg,fore,,,0,562,973,627,1029,65,56
13446,levle3_143.jpg,fore,,,0,633,895,705,960,72,65
13447,levle3_143.jpg,fore,,,0,679,931,744,990,65,59
13448,levle3_143.jpg,fore,,,0,760,970,848,1029,88,59
13449,levle3_143.jpg,fore,,,0,597,765,669,847,72,82
13450,levle3_143.jpg,fore,,,0,675,428,737,499,62,71
13451,levle3_143.jpg,fore,,,0,597,314,679,405,82,91
13452,levle3_143.jpg,fore,,,0,364,368,414,416,50,48
13453,levle3_143.jpg,fore,,,0,580,523,638,588,58,65
13454,levle3_143.jpg,fore,,,0,629,522,663,567,34,45
13455,levle3_143.jpg,fore,,,0,811,560,857,593,46,33
13456,levle3_143.jpg,fore,,,0,795,519,829,543,34,24
13457,levle3_143.jpg,fore,,,0,731,623,768,685,37,62
13458,levle3_143.jpg,fore,,,0,806,708,841,745,35,37
13459,levle3_143.jpg,fore,,,0,678,694,698,720,20,26
13460,levle3_143.jpg,fore,,,0,686,327,731,393,45,66
13461,levle3_143.jpg,fore,,,0,564,691,623,737,59,46
13462,levle3_143.jpg,fore,,,0,537,702,568,740,31,38
13463,levle3_143.jpg,fore,,,0,501,727,608,805,107,78
13464,levle3_143.jpg,fore,,,0,686,747,718,776,32,29
13465,levle3_143.jpg,fore,,,0,708,733,748,771,40,38
13466,levle3_143.jpg,fore,,,0,741,571,772,596,31,25
13467,levle3_143.jpg,fore,,,0,768,553,804,610,36,57
13468,levle3_143.jpg,fore,,,0,611,436,701,528,90,92
13469,levle3_143.jpg,fore,,,0,763,462,809,503,46,41
13470,levle3_143.jpg,fore,,,0,654,793,704,828,50,35
13471,levle3_143.jpg,fore,,,0,658,630,715,677,57,47
13472,levle3_143.jpg,fore,,,0,636,580,702,629,66,49
13473,levle3_143.jpg,fore,,,0,912,531,946,576,34,45
13474,levle3_143.jpg,fore,,,0,961,496,1001,533,40,37
13475,levle3_143.jpg,fore,,,0,911,654,944,702,33,48
13476,levle3_143.jpg,fore,,,0,719,204,755,244,36,40
13477,levle3_143.jpg,fore,,,0,791,376,843,414,52,38
13478,levle3_143.jpg,fore,,,0,776,419,821,455,45,36
13479,levle3_143.jpg,fore,,,0,734,373,780,428,46,55
13480,levle3_143.jpg,fore,,,0,726,497,755,535,29,38
13481,levle3_143.jpg,fore,,,0,753,506,788,547,35,41
13482,levle3_143.jpg,fore,,,0,549,297,580,324,31,27
13483,levle3_143.jpg,fore,,,0,655,404,713,444,58,40
13484,levle3_143.jpg,fore,,,0,714,1011,743,1039,29,28
13485,levle3_143.jpg,fore,,,0,742,1006,762,1039,20,33
13486,levle3_143.jpg,fore,,,0,849,910,891,961,42,51
13487,levle3_143.jpg,fore,,,0,782,755,821,803,39,48
13488,levle3_143.jpg,fore,,,0,520,661,568,696,48,35
13489,levle3_143.jpg,fore,,,0,643,686,677,732,34,46
13490,levle3_143.jpg,fore,,,0,337,247,367,277,30,30
13491,levle3_143.jpg,fore,,,0,345,337,388,374,43,37
13492,levle3_143.jpg,fore,,,0,339,372,367,412,28,40
13493,levle3_143.jpg,fore,,,0,317,361,343,386,26,25
13494,levle3_143.jpg,fore,,,0,302,321,336,359,34,38
13495,levle1_293.jpg,fore,Unspecified,0.0,0,1965,1654,2133,1815,168,161
13496,levle1_293.jpg,fore,Unspecified,0.0,0,1528,2857,1696,2979,168,122
13497,levle1_293.jpg,fore,Unspecified,0.0,0,1489,3002,1627,3087,138,85
13498,levle1_293.jpg,fore,Unspecified,0.0,0,1352,3064,1551,3248,199,184
13499,levle1_293.jpg,fore,Unspecified,0.0,0,1313,2773,1466,2888,153,115
13500,levle1_293.jpg,fore,Unspecified,0.0,0,1857,2926,2041,3064,184,138
13501,levle1_292.jpg,fore,Unspecified,0.0,0,1735,2144,1888,2320,153,176
13502,levle1_292.jpg,fore,Unspecified,0.0,0,1666,2359,1819,2504,153,145
13503,levle1_292.jpg,fore,Unspecified,0.0,0,1520,2359,1627,2489,107,130
13504,levle1_292.jpg,fore,Unspecified,0.0,0,1551,2121,1681,2251,130,130
13505,levle1_292.jpg,fore,Unspecified,0.0,0,1352,2336,1482,2489,130,153
13506,levle1_292.jpg,fore,Unspecified,0.0,0,1528,2803,1627,2949,99,146
13507,levle1_292.jpg,fore,Unspecified,0.0,0,2102,2259,2263,2412,161,153
13508,levle1_292.jpg,fore,Unspecified,0.0,0,1949,2819,2049,2979,100,160
13509,levle1_292.jpg,fore,Unspecified,0.0,0,1643,3133,1727,3271,84,138
13510,levle1_292.jpg,fore,Unspecified,0.0,0,1873,3163,2003,3263,130,100
13511,levle3_142.jpg,fore,,,0,887,512,945,571,58,59
13512,levle3_142.jpg,fore,,,0,682,379,750,424,68,45
13513,levle3_142.jpg,fore,,,0,835,278,893,353,58,75
13514,levle3_142.jpg,fore,,,0,721,327,818,408,97,81
13515,levle3_142.jpg,fore,,,0,812,441,890,535,78,94
13516,levle3_142.jpg,fore,,,0,701,450,750,489,49,39
13517,levle3_142.jpg,fore,,,0,705,541,770,632,65,91
13518,levle3_142.jpg,fore,,,0,1075,278,1146,343,71,65
13519,levle3_142.jpg,fore,,,0,1059,359,1117,428,58,69
13520,levle3_142.jpg,fore,,,0,711,655,750,723,39,68
13521,levle3_142.jpg,fore,,,0,760,713,805,788,45,75
13522,levle3_142.jpg,fore,,,0,812,746,870,817,58,71
13523,levle3_142.jpg,fore,,,0,874,730,945,824,71,94
13524,levle3_142.jpg,fore,,,0,815,827,880,970,65,143
13525,levle3_142.jpg,fore,,,0,662,808,727,847,65,39
13526,levle3_142.jpg,fore,,,0,662,736,714,804,52,68
13527,levle3_142.jpg,fore,,,0,734,879,792,928,58,49
13528,levle3_142.jpg,fore,,,0,656,869,750,951,94,82
13529,levle3_142.jpg,fore,,,0,620,873,682,938,62,65
13530,levle3_142.jpg,fore,,,0,562,837,636,912,74,75
13531,levle3_142.jpg,fore,,,0,666,954,757,1048,91,94
13532,levle3_142.jpg,fore,,,0,718,990,809,1055,91,65
13533,levle3_142.jpg,fore,,,0,878,388,935,447,57,59
13534,levle3_142.jpg,fore,,,0,798,580,869,660,71,80
13535,levle3_142.jpg,fore,,,0,859,680,898,729,39,49
13536,levle3_142.jpg,fore,,,0,806,693,861,740,55,47
13537,levle3_142.jpg,fore,,,0,744,803,801,842,57,39
13538,levle3_142.jpg,fore,,,0,620,736,660,779,40,43
13539,levle3_142.jpg,fore,,,0,932,954,978,996,46,42
13540,levle3_142.jpg,fore,,,0,951,751,997,796,46,45
13541,levle3_142.jpg,fore,,,0,920,694,980,736,60,42
13542,levle3_142.jpg,fore,,,0,715,731,764,793,49,62
13543,levle3_142.jpg,fore,,,0,1063,216,1101,265,38,49
13544,levle3_142.jpg,fore,,,0,608,682,658,730,50,48
13545,levle3_142.jpg,fore,,,0,543,750,615,834,72,84
13546,levle3_142.jpg,fore,,,0,760,256,803,307,43,51
13547,levle3_142.jpg,fore,,,0,786,110,854,167,68,57
13548,levle3_142.jpg,fore,,,0,934,280,978,319,44,39
13549,levle3_142.jpg,fore,,,0,752,688,791,725,39,37
13550,levle3_142.jpg,fore,,,0,640,1007,674,1048,34,41
13551,levle3_142.jpg,fore,,,0,652,1045,689,1080,37,35
13552,levle3_142.jpg,fore,,,0,568,682,612,725,44,43
13553,levle3_142.jpg,fore,,,0,872,187,909,227,37,40
13554,levle3_142.jpg,fore,,,0,851,234,901,276,50,42
13555,levle3_142.jpg,fore,,,0,818,822,875,862,57,40
13556,levle3_142.jpg,fore,,,0,671,497,729,545,58,48
13557,levle3_142.jpg,fore,,,0,717,510,768,559,51,49
13558,levle3_142.jpg,fore,,,0,775,427,812,468,37,41
13559,levle3_142.jpg,fore,,,0,949,137,989,176,40,39
13560,levle3_142.jpg,fore,,,0,975,171,1024,216,49,45
13561,levle3_142.jpg,fore,,,0,977,427,1014,463,37,36
13562,levle3_142.jpg,fore,,,0,977,305,1028,348,51,43
13563,levle3_142.jpg,fore,,,0,881,583,941,637,60,54
13564,levle3_142.jpg,fore,,,0,781,854,824,893,43,39
13565,levle3_142.jpg,fore,,,0,931,648,958,682,27,34
13566,levle3_142.jpg,fore,,,0,684,628,724,665,40,37
13567,levle3_142.jpg,fore,,,0,758,657,801,694,43,37
13568,levle3_142.jpg,fore,,,0,823,397,877,440,54,43
13569,levle3_142.jpg,fore,,,0,1020,173,1061,217,41,44
13570,levle3_142.jpg,fore,,,0,804,663,854,700,50,37
13571,levle3_142.jpg,fore,,,0,729,619,772,659,43,40
13572,levle1_286.jpg,fore,Unspecified,0.0,0,2539,2160,2700,2320,161,160
13573,levle1_286.jpg,fore,Unspecified,0.0,0,1735,2282,1911,2420,176,138
13574,levle1_286.jpg,fore,Unspecified,0.0,0,1597,2183,1727,2320,130,137
13575,levle1_286.jpg,fore,Unspecified,0.0,0,1474,2098,1566,2236,92,138
13576,levle1_286.jpg,fore,Unspecified,0.0,0,1160,2474,1283,2612,123,138
13577,levle1_286.jpg,fore,Unspecified,0.0,0,953,2297,1137,2405,184,108
13578,levle1_286.jpg,fore,Unspecified,0.0,0,1221,3064,1352,3209,131,145
13579,levle1_279.jpg,fore,Unspecified,0.0,0,2394,1761,2470,1907,76,146
13580,levle1_279.jpg,fore,Unspecified,0.0,0,2079,2144,2217,2282,138,138
13581,levle1_279.jpg,fore,Unspecified,0.0,0,2631,2091,2716,2244,85,153
13582,levle1_279.jpg,fore,Unspecified,0.0,0,2570,2481,2723,2627,153,146
13583,levle1_49.jpg,fore,Unspecified,0.0,0,1443,1317,1558,1462,115,145
13584,levle1_49.jpg,fore,Unspecified,0.0,0,1643,1217,1804,1324,161,107
13585,levle1_49.jpg,fore,Unspecified,0.0,0,1581,1455,1735,1631,154,176
13586,levle1_49.jpg,fore,Unspecified,0.0,0,1965,819,2095,987,130,168
13587,levle1_49.jpg,fore,Unspecified,0.0,0,1965,466,2110,650,145,184
13588,levle1_49.jpg,fore,Unspecified,0.0,0,2102,704,2210,849,108,145
13589,levle1_49.jpg,fore,Unspecified,0.0,0,1198,2183,1344,2336,146,153
13590,levle1_49.jpg,fore,Unspecified,0.0,0,1336,2328,1482,2474,146,146
13591,levle1_49.jpg,fore,Unspecified,0.0,0,1482,2060,1589,2336,107,276
13592,levle1_49.jpg,fore,Unspecified,0.0,0,1589,2290,1742,2397,153,107
13593,levle1_49.jpg,fore,Unspecified,0.0,0,1742,2397,1919,2550,177,153
13594,levle1_49.jpg,fore,Unspecified,0.0,0,1566,2474,1696,2635,130,161
13595,levle1_49.jpg,fore,Unspecified,0.0,0,1627,2635,1827,2773,200,138
13596,levle1_49.jpg,fore,Unspecified,0.0,0,1926,2336,2095,2489,169,153
13597,levle1_49.jpg,fore,Unspecified,0.0,0,2049,2206,2194,2382,145,176
13598,levle1_49.jpg,fore,Unspecified,0.0,0,1972,2497,2141,2665,169,168
13599,levle1_49.jpg,fore,Unspecified,0.0,0,1865,2658,2003,2796,138,138
13600,levle1_537.jpg,fore,Unspecified,0.0,0,1283,2535,1443,2658,160,123
13601,levle1_537.jpg,fore,Unspecified,0.0,0,1382,3010,1535,3179,153,169
13602,levle1_537.jpg,fore,Unspecified,0.0,0,1420,3202,1543,3324,123,122
13603,levle1_537.jpg,fore,Unspecified,0.0,0,1865,3240,1965,3340,100,100
13604,levle1_537.jpg,fore,Unspecified,0.0,0,1934,2773,2064,2926,130,153
13605,levle1_537.jpg,fore,Unspecified,0.0,0,2141,2466,2256,2627,115,161
13606,levle1_537.jpg,fore,Unspecified,0.0,0,2470,2259,2670,2435,200,176
13607,levle1_537.jpg,fore,Unspecified,0.0,0,2539,2091,2639,2206,100,115
13608,levle1_537.jpg,fore,Unspecified,0.0,0,2700,1700,2853,1861,153,161
13609,levle1_537.jpg,fore,Unspecified,0.0,0,1888,1048,2041,1225,153,177
13610,levle1_537.jpg,fore,Unspecified,0.0,0,1183,1110,1367,1294,184,184
13611,levle1_537.jpg,fore,Unspecified,0.0,0,1198,1386,1375,1615,177,229
13612,levle1_537.jpg,fore,Unspecified,0.0,0,1574,933,1681,1041,107,108
13613,levle1_537.jpg,fore,Unspecified,0.0,0,1267,750,1397,895,130,145
13614,levle1_537.jpg,fore,Unspecified,0.0,0,1168,612,1367,765,199,153
13615,levle1_537.jpg,fore,Unspecified,0.0,0,1497,458,1673,566,176,108
13616,levle1_537.jpg,fore,Unspecified,0.0,0,1367,420,1466,527,99,107
13617,levle1_537.jpg,fore,Unspecified,0.0,0,1520,619,1704,773,184,154
13618,levle1_537.jpg,fore,Unspecified,0.0,0,999,688,1152,803,153,115
13619,levle1_61.jpg,fore,Unspecified,0.0,0,238,208,264,237,26,29
13620,levle1_61.jpg,fore,Unspecified,0.0,0,305,216,329,243,24,27
13621,levle1_61.jpg,fore,Unspecified,0.0,0,318,113,342,139,24,26
13622,levle1_61.jpg,fore,Unspecified,0.0,0,316,151,338,178,22,27
13623,levle1_61.jpg,fore,Unspecified,0.0,0,222,255,241,271,19,16
13624,levle1_61.jpg,fore,Unspecified,0.0,0,167,272,203,289,36,17
13625,levle1_61.jpg,fore,Unspecified,0.0,0,273,250,292,277,19,27
13626,levle1_61.jpg,fore,Unspecified,0.0,0,204,155,222,174,18,19
13627,levle1_61.jpg,fore,Unspecified,0.0,0,115,95,133,118,18,23
13628,levle1_61.jpg,fore,Unspecified,0.0,0,220,48,255,78,35,30
13629,levle1_61.jpg,fore,Unspecified,0.0,0,152,64,183,91,31,27
13630,levle1_251.jpg,fore,Unspecified,0.0,0,2202,2543,2386,2696,184,153
13631,levle1_251.jpg,fore,Unspecified,0.0,0,2217,2750,2363,2880,146,130
13632,levle1_251.jpg,fore,Unspecified,0.0,0,2210,3010,2317,3163,107,153
13633,levle1_251.jpg,fore,Unspecified,0.0,0,746,673,907,842,161,169
13634,levle1_251.jpg,fore,Unspecified,0.0,0,961,1217,1099,1416,138,199
13635,levle1_251.jpg,fore,Unspecified,0.0,0,2026,2719,2102,2849,76,130
13636,levle1_245.jpg,fore,Unspecified,0.0,0,861,1531,999,1654,138,123
13637,levle1_245.jpg,fore,Unspecified,0.0,0,991,1937,1099,2075,108,138
13638,levle1_245.jpg,fore,Unspecified,0.0,0,800,1930,922,2106,122,176
13639,levle1_245.jpg,fore,Unspecified,0.0,0,1145,1960,1244,2098,99,138
13640,levle1_245.jpg,fore,Unspecified,0.0,0,1267,2029,1390,2160,123,131
13641,levle1_245.jpg,fore,Unspecified,0.0,0,1145,2198,1244,2274,99,76
13642,levle1_245.jpg,fore,Unspecified,0.0,0,1129,2305,1206,2405,77,100
13643,levle1_245.jpg,fore,Unspecified,0.0,0,1198,2374,1275,2520,77,146
13644,levle1_245.jpg,fore,Unspecified,0.0,0,1290,2267,1367,2405,77,138
13645,levle1_245.jpg,fore,Unspecified,0.0,0,1390,2688,1497,2803,107,115
13646,levle1_245.jpg,fore,Unspecified,0.0,0,1528,2972,1627,3102,99,130
13647,levle1_523.jpg,fore,Unspecified,0.0,0,1030,750,1198,933,168,183
13648,levle1_523.jpg,fore,Unspecified,0.0,0,1106,98,1237,228,131,130
13649,levle1_523.jpg,fore,Unspecified,0.0,0,2394,2091,2562,2267,168,176
13650,levle1_523.jpg,fore,Unspecified,0.0,0,2210,2382,2432,2489,222,107
13651,levle1_523.jpg,fore,Unspecified,0.0,0,2194,2497,2378,2642,184,145
13652,levle1_523.jpg,fore,Unspecified,0.0,0,2102,2757,2202,2857,100,100
13653,levle1_523.jpg,fore,Unspecified,0.0,0,2164,2857,2340,3010,176,153
13654,levle1_523.jpg,fore,Unspecified,0.0,0,1934,2987,2110,3110,176,123
13655,levle1_523.jpg,fore,Unspecified,0.0,0,1689,2972,1865,3133,176,161
13656,levle1_523.jpg,fore,Unspecified,0.0,0,1474,3133,1673,3286,199,153
13657,levle1_75.jpg,fore,Unspecified,0.0,0,2533,1202,2633,1377,100,175
13658,levle1_75.jpg,fore,Unspecified,0.0,0,2367,1236,2475,1344,108,108
13659,levle1_75.jpg,fore,Unspecified,0.0,0,2558,1377,2741,1502,183,125
13660,levle1_75.jpg,fore,Unspecified,0.0,0,2450,1551,2608,1668,158,117
13661,levle1_75.jpg,fore,Unspecified,0.0,0,2409,1643,2583,1801,174,158
13662,levle1_75.jpg,fore,Unspecified,0.0,0,2683,1701,2824,1826,141,125
13663,levle1_75.jpg,fore,Unspecified,0.0,0,3157,2083,3281,2200,124,117
13664,levle1_75.jpg,fore,Unspecified,0.0,0,3256,1967,3398,2133,142,166
13665,levle1_75.jpg,fore,Unspecified,0.0,0,3655,2740,3805,2906,150,166
13666,levle1_75.jpg,fore,Unspecified,0.0,0,3464,2981,3597,3114,133,133
13667,levle2_153.jpg,fore,Unspecified,0.0,0,1750,1845,1842,1999,92,154
13668,levle2_153.jpg,fore,Unspecified,0.0,0,1919,1983,1995,2091,76,108
13669,levle2_153.jpg,fore,Unspecified,0.0,0,1045,1907,1206,2060,161,153
13670,levle2_153.jpg,fore,Unspecified,0.0,0,861,1876,999,2006,138,130
13671,levle2_153.jpg,fore,Unspecified,0.0,0,1198,1914,1344,2022,146,108
13672,levle2_153.jpg,fore,Unspecified,0.0,0,1175,2091,1336,2206,161,115
13673,levle2_153.jpg,fore,Unspecified,0.0,0,1451,1968,1650,2098,199,130
13674,levle2_153.jpg,fore,Unspecified,0.0,0,1405,2075,1543,2167,138,92
13675,levle2_153.jpg,fore,Unspecified,0.0,0,1727,2014,1873,2114,146,100
13676,levle2_153.jpg,fore,Unspecified,0.0,0,1865,2282,1988,2389,123,107
13677,levle2_153.jpg,fore,Unspecified,0.0,0,1428,2206,1574,2328,146,122
13678,levle2_153.jpg,fore,Unspecified,0.0,0,1773,2198,1903,2282,130,84
13679,levle2_153.jpg,fore,Unspecified,0.0,0,1735,2451,1903,2550,168,99
13680,levle2_153.jpg,fore,Unspecified,0.0,0,1620,2313,1765,2435,145,122
13681,levle2_153.jpg,fore,Unspecified,0.0,0,1765,2297,1865,2405,100,108
13682,levle2_153.jpg,fore,Unspecified,0.0,0,1352,2374,1489,2497,137,123
13683,levle2_153.jpg,fore,Unspecified,0.0,0,1520,2443,1650,2566,130,123
13684,levle2_153.jpg,fore,Unspecified,0.0,0,1367,2466,1543,2604,176,138
13685,levle2_153.jpg,fore,Unspecified,0.0,0,1436,2573,1551,2704,115,131
13686,levle2_153.jpg,fore,Unspecified,0.0,0,1566,2535,1673,2665,107,130
13687,levle2_153.jpg,fore,Unspecified,0.0,0,1696,2650,1811,2780,115,130
13688,levle2_153.jpg,fore,Unspecified,0.0,0,1773,2550,1857,2635,84,85
13689,levle2_153.jpg,fore,Unspecified,0.0,0,1459,2742,1566,2834,107,92
13690,levle2_153.jpg,fore,Unspecified,0.0,0,1574,2788,1658,2880,84,92
13691,levle0_283.jpg,fore,Unspecified,0.0,0,1712,2780,1903,2934,191,154
13692,levle2_147.jpg,fore,Unspecified,0.0,0,1765,1041,1857,1156,92,115
13693,levle2_147.jpg,fore,Unspecified,0.0,0,1934,949,2079,1117,145,168
13694,levle2_147.jpg,fore,Unspecified,0.0,0,823,1041,1014,1156,191,115
13695,levle2_147.jpg,fore,Unspecified,0.0,0,876,1332,1007,1493,131,161
13696,levle2_147.jpg,fore,Unspecified,0.0,0,470,1608,593,1723,123,115
13697,levle2_147.jpg,fore,Unspecified,0.0,0,470,2029,608,2144,138,115
13698,levle2_147.jpg,fore,Unspecified,0.0,0,555,2206,670,2313,115,107
13699,levle2_147.jpg,fore,Unspecified,0.0,0,624,2144,746,2297,122,153
13700,levle2_147.jpg,fore,Unspecified,0.0,0,723,2114,823,2213,100,99
13701,levle2_147.jpg,fore,Unspecified,0.0,0,1152,1960,1244,2029,92,69
13702,levle2_147.jpg,fore,Unspecified,0.0,0,1183,2213,1275,2290,92,77
13703,levle2_147.jpg,fore,Unspecified,0.0,0,1114,2282,1206,2389,92,107
13704,levle2_147.jpg,fore,Unspecified,0.0,0,1206,2297,1298,2374,92,77
13705,levle2_147.jpg,fore,Unspecified,0.0,0,1145,2366,1237,2435,92,69
13706,levle2_147.jpg,fore,Unspecified,0.0,0,1129,2481,1252,2635,123,154
13707,levle2_147.jpg,fore,Unspecified,0.0,0,1420,2320,1528,2397,108,77
13708,levle2_147.jpg,fore,Unspecified,0.0,0,1413,2389,1505,2489,92,100
13709,levle2_147.jpg,fore,Unspecified,0.0,0,907,2397,991,2520,84,123
13710,levle2_147.jpg,fore,Unspecified,0.0,0,830,2206,907,2305,77,99
13711,levle2_147.jpg,fore,Unspecified,0.0,0,1014,2834,1122,2956,108,122
13712,levle2_147.jpg,fore,Unspecified,0.0,0,907,2911,1114,3041,207,130
13713,levle2_147.jpg,fore,Unspecified,0.0,0,1704,3125,1834,3255,130,130
13714,levle2_147.jpg,fore,Unspecified,0.0,0,1673,3018,1765,3133,92,115
13715,levle2_147.jpg,fore,Unspecified,0.0,0,1819,2972,1942,3087,123,115
13716,levle2_147.jpg,fore,Unspecified,0.0,0,1290,2566,1359,2650,69,84
13717,levle2_147.jpg,fore,Unspecified,0.0,0,1267,2382,1390,2428,123,46
13718,levle2_147.jpg,fore,Unspecified,0.0,0,1214,2443,1382,2566,168,123
13719,levle2_147.jpg,fore,Unspecified,0.0,0,922,2167,1076,2290,154,123
13720,levle2_147.jpg,fore,Unspecified,0.0,0,938,2022,1106,2160,168,138
13721,levle0_297.jpg,fore,Unspecified,0.0,0,1758,2504,1873,2780,115,276
13722,levle2_30.jpg,fore,Unspecified,0.0,0,256,316,276,345,20,29
13723,levle2_30.jpg,fore,Unspecified,0.0,0,210,320,229,339,19,19
13724,levle2_30.jpg,fore,Unspecified,0.0,0,229,324,247,338,18,14
13725,levle2_30.jpg,fore,Unspecified,0.0,0,231,338,253,355,22,17
13726,levle2_30.jpg,fore,Unspecified,0.0,0,224,350,242,366,18,16
13727,levle2_30.jpg,fore,Unspecified,0.0,0,216,337,232,355,16,18
13728,levle2_30.jpg,fore,Unspecified,0.0,0,193,337,208,361,15,24
13729,levle2_30.jpg,fore,Unspecified,0.0,0,198,317,209,338,11,21
13730,levle2_30.jpg,fore,Unspecified,0.0,0,169,309,185,326,16,17
13731,levle2_30.jpg,fore,Unspecified,0.0,0,167,341,180,364,13,23
13732,levle2_30.jpg,fore,Unspecified,0.0,0,188,376,206,398,18,22
13733,levle2_30.jpg,fore,Unspecified,0.0,0,197,397,218,416,21,19
13734,levle2_30.jpg,fore,Unspecified,0.0,0,215,375,231,392,16,17
13735,levle2_30.jpg,fore,Unspecified,0.0,0,233,363,253,383,20,20
13736,levle2_30.jpg,fore,Unspecified,0.0,0,237,380,257,395,20,15
13737,levle2_30.jpg,fore,Unspecified,0.0,0,243,392,259,411,16,19
13738,levle2_30.jpg,fore,Unspecified,0.0,0,279,371,292,388,13,17
13739,levle2_30.jpg,fore,Unspecified,0.0,0,296,357,315,379,19,22
13740,levle2_30.jpg,fore,Unspecified,0.0,0,268,411,284,431,16,20
13741,levle2_30.jpg,fore,Unspecified,0.0,0,235,426,251,451,16,25
13742,levle2_30.jpg,fore,Unspecified,0.0,0,205,416,215,430,10,14
13743,levle2_30.jpg,fore,Unspecified,0.0,0,257,441,271,455,14,14
13744,levle2_30.jpg,fore,Unspecified,0.0,0,280,448,294,467,14,19
13745,levle2_30.jpg,fore,Unspecified,0.0,0,301,419,320,439,19,20
13746,levle2_30.jpg,fore,Unspecified,0.0,0,302,443,320,463,18,20
13747,levle2_30.jpg,fore,Unspecified,0.0,0,179,322,198,351,19,29
13748,levle0_268.jpg,fore,Unspecified,0.0,0,478,1922,608,2098,130,176
13749,levle0_268.jpg,fore,Unspecified,0.0,0,746,2137,838,2244,92,107
13750,levle0_268.jpg,fore,Unspecified,0.0,0,2248,1056,2432,1225,184,169
13751,levle2_24.jpg,fore,Unspecified,0.0,0,560,77,613,112,53,35
13752,levle2_24.jpg,fore,Unspecified,0.0,0,586,108,631,157,45,49
13753,levle2_24.jpg,fore,Unspecified,0.0,0,515,112,552,149,37,37
13754,levle2_24.jpg,fore,Unspecified,0.0,0,517,79,562,110,45,31
13755,levle2_24.jpg,fore,Unspecified,0.0,0,503,161,525,189,22,28
13756,levle2_24.jpg,fore,Unspecified,0.0,0,531,187,562,230,31,43
13757,levle2_24.jpg,fore,Unspecified,0.0,0,411,297,440,332,29,35
13758,levle2_24.jpg,fore,Unspecified,0.0,0,425,315,464,340,39,25
13759,levle2_24.jpg,fore,Unspecified,0.0,0,415,332,452,372,37,40
13760,levle2_24.jpg,fore,Unspecified,0.0,0,474,338,531,389,57,51
13761,levle2_24.jpg,fore,Unspecified,0.0,0,629,550,670,596,41,46
13762,levle2_24.jpg,fore,Unspecified,0.0,0,676,529,680,543,4,14
13763,levle2_24.jpg,fore,Unspecified,0.0,0,643,493,678,535,35,42
13764,levle2_24.jpg,fore,Unspecified,0.0,0,379,381,415,419,36,38
13765,levle2_24.jpg,fore,Unspecified,0.0,0,383,411,417,452,34,41
13766,levle2_24.jpg,fore,Unspecified,0.0,0,556,564,590,594,34,30
13767,levle2_24.jpg,fore,Unspecified,0.0,0,548,607,592,659,44,52
13768,levle2_24.jpg,fore,Unspecified,0.0,0,460,680,495,733,35,53
13769,levle2_24.jpg,fore,Unspecified,0.0,0,497,678,535,721,38,43
13770,levle2_24.jpg,fore,Unspecified,0.0,0,537,686,572,733,35,47
13771,levle2_24.jpg,fore,Unspecified,0.0,0,529,776,566,816,37,40
13772,levle2_24.jpg,fore,Unspecified,0.0,0,488,765,521,816,33,51
13773,levle2_24.jpg,fore,Unspecified,0.0,0,537,810,564,841,27,31
13774,levle2_24.jpg,fore,Unspecified,0.0,0,562,843,586,869,24,26
13775,levle2_24.jpg,fore,Unspecified,0.0,0,576,863,607,896,31,33
13776,levle2_24.jpg,fore,Unspecified,0.0,0,600,824,635,871,35,47
13777,levle2_24.jpg,fore,Unspecified,0.0,0,427,462,468,511,41,49
13778,levle2_24.jpg,fore,Unspecified,0.0,0,431,564,470,617,39,53
13779,levle2_24.jpg,fore,Unspecified,0.0,0,458,611,509,672,51,61
13780,levle2_24.jpg,fore,Unspecified,0.0,0,482,574,521,609,39,35
13781,levle2_24.jpg,fore,Unspecified,0.0,0,580,698,617,733,37,35
13782,levle2_24.jpg,fore,Unspecified,0.0,0,570,261,598,293,28,32
13783,levle2_24.jpg,fore,Unspecified,0.0,0,627,197,655,232,28,35
13784,levle2_24.jpg,fore,Unspecified,0.0,0,666,210,684,252,18,42
13785,levle2_24.jpg,fore,Unspecified,0.0,0,662,142,672,183,10,41
13786,levle2_24.jpg,fore,Unspecified,0.0,0,572,484,623,531,51,47
13787,levle2_24.jpg,fore,Unspecified,0.0,0,655,686,684,725,29,39
13788,levle2_190.jpg,fore,Unspecified,0.0,0,2525,1086,2658,1219,133,133
13789,levle2_190.jpg,fore,Unspecified,0.0,0,2359,1593,2484,1734,125,141
13790,levle2_190.jpg,fore,Unspecified,0.0,0,2450,1859,2467,1876,17,17
13791,levle2_190.jpg,fore,Unspecified,0.0,0,2334,1709,2492,1859,158,150
13792,levle2_190.jpg,fore,Unspecified,0.0,0,2026,1934,2110,2050,84,116
13793,levle2_190.jpg,fore,Unspecified,0.0,0,3007,313,3190,488,183,175
13794,levle2_190.jpg,fore,Unspecified,0.0,0,2575,571,2700,762,125,191
13795,levle2_190.jpg,fore,Unspecified,0.0,0,2234,887,2400,1053,166,166
13796,levle2_190.jpg,fore,Unspecified,0.0,0,2442,828,2708,1078,266,250
13797,levle2_190.jpg,fore,Unspecified,0.0,0,2841,820,2924,945,83,125
13798,levle2_190.jpg,fore,Unspecified,0.0,0,2500,1427,2675,1560,175,133
13799,levle2_190.jpg,fore,Unspecified,0.0,0,2051,1510,2218,1684,167,174
13800,levle2_190.jpg,fore,Unspecified,0.0,0,2550,1684,2683,1826,133,142
13801,levle2_190.jpg,fore,Unspecified,0.0,0,2592,1967,2666,2034,74,67
13802,levle2_190.jpg,fore,Unspecified,0.0,0,2193,1925,2334,2083,141,158
13803,levle2_190.jpg,fore,Unspecified,0.0,0,2533,1826,2700,1984,167,158
13804,levle2_190.jpg,fore,Unspecified,0.0,0,2284,1967,2450,2108,166,141
13805,levle2_190.jpg,fore,Unspecified,0.0,0,2409,2067,2533,2183,124,116
13806,levle2_190.jpg,fore,Unspecified,0.0,0,2475,2191,2683,2324,208,133
13807,levle2_190.jpg,fore,Unspecified,0.0,0,2683,1959,2874,2142,191,183
13808,levle2_190.jpg,fore,Unspecified,0.0,0,2866,2133,3024,2308,158,175
13809,levle2_190.jpg,fore,Unspecified,0.0,0,2658,2216,2774,2416,116,200
13810,levle2_190.jpg,fore,Unspecified,0.0,0,3049,2058,3207,2258,158,200
13811,levle0_240.jpg,fore,Unspecified,0.0,0,1773,972,1896,1163,123,191
13812,levle0_240.jpg,fore,Unspecified,0.0,0,1804,673,1934,834,130,161
13813,levle0_240.jpg,fore,Unspecified,0.0,0,1390,2435,1566,2581,176,146
13814,levle0_240.jpg,fore,Unspecified,0.0,0,1781,2619,1980,2796,199,177
13815,levle0_526.jpg,fore,Unspecified,0.0,0,2225,2267,2432,2466,207,199
13816,levle0_526.jpg,fore,Unspecified,0.0,0,2003,2382,2210,2535,207,153
13817,levle0_532.jpg,fore,Unspecified,0.0,0,113,67,130,82,17,15
13818,levle0_532.jpg,fore,Unspecified,0.0,0,116,89,138,104,22,15
13819,levle0_532.jpg,fore,Unspecified,0.0,0,118,105,136,121,18,16
13820,levle0_532.jpg,fore,Unspecified,0.0,0,95,155,113,176,18,21
13821,levle2_18.jpg,fore,Unspecified,0.0,0,170,156,190,174,20,18
13822,levle2_18.jpg,fore,Unspecified,0.0,0,150,157,168,173,18,16
13823,levle2_18.jpg,fore,Unspecified,0.0,0,206,48,230,68,24,20
13824,levle2_18.jpg,fore,Unspecified,0.0,0,205,28,223,39,18,11
13825,levle2_18.jpg,fore,Unspecified,0.0,0,221,22,240,44,19,22
13826,levle2_18.jpg,fore,Unspecified,0.0,0,229,11,251,19,22,8
13827,levle2_18.jpg,fore,Unspecified,0.0,0,243,29,250,44,7,15
13828,levle2_18.jpg,fore,Unspecified,0.0,0,254,28,263,34,9,6
13829,levle2_18.jpg,fore,Unspecified,0.0,0,255,35,268,48,13,13
13830,levle2_18.jpg,fore,Unspecified,0.0,0,252,10,267,22,15,12
13831,levle2_18.jpg,fore,Unspecified,0.0,0,260,3,283,18,23,15
13832,levle2_18.jpg,fore,Unspecified,0.0,0,288,57,307,81,19,24
13833,levle2_18.jpg,fore,Unspecified,0.0,0,159,234,170,245,11,11
13834,levle2_18.jpg,fore,Unspecified,0.0,0,153,243,174,258,21,15
13835,levle2_18.jpg,fore,Unspecified,0.0,0,170,257,183,276,13,19
13836,levle2_18.jpg,fore,Unspecified,0.0,0,193,242,211,267,18,25
13837,levle2_18.jpg,fore,Unspecified,0.0,0,211,253,227,261,16,8
13838,levle2_18.jpg,fore,Unspecified,0.0,0,216,261,230,277,14,16
13839,levle2_18.jpg,fore,Unspecified,0.0,0,235,251,254,277,19,26
13840,levle2_18.jpg,fore,Unspecified,0.0,0,254,238,275,251,21,13
13841,levle2_18.jpg,fore,Unspecified,0.0,0,273,255,297,281,24,26
13842,levle2_18.jpg,fore,Unspecified,0.0,0,269,53,288,73,19,20
13843,levle2_18.jpg,fore,Unspecified,0.0,0,269,28,293,50,24,22
13844,levle2_184.jpg,fore,,,0,1060,696,1283,780,223,84
13845,levle2_184.jpg,fore,,,0,562,987,761,1133,199,146
13846,levle2_184.jpg,fore,,,0,302,1071,601,1255,299,184
13847,levle2_184.jpg,fore,,,0,516,1462,708,1592,192,130
13848,levle2_184.jpg,fore,,,0,233,1409,516,1592,283,183
13849,levle2_184.jpg,fore,,,0,501,1615,700,1784,199,169
13850,levle2_184.jpg,fore,,,0,784,1884,1099,2091,315,207
13851,levle2_184.jpg,fore,,,0,547,2006,792,2382,245,376
13852,levle2_184.jpg,fore,,,0,1168,2903,1451,3010,283,107
13853,levle2_184.jpg,fore,,,0,1459,2903,1558,3133,99,230
13854,levle2_184.jpg,fore,,,0,953,3064,1183,3255,230,191
13855,levle2_184.jpg,fore,,,0,1168,2956,1413,3194,245,238
13856,levle2_184.jpg,fore,,,0,1181,2753,1336,2836,155,83
13857,levle2_184.jpg,fore,,,0,536,2767,674,2846,138,79
13858,levle2_184.jpg,fore,,,0,1560,2601,1657,2684,97,83
13859,levle2_184.jpg,fore,,,0,712,2488,833,2577,121,89
13860,levle2_184.jpg,fore,,,0,602,1774,729,1877,127,103
13861,levle2_184.jpg,fore,,,0,1315,2422,1464,2525,149,103
13862,levle2_184.jpg,fore,,,0,1860,939,1953,1132,93,193
13863,levle2_184.jpg,fore,,,0,1171,2598,1291,2701,120,103
13864,levle2_184.jpg,fore,,,0,412,1553,533,1663,121,110
13865,levle0_491.jpg,fore,Unspecified,0.0,0,1574,2558,1758,2719,184,161
13866,levle0_491.jpg,fore,Unspecified,0.0,0,1689,3087,1880,3248,191,161
13867,levle0_485.jpg,fore,Unspecified,0.0,0,1114,2144,1260,2267,146,123
13868,levle0_485.jpg,fore,Unspecified,0.0,0,662,2229,815,2374,153,145
13869,levle0_485.jpg,fore,Unspecified,0.0,0,1459,2681,1612,2780,153,99
13870,levle0_308.jpg,fore,Unspecified,0.0,0,1489,3056,1566,3217,77,161
13871,levle0_35.jpg,fore,Unspecified,0.0,0,1260,1186,1367,1324,107,138
13872,levle0_35.jpg,fore,Unspecified,0.0,0,2340,681,2516,742,176,61
13873,levle0_35.jpg,fore,Unspecified,0.0,0,1229,780,1329,887,100,107
13874,levle0_35.jpg,fore,Unspecified,0.0,0,2670,1922,2754,2014,84,92
13875,levle0_21.jpg,fore,Unspecified,0.0,0,325,1064,509,1248,184,184
13876,levle0_21.jpg,fore,Unspecified,0.0,0,355,1845,524,2006,169,161
13877,levle1_127.jpg,fore,Unspecified,0.0,0,1413,2351,1597,2481,184,130
13878,levle1_127.jpg,fore,Unspecified,0.0,0,1696,2504,1819,2650,123,146
13879,levle1_127.jpg,fore,Unspecified,0.0,0,1796,2428,1942,2558,146,130
13880,levle1_127.jpg,fore,Unspecified,0.0,0,1290,2926,1436,3048,146,122
13881,levle1_127.jpg,fore,Unspecified,0.0,0,1635,2727,1742,2872,107,145
13882,levle1_127.jpg,fore,Unspecified,0.0,0,1727,3171,1827,3294,100,123
13883,levle1_127.jpg,fore,Unspecified,0.0,0,1965,2903,2141,3018,176,115
13884,levle1_127.jpg,fore,Unspecified,0.0,0,2057,3079,2171,3202,114,123
13885,levle0_334.jpg,fore,Unspecified,0.0,0,1574,3110,1704,3240,130,130
13886,levle0_334.jpg,fore,Unspecified,0.0,0,1903,2972,2079,3110,176,138
13887,levle0_452.jpg,fore,Unspecified,0.0,0,884,1179,1045,1347,161,168
13888,levle0_452.jpg,fore,Unspecified,0.0,0,555,757,708,910,153,153
13889,levle1_641.jpg,fore,Unspecified,0.0,0,88,191,98,198,10,7
13890,levle1_641.jpg,fore,Unspecified,0.0,0,83,200,96,210,13,10
13891,levle1_641.jpg,fore,Unspecified,0.0,0,110,179,121,192,11,13
13892,levle1_641.jpg,fore,Unspecified,0.0,0,131,187,147,197,16,10
13893,levle1_641.jpg,fore,Unspecified,0.0,0,148,9,163,26,15,17
13894,levle1_641.jpg,fore,Unspecified,0.0,0,165,17,177,26,12,9
13895,levle1_641.jpg,fore,Unspecified,0.0,0,190,62,206,76,16,14
13896,levle1_641.jpg,fore,Unspecified,0.0,0,187,96,205,111,18,15
13897,levle1_641.jpg,fore,Unspecified,0.0,0,132,149,146,156,14,7
13898,levle1_641.jpg,fore,Unspecified,0.0,0,139,160,153,170,14,10
13899,levle0_446.jpg,fore,Unspecified,0.0,0,631,2918,738,3048,107,130
13900,levle0_446.jpg,fore,Unspecified,0.0,0,1229,573,1397,773,168,200
13901,levle1_133.jpg,fore,Unspecified,0.0,0,1604,451,1758,627,154,176
13902,levle1_133.jpg,fore,Unspecified,0.0,0,2233,1255,2340,1393,107,138
13903,levle1_133.jpg,fore,Unspecified,0.0,0,2279,826,2340,964,61,138
13904,levle1_133.jpg,fore,Unspecified,0.0,0,1842,2673,1988,2819,146,146
13905,levle1_133.jpg,fore,Unspecified,0.0,0,1842,3056,1995,3225,153,169
13906,levle1_133.jpg,fore,Unspecified,0.0,0,2240,2428,2355,2535,115,107
13907,levle1_133.jpg,fore,Unspecified,0.0,0,2210,2527,2371,2688,161,161
13908,levle1_133.jpg,fore,Unspecified,0.0,0,1520,627,1635,734,115,107
13909,levle1_133.jpg,fore,Unspecified,0.0,0,1183,903,1290,1041,107,138
13910,levle0_320.jpg,fore,Unspecified,0.0,0,2141,2849,2332,2972,191,123
13911,levle0_320.jpg,fore,Unspecified,0.0,0,1482,3033,1635,3156,153,123
13912,levle0_320.jpg,fore,Unspecified,0.0,0,1689,3194,1873,3301,184,107
13913,levle0_320.jpg,fore,Unspecified,0.0,0,2309,1769,2478,1945,169,176
13914,levle2_8.jpg,fore,Unspecified,0.0,0,478,235,552,301,74,66
13915,levle2_8.jpg,fore,Unspecified,0.0,0,217,207,277,275,60,68
13916,levle2_8.jpg,fore,Unspecified,0.0,0,138,252,200,312,62,60
13917,levle2_8.jpg,fore,Unspecified,0.0,0,90,275,143,349,53,74
13918,levle2_8.jpg,fore,Unspecified,0.0,0,175,372,294,468,119,96
13919,levle2_8.jpg,fore,Unspecified,0.0,0,336,309,390,363,54,54
13920,levle2_8.jpg,fore,Unspecified,0.0,0,459,482,564,562,105,80
13921,levle2_8.jpg,fore,Unspecified,0.0,0,390,550,453,604,63,54
13922,levle2_8.jpg,fore,Unspecified,0.0,0,470,570,566,644,96,74
13923,levle2_8.jpg,fore,Unspecified,0.0,0,606,482,691,562,85,80
13924,levle2_8.jpg,fore,Unspecified,0.0,0,220,590,308,678,88,88
13925,levle2_8.jpg,fore,Unspecified,0.0,0,294,528,419,621,125,93
13926,levle2_8.jpg,fore,Unspecified,0.0,0,175,729,263,829,88,100
13927,levle2_8.jpg,fore,Unspecified,0.0,0,115,672,175,726,60,54
13928,levle2_8.jpg,fore,Unspecified,0.0,0,302,851,385,945,83,94
13929,levle2_8.jpg,fore,Unspecified,0.0,0,214,1073,288,1152,74,79
13930,levle2_8.jpg,fore,Unspecified,0.0,0,385,987,453,1050,68,63
13931,levle2_8.jpg,fore,Unspecified,0.0,0,566,800,640,874,74,74
13932,levle2_8.jpg,fore,Unspecified,0.0,0,490,860,515,897,25,37
13933,levle2_8.jpg,fore,Unspecified,0.0,0,703,786,745,857,42,71
13934,levle2_8.jpg,fore,Unspecified,0.0,0,737,687,827,743,90,56
13935,levle1_480.jpg,fore,Unspecified,0.0,0,2424,2351,2593,2481,169,130
13936,levle1_480.jpg,fore,Unspecified,0.0,0,2532,1861,2662,2006,130,145
13937,levle1_480.jpg,fore,Unspecified,0.0,0,2248,2888,2355,3033,107,145
13938,levle1_480.jpg,fore,Unspecified,0.0,0,1942,2918,2102,3048,160,130
13939,levle1_480.jpg,fore,Unspecified,0.0,0,2011,3079,2118,3232,107,153
13940,levle1_480.jpg,fore,Unspecified,0.0,0,1681,3064,1850,3240,169,176
13941,levle1_480.jpg,fore,Unspecified,0.0,0,1558,3064,1673,3163,115,99
13942,levle1_480.jpg,fore,Unspecified,0.0,0,1436,3094,1558,3209,122,115
13943,levle1_480.jpg,fore,Unspecified,0.0,0,1275,3041,1482,3148,207,107
13944,levle1_480.jpg,fore,Unspecified,0.0,0,1275,2903,1359,2987,84,84
13945,levle1_480.jpg,fore,Unspecified,0.0,0,1083,2979,1244,3094,161,115
13946,levle1_480.jpg,fore,Unspecified,0.0,0,1106,2857,1229,2934,123,77
13947,levle1_494.jpg,fore,Unspecified,0.0,0,1053,2466,1214,2650,161,184
13948,levle1_494.jpg,fore,Unspecified,0.0,0,930,2259,1045,2405,115,146
13949,levle1_494.jpg,fore,Unspecified,0.0,0,754,2091,984,2290,230,199
13950,levle1_494.jpg,fore,Unspecified,0.0,0,823,2343,922,2489,99,146
13951,levle1_494.jpg,fore,Unspecified,0.0,0,601,2313,700,2458,99,145
13952,levle1_494.jpg,fore,Unspecified,0.0,0,363,1677,547,1861,184,184
13953,levle1_319.jpg,fore,,,0,2708,2229,2876,2359,168,130
13954,levle1_319.jpg,fore,,,0,2593,2451,2792,2604,199,153
13955,levle1_319.jpg,fore,,,0,2915,2589,3037,2757,122,168
13956,levle1_319.jpg,fore,,,0,2700,2826,2823,2941,123,115
13957,levle1_319.jpg,fore,,,0,1857,420,1972,558,115,138
13958,levle1_319.jpg,fore,,,0,2964,2181,3084,2388,120,207
13959,levle3_58.jpg,fore,,,0,230,33,250,56,20,23
13960,levle3_58.jpg,fore,,,0,178,50,202,70,24,20
13961,levle3_58.jpg,fore,,,0,186,68,206,89,20,21
13962,levle3_58.jpg,fore,,,0,206,85,221,104,15,19
13963,levle3_58.jpg,fore,,,0,220,88,238,112,18,24
13964,levle3_58.jpg,fore,,,0,162,102,178,118,16,16
13965,levle3_58.jpg,fore,,,0,88,101,107,120,19,19
13966,levle3_58.jpg,fore,,,0,285,77,312,104,27,27
13967,levle3_58.jpg,fore,,,0,249,84,268,102,19,18
13968,levle3_58.jpg,fore,,,0,322,96,335,114,13,18
13969,levle3_58.jpg,fore,,,0,340,109,353,125,13,16
13970,levle3_58.jpg,fore,,,0,63,173,84,193,21,20
13971,levle3_58.jpg,fore,,,0,142,237,159,261,17,24
13972,levle3_58.jpg,fore,,,0,156,226,171,247,15,21
13973,levle3_58.jpg,fore,,,0,101,224,118,255,17,31
13974,levle3_58.jpg,fore,,,0,98,197,118,225,20,28
13975,levle3_58.jpg,fore,,,0,120,263,137,282,17,19
13976,levle3_58.jpg,fore,,,0,153,271,185,293,32,22
13977,levle3_58.jpg,fore,,,0,176,214,198,232,22,18
13978,levle3_58.jpg,fore,,,0,209,220,227,236,18,16
13979,levle3_58.jpg,fore,,,0,216,252,238,280,22,28
13980,levle3_58.jpg,fore,,,0,315,208,331,233,16,25
13981,levle3_58.jpg,fore,,,0,322,150,337,167,15,17
13982,levle3_58.jpg,fore,,,0,321,174,345,197,24,23
13983,levle3_58.jpg,fore,,,0,303,165,315,180,12,15
13984,levle3_58.jpg,fore,,,0,304,183,324,207,20,24
13985,levle3_58.jpg,fore,,,0,281,194,295,214,14,20
13986,levle3_58.jpg,fore,,,0,293,49,323,79,30,30
13987,levle3_58.jpg,fore,,,0,254,46,278,66,24,20
13988,levle3_58.jpg,fore,,,0,211,64,232,84,21,20
13989,levle3_58.jpg,fore,,,0,215,113,239,134,24,21
13990,levle3_58.jpg,fore,,,0,285,107,306,126,21,19
13991,levle3_58.jpg,fore,,,0,291,137,318,156,27,19
13992,levle3_58.jpg,fore,,,0,220,147,244,167,24,20
13993,levle3_58.jpg,fore,,,0,241,166,263,186,22,20
13994,levle3_58.jpg,fore,,,0,238,189,269,208,31,19
13995,levle3_58.jpg,fore,,,0,256,252,277,273,21,21
13996,levle3_58.jpg,fore,,,0,187,266,203,286,16,20
13997,levle3_58.jpg,fore,,,0,323,241,345,261,22,20
13998,levle3_58.jpg,fore,,,0,165,142,183,164,18,22
13999,levle3_58.jpg,fore,,,0,183,146,200,161,17,15
14000,levle3_58.jpg,fore,,,0,193,158,212,173,19,15
14001,levle3_58.jpg,fore,,,0,180,121,197,138,17,17
14002,levle3_58.jpg,fore,,,0,263,165,276,181,13,16
14003,levle3_58.jpg,fore,,,0,256,143,271,161,15,18
14004,levle3_58.jpg,fore,,,0,320,112,336,128,16,16
14005,levle3_58.jpg,fore,,,0,338,152,351,171,13,19
14006,levle3_58.jpg,fore,,,0,182,184,201,199,19,15
14007,levle3_58.jpg,fore,,,0,158,190,178,204,20,14
14008,levle3_58.jpg,fore,,,0,151,201,170,219,19,18
14009,levle3_58.jpg,fore,,,0,137,203,148,214,11,11
14010,levle3_58.jpg,fore,,,0,127,201,141,213,14,12
14011,levle3_58.jpg,fore,,,0,97,184,116,199,19,15
14012,levle3_58.jpg,fore,,,0,84,183,100,198,16,15
14013,levle3_58.jpg,fore,,,0,113,148,131,164,18,16
14014,levle3_58.jpg,fore,,,0,163,174,178,190,15,16
14015,levle3_58.jpg,fore,,,0,227,229,246,246,19,17
14016,levle3_58.jpg,fore,,,0,206,203,239,217,33,14
14017,levle3_58.jpg,fore,,,0,244,209,261,224,17,15
14018,levle3_58.jpg,fore,,,0,259,209,276,233,17,24
14019,levle3_58.jpg,fore,,,0,293,227,313,245,20,18
14020,levle3_58.jpg,fore,,,0,299,250,319,274,20,24
14021,levle1_443.jpg,fore,Unspecified,0.0,0,884,1278,1007,1416,123,138
14022,levle1_443.jpg,fore,Unspecified,0.0,0,486,1569,647,1669,161,100
14023,levle1_443.jpg,fore,Unspecified,0.0,0,631,1861,761,2006,130,145
14024,levle1_443.jpg,fore,Unspecified,0.0,0,516,2282,654,2435,138,153
14025,levle1_443.jpg,fore,Unspecified,0.0,0,524,2466,715,2596,191,130
14026,levle1_443.jpg,fore,Unspecified,0.0,0,424,2573,555,2673,131,100
14027,levle1_443.jpg,fore,Unspecified,0.0,0,685,2167,830,2328,145,161
14028,levle1_443.jpg,fore,Unspecified,0.0,0,692,2351,792,2420,100,69
14029,levle1_443.jpg,fore,Unspecified,0.0,0,830,2382,953,2520,123,138
14030,levle1_443.jpg,fore,Unspecified,0.0,0,876,2650,976,2734,100,84
14031,levle1_443.jpg,fore,Unspecified,0.0,0,1106,3056,1244,3171,138,115
14032,levle3_64.jpg,fore,Unspecified,0.0,0,71,246,94,264,23,18
14033,levle3_64.jpg,fore,Unspecified,0.0,0,33,127,44,144,11,17
14034,levle3_64.jpg,fore,Unspecified,0.0,0,52,145,64,162,12,17
14035,levle3_64.jpg,fore,Unspecified,0.0,0,70,121,88,137,18,16
14036,levle3_64.jpg,fore,Unspecified,0.0,0,71,136,86,156,15,20
14037,levle3_64.jpg,fore,Unspecified,0.0,0,76,156,87,173,11,17
14038,levle3_64.jpg,fore,Unspecified,0.0,0,86,135,107,155,21,20
14039,levle3_64.jpg,fore,Unspecified,0.0,0,94,156,105,172,11,16
14040,levle3_64.jpg,fore,Unspecified,0.0,0,106,158,124,181,18,23
14041,levle3_64.jpg,fore,Unspecified,0.0,0,66,178,89,196,23,18
14042,levle3_64.jpg,fore,Unspecified,0.0,0,98,192,117,208,19,16
14043,levle3_64.jpg,fore,Unspecified,0.0,0,135,183,160,202,25,19
14044,levle3_64.jpg,fore,Unspecified,0.0,0,125,94,147,110,22,16
14045,levle3_64.jpg,fore,Unspecified,0.0,0,173,67,199,82,26,15
14046,levle3_64.jpg,fore,Unspecified,0.0,0,213,95,230,114,17,19
14047,levle3_64.jpg,fore,Unspecified,0.0,0,146,135,167,150,21,15
14048,levle3_64.jpg,fore,Unspecified,0.0,0,176,135,192,148,16,13
14049,levle3_64.jpg,fore,Unspecified,0.0,0,115,135,128,150,13,15
14050,levle3_64.jpg,fore,Unspecified,0.0,0,130,157,141,169,11,12
14051,levle3_64.jpg,fore,Unspecified,0.0,0,36,199,54,218,18,19
14052,levle3_64.jpg,fore,Unspecified,0.0,0,40,219,54,238,14,19
14053,levle3_64.jpg,fore,Unspecified,0.0,0,45,237,63,255,18,18
14054,levle3_64.jpg,fore,Unspecified,0.0,0,17,257,37,280,20,23
14055,levle3_64.jpg,fore,Unspecified,0.0,0,42,287,64,309,22,22
14056,levle3_64.jpg,fore,Unspecified,0.0,0,64,265,78,285,14,20
14057,levle3_64.jpg,fore,Unspecified,0.0,0,138,53,148,70,10,17
14058,levle3_64.jpg,fore,Unspecified,0.0,0,124,55,138,73,14,18
14059,levle3_64.jpg,fore,Unspecified,0.0,0,97,72,122,100,25,28
14060,levle3_64.jpg,fore,Unspecified,0.0,0,149,52,164,78,15,26
14061,levle3_64.jpg,fore,Unspecified,0.0,0,160,49,186,67,26,18
14062,levle3_64.jpg,fore,Unspecified,0.0,0,230,43,250,67,20,24
14063,levle3_64.jpg,fore,Unspecified,0.0,0,186,84,220,109,34,25
14064,levle3_64.jpg,fore,Unspecified,0.0,0,143,84,167,103,24,19
14065,levle3_64.jpg,fore,Unspecified,0.0,0,109,109,127,123,18,14
14066,levle3_64.jpg,fore,Unspecified,0.0,0,88,104,108,119,20,15
14067,levle3_64.jpg,fore,Unspecified,0.0,0,97,117,117,133,20,16
14068,levle0_136.jpg,fore,Unspecified,0.0,0,1198,773,1329,918,131,145
14069,levle1_325.jpg,fore,Unspecified,0.0,0,447,2527,639,2727,192,200
14070,levle1_325.jpg,fore,Unspecified,0.0,0,1152,2535,1283,2696,131,161
14071,levle1_325.jpg,fore,Unspecified,0.0,0,1321,2842,1405,2979,84,137
14072,levle1_325.jpg,fore,Unspecified,0.0,0,1206,3125,1367,3263,161,138
14073,levle1_325.jpg,fore,Unspecified,0.0,0,1796,3240,1934,3347,138,107
14074,levle1_325.jpg,fore,Unspecified,0.0,0,838,2474,922,2612,84,138
14075,levle0_122.jpg,fore,Unspecified,0.0,0,731,2351,884,2512,153,161
14076,levle1_331.jpg,fore,Unspecified,0.0,0,2478,2619,2631,2750,153,131
14077,levle1_331.jpg,fore,Unspecified,0.0,0,2409,2773,2570,2911,161,138
14078,levle1_331.jpg,fore,Unspecified,0.0,0,2202,2972,2317,3064,115,92
14079,levle1_331.jpg,fore,Unspecified,0.0,0,2217,3125,2302,3217,85,92
14080,levle1_331.jpg,fore,Unspecified,0.0,0,2424,3079,2562,3263,138,184
14081,levle1_331.jpg,fore,Unspecified,0.0,0,1290,1531,1405,1707,115,176
14082,levle3_70.jpg,fore,,,0,472,303,501,323,29,20
14083,levle3_70.jpg,fore,,,0,484,274,506,303,22,29
14084,levle3_70.jpg,fore,,,0,516,284,542,314,26,30
14085,levle3_70.jpg,fore,,,0,554,261,569,288,15,27
14086,levle3_70.jpg,fore,,,0,516,229,535,246,19,17
14087,levle3_70.jpg,fore,,,0,548,233,563,257,15,24
14088,levle3_70.jpg,fore,,,0,569,223,605,236,36,13
14089,levle3_70.jpg,fore,,,0,588,208,618,231,30,23
14090,levle3_70.jpg,fore,,,0,453,344,491,369,38,25
14091,levle3_70.jpg,fore,,,0,489,339,512,359,23,20
14092,levle3_70.jpg,fore,,,0,391,382,414,412,23,30
14093,levle3_70.jpg,fore,,,0,376,376,408,397,32,21
14094,levle3_70.jpg,fore,,,0,370,393,393,427,23,34
14095,levle3_70.jpg,fore,,,0,374,426,406,448,32,22
14096,levle3_70.jpg,fore,,,0,370,456,397,488,27,32
14097,levle3_70.jpg,fore,,,0,412,439,446,463,34,24
14098,levle3_70.jpg,fore,,,0,399,452,417,477,18,25
14099,levle3_70.jpg,fore,,,0,427,471,455,496,28,25
14100,levle3_70.jpg,fore,,,0,389,473,419,499,30,26
14101,levle3_70.jpg,fore,,,0,414,494,429,513,15,19
14102,levle3_70.jpg,fore,,,0,431,497,457,522,26,25
14103,levle3_70.jpg,fore,,,0,400,528,434,571,34,43
14104,levle3_70.jpg,fore,,,0,457,511,478,549,21,38
14105,levle3_70.jpg,fore,,,0,476,514,489,533,13,19
14106,levle3_70.jpg,fore,,,0,486,537,525,567,39,30
14107,levle3_70.jpg,fore,,,0,474,556,518,596,44,40
14108,levle3_70.jpg,fore,,,0,531,573,565,605,34,32
14109,levle3_70.jpg,fore,,,0,550,511,569,539,19,28
14110,levle3_70.jpg,fore,,,0,563,494,578,526,15,32
14111,levle3_70.jpg,fore,,,0,493,494,516,520,23,26
14112,levle3_70.jpg,fore,,,0,518,482,540,514,22,32
14113,levle3_70.jpg,fore,,,0,548,458,559,488,11,30
14114,levle3_70.jpg,fore,,,0,576,467,590,492,14,25
14115,levle3_70.jpg,fore,,,0,559,437,588,484,29,47
14116,levle3_70.jpg,fore,,,0,521,450,546,479,25,29
14117,levle3_70.jpg,fore,,,0,478,454,512,488,34,34
14118,levle3_70.jpg,fore,,,0,450,462,482,496,32,34
14119,levle3_70.jpg,fore,,,0,457,435,480,456,23,21
14120,levle3_70.jpg,fore,,,0,486,418,516,458,30,40
14121,levle3_70.jpg,fore,,,0,478,401,497,426,19,25
14122,levle3_70.jpg,fore,,,0,457,390,478,410,21,20
14123,levle3_70.jpg,fore,,,0,493,373,518,403,25,30
14124,levle3_70.jpg,fore,,,0,520,361,544,399,24,38
14125,levle3_70.jpg,fore,,,0,550,371,571,399,21,28
14126,levle3_70.jpg,fore,,,0,510,405,527,424,17,19
14127,levle3_70.jpg,fore,,,0,531,424,544,443,13,19
14128,levle3_70.jpg,fore,,,0,537,396,555,413,18,17
14129,levle3_70.jpg,fore,,,0,373,489,393,512,20,23
14130,levle3_70.jpg,fore,,,0,457,419,471,432,14,13
14131,levle3_70.jpg,fore,,,0,524,336,541,353,17,17
14132,levle3_70.jpg,fore,,,0,550,360,563,376,13,16
14133,levle3_70.jpg,fore,,,0,413,361,427,374,14,13
14134,levle3_70.jpg,fore,,,0,415,376,436,393,21,17
14135,levle3_70.jpg,fore,,,0,549,293,566,306,17,13
14136,levle3_70.jpg,fore,,,0,519,525,538,537,19,12
14137,levle3_70.jpg,fore,,,0,570,594,587,610,17,16
14138,levle3_70.jpg,fore,,,0,405,510,426,529,21,19
14139,levle3_70.jpg,fore,,,0,557,400,575,417,18,17
14140,levle3_70.jpg,fore,,,0,564,424,581,439,17,15
14141,levle3_70.jpg,fore,,,0,532,540,548,553,16,13
14142,levle3_70.jpg,fore,,,0,430,422,451,437,21,15
14143,levle3_70.jpg,fore,,,0,447,375,464,393,17,18
14144,levle1_457.jpg,fore,Unspecified,0.0,0,1535,2987,1758,3156,223,169
14145,levle1_457.jpg,fore,Unspecified,0.0,0,1735,2443,1804,2535,69,92
14146,levle1_457.jpg,fore,Unspecified,0.0,0,2095,2719,2225,2780,130,61
14147,levle1_457.jpg,fore,Unspecified,0.0,0,953,1117,1137,1232,184,115
14148,levle0_179.jpg,fore,Unspecified,0.0,0,1267,665,1390,796,123,131
14149,levle0_179.jpg,fore,Unspecified,0.0,0,2340,1784,2440,1907,100,123
14150,levle1_418.jpg,fore,Unspecified,0.0,0,1466,3041,1673,3163,207,122
14151,levle1_418.jpg,fore,Unspecified,0.0,0,1083,3133,1244,3271,161,138
14152,levle1_418.jpg,fore,Unspecified,0.0,0,869,2956,968,3102,99,146
14153,levle1_418.jpg,fore,Unspecified,0.0,0,325,2535,539,2696,214,161
14154,levle1_418.jpg,fore,Unspecified,0.0,0,1183,918,1352,1079,169,161
14155,levle1_418.jpg,fore,Unspecified,0.0,0,1344,1079,1436,1171,92,92
14156,levle1_418.jpg,fore,Unspecified,0.0,0,1612,3217,1727,3332,115,115
14157,levle0_145.jpg,fore,Unspecified,0.0,0,2378,2083,2524,2236,146,153
14158,levle0_145.jpg,fore,Unspecified,0.0,0,2271,2474,2409,2619,138,145
14159,levle1_356.jpg,fore,Unspecified,0.0,0,2401,2435,2570,2604,169,169
14160,levle1_356.jpg,fore,Unspecified,0.0,0,2141,2780,2271,2934,130,154
14161,levle1_356.jpg,fore,Unspecified,0.0,0,1942,2849,2118,3002,176,153
14162,levle1_356.jpg,fore,Unspecified,0.0,0,1896,2658,2064,2819,168,161
14163,levle1_356.jpg,fore,Unspecified,0.0,0,1949,2489,2064,2596,115,107
14164,levle1_356.jpg,fore,Unspecified,0.0,0,1888,2290,2011,2451,123,161
14165,levle1_356.jpg,fore,Unspecified,0.0,0,2003,2274,2210,2512,207,238
14166,levle3_17.jpg,fore,,,0,552,422,570,455,18,33
14167,levle3_17.jpg,fore,,,0,448,392,481,418,33,26
14168,levle3_17.jpg,fore,,,0,452,418,491,453,39,35
14169,levle3_17.jpg,fore,,,0,413,402,432,439,19,37
14170,levle3_17.jpg,fore,,,0,458,477,493,518,35,41
14171,levle3_17.jpg,fore,,,0,470,524,513,559,43,35
14172,levle3_17.jpg,fore,,,0,466,649,503,681,37,32
14173,levle3_17.jpg,fore,,,0,487,685,534,698,47,13
14174,levle3_17.jpg,fore,,,0,405,616,428,655,23,39
14175,levle3_17.jpg,fore,,,0,383,545,432,598,49,53
14176,levle3_17.jpg,fore,,,0,368,508,387,549,19,41
14177,levle3_17.jpg,fore,,,0,393,502,438,545,45,43
14178,levle3_17.jpg,fore,,,0,307,549,332,577,25,28
14179,levle3_17.jpg,fore,,,0,346,563,370,585,24,22
14180,levle3_17.jpg,fore,,,0,330,579,358,620,28,41
14181,levle3_17.jpg,fore,,,0,254,600,287,624,33,24
14182,levle3_17.jpg,fore,,,0,315,643,346,677,31,34
14183,levle3_17.jpg,fore,,,0,342,645,364,692,22,47
14184,levle3_17.jpg,fore,,,0,377,661,411,696,34,35
14185,levle3_17.jpg,fore,,,0,250,563,268,585,18,22
14186,levle3_17.jpg,fore,,,0,266,516,305,577,39,61
14187,levle3_17.jpg,fore,,,0,281,498,315,526,34,28
14188,levle3_17.jpg,fore,,,0,313,506,364,555,51,49
14189,levle3_17.jpg,fore,,,0,307,467,326,496,19,29
14190,levle3_17.jpg,fore,,,0,346,455,370,492,24,37
14191,levle3_17.jpg,fore,,,0,289,402,324,445,35,43
14192,levle3_17.jpg,fore,,,0,313,428,346,465,33,37
14193,levle3_17.jpg,fore,,,0,236,400,268,439,32,39
14194,levle3_17.jpg,fore,,,0,258,424,295,469,37,45
14195,levle3_17.jpg,fore,,,0,287,330,317,369,30,39
14196,levle3_17.jpg,fore,,,0,352,284,370,326,18,42
14197,levle3_17.jpg,fore,,,0,387,249,419,281,32,32
14198,levle3_17.jpg,fore,,,0,454,281,485,306,31,25
14199,levle3_17.jpg,fore,,,0,468,239,503,281,35,42
14200,levle3_17.jpg,fore,,,0,491,200,526,235,35,35
14201,levle3_17.jpg,fore,,,0,491,151,526,202,35,51
14202,levle3_17.jpg,fore,,,0,220,506,262,547,42,41
14203,levle3_17.jpg,fore,,,0,183,551,222,583,39,32
14204,levle3_17.jpg,fore,,,0,268,630,303,669,35,39
14205,levle3_17.jpg,fore,,,0,360,600,403,638,43,38
14206,levle3_17.jpg,fore,,,0,289,587,315,628,26,41
14207,levle3_17.jpg,fore,,,0,585,383,625,432,40,49
14208,levle3_17.jpg,fore,,,0,523,565,572,622,49,57
14209,levle3_17.jpg,fore,,,0,468,696,523,747,55,51
14210,levle3_17.jpg,fore,,,0,454,567,513,622,59,55
14211,levle3_17.jpg,fore,,,0,536,372,570,402,34,30
14212,levle3_17.jpg,fore,,,0,566,436,602,476,36,40
14213,levle3_17.jpg,fore,,,0,596,450,633,483,37,33
14214,levle3_17.jpg,fore,,,0,371,435,417,471,46,36
14215,levle3_17.jpg,fore,,,0,535,620,575,657,40,37
14216,levle3_17.jpg,fore,,,0,230,613,270,647,40,34
14217,levle3_17.jpg,fore,,,0,435,550,475,588,40,38
14218,levle3_17.jpg,fore,,,0,182,484,216,518,34,34
14219,levle3_17.jpg,fore,,,0,202,412,234,441,32,29
14220,levle3_17.jpg,fore,,,0,242,325,274,350,32,25
14221,levle3_17.jpg,fore,,,0,326,328,363,358,37,30
14222,levle3_17.jpg,fore,,,0,313,296,347,328,34,32
14223,levle3_17.jpg,fore,,,0,230,576,252,598,22,22
14224,levle3_17.jpg,fore,,,0,216,591,244,613,28,22
14225,levle3_17.jpg,fore,,,0,178,611,200,637,22,26
14226,levle3_17.jpg,fore,,,0,197,606,228,637,31,31
14227,levle3_17.jpg,fore,,,0,271,680,302,704,31,24
14228,levle3_17.jpg,fore,,,0,411,481,440,514,29,33
14229,levle3_17.jpg,fore,,,0,478,346,503,371,25,25
14230,levle3_17.jpg,fore,,,0,537,451,565,478,28,27
14231,levle1_430.jpg,fore,Unspecified,0.0,0,2539,2420,2731,2558,192,138
14232,levle1_430.jpg,fore,Unspecified,0.0,0,2578,2581,2792,2727,214,146
14233,levle1_430.jpg,fore,Unspecified,0.0,0,1988,2826,2164,2979,176,153
14234,levle1_430.jpg,fore,Unspecified,0.0,0,1934,2987,2018,3179,84,192
14235,levle1_430.jpg,fore,Unspecified,0.0,0,1244,3033,1413,3179,169,146
14236,levle1_430.jpg,fore,Unspecified,0.0,0,1137,2106,1359,2305,222,199
14237,levle1_424.jpg,fore,Unspecified,0.0,0,738,2160,838,2274,100,114
14238,levle1_424.jpg,fore,Unspecified,0.0,0,631,2022,777,2175,146,153
14239,levle1_424.jpg,fore,Unspecified,0.0,0,332,2466,470,2627,138,161
14240,levle1_424.jpg,fore,Unspecified,0.0,0,547,2451,738,2543,191,92
14241,levle1_424.jpg,fore,Unspecified,0.0,0,585,2573,692,2688,107,115
14242,levle1_424.jpg,fore,Unspecified,0.0,0,823,2543,945,2704,122,161
14243,levle1_424.jpg,fore,Unspecified,0.0,0,1750,734,1965,910,215,176
14244,levle0_151.jpg,fore,Unspecified,0.0,0,1329,2037,1451,2167,122,130
14245,levle1_342.jpg,fore,Unspecified,0.0,0,915,2206,1022,2336,107,130
14246,levle1_342.jpg,fore,Unspecified,0.0,0,1068,2160,1168,2229,100,69
14247,levle1_342.jpg,fore,Unspecified,0.0,0,1168,2221,1267,2366,99,145
14248,levle1_342.jpg,fore,Unspecified,0.0,0,1175,2351,1321,2520,146,169
14249,levle1_342.jpg,fore,Unspecified,0.0,0,1152,2566,1298,2665,146,99
14250,levle1_342.jpg,fore,Unspecified,0.0,0,976,2451,1060,2596,84,145
14251,levle0_186.jpg,fore,Unspecified,0.0,0,1076,2213,1252,2412,176,199
14252,levle0_186.jpg,fore,Unspecified,0.0,0,1137,2711,1290,2880,153,169
14253,levle1_395.jpg,fore,Unspecified,0.0,0,647,2014,761,2190,114,176
14254,levle1_395.jpg,fore,Unspecified,0.0,0,325,1799,409,1953,84,154
14255,levle1_395.jpg,fore,Unspecified,0.0,0,95,1914,225,2114,130,200
14256,levle1_395.jpg,fore,Unspecified,0.0,0,179,2098,309,2259,130,161
14257,levle1_395.jpg,fore,Unspecified,0.0,0,723,2451,861,2604,138,153
14258,levle1_395.jpg,fore,Unspecified,0.0,0,685,2190,769,2359,84,169
14259,levle1_395.jpg,fore,Unspecified,0.0,0,1413,2826,1566,2979,153,153
14260,levle1_395.jpg,fore,Unspecified,0.0,0,1497,3071,1650,3240,153,169
14261,levle1_395.jpg,fore,Unspecified,0.0,0,1336,3064,1443,3225,107,161
14262,levle1_395.jpg,fore,Unspecified,0.0,0,1306,2934,1459,3079,153,145
14263,levle1_395.jpg,fore,Unspecified,0.0,0,731,2911,922,2995,191,84
14264,levle1_395.jpg,fore,Unspecified,0.0,0,922,2934,1099,3140,177,206
14265,levle0_192.jpg,fore,Unspecified,0.0,0,853,2129,1007,2297,154,168
14266,levle1_381.jpg,fore,Unspecified,0.0,0,2455,1286,2631,1424,176,138
14267,levle1_381.jpg,fore,Unspecified,0.0,0,2493,2052,2685,2206,192,154
14268,levle1_381.jpg,fore,Unspecified,0.0,0,2830,2206,2984,2328,154,122
14269,levle1_381.jpg,fore,Unspecified,0.0,0,2440,2696,2601,2826,161,130
14270,levle1_381.jpg,fore,Unspecified,0.0,0,1857,2911,2064,3064,207,153
14271,levle1_381.jpg,fore,Unspecified,0.0,0,2041,2849,2156,3010,115,161
14272,levle1_381.jpg,fore,Unspecified,0.0,0,2210,2834,2325,2941,115,107
14273,levle1_381.jpg,fore,Unspecified,0.0,0,2417,2888,2547,3048,130,160
14274,levle0_46.jpg,fore,Unspecified,0.0,0,1137,2083,1283,2229,146,146
14275,levle0_46.jpg,fore,Unspecified,0.0,0,961,1194,1168,1347,207,153
14276,levle1_168.jpg,fore,Unspecified,0.0,0,1673,750,1827,880,154,130
14277,levle1_168.jpg,fore,Unspecified,0.0,0,1214,2405,1329,2535,115,130
14278,levle1_168.jpg,fore,Unspecified,0.0,0,1405,2489,1574,2581,169,92
14279,levle1_168.jpg,fore,Unspecified,0.0,0,1727,2366,1865,2497,138,131
14280,levle1_168.jpg,fore,Unspecified,0.0,0,1850,2573,1949,2681,99,108
14281,levle1_168.jpg,fore,Unspecified,0.0,0,2110,2520,2194,2619,84,99
14282,levle0_52.jpg,fore,Unspecified,0.0,0,2294,2543,2501,2780,207,237
14283,levle0_409.jpg,fore,Unspecified,0.0,0,2654,1953,2777,2098,123,145
14284,levle0_421.jpg,fore,Unspecified,0.0,0,1229,1569,1306,1692,77,123
14285,levle0_421.jpg,fore,Unspecified,0.0,0,1229,1110,1344,1217,115,107
14286,levle0_421.jpg,fore,Unspecified,0.0,0,1696,2681,1819,2765,123,84
14287,levle0_421.jpg,fore,Unspecified,0.0,0,1673,3010,1819,3125,146,115
14288,levle1_632.jpg,fore,Unspecified,0.0,0,999,650,1152,780,153,130
14289,levle1_632.jpg,fore,Unspecified,0.0,0,2317,2106,2432,2251,115,145
14290,levle1_632.jpg,fore,Unspecified,0.0,0,2248,2688,2378,2803,130,115
14291,levle1_632.jpg,fore,Unspecified,0.0,0,2478,2558,2562,2750,84,192
14292,levle1_632.jpg,fore,Unspecified,0.0,0,2455,1845,2539,1937,84,92
14293,levle1_632.jpg,fore,Unspecified,0.0,0,2378,1646,2493,1730,115,84
14294,levle1_154.jpg,fore,Unspecified,0.0,0,807,1071,922,1209,115,138
14295,levle1_154.jpg,fore,Unspecified,0.0,0,1773,2412,1957,2550,184,138
14296,levle1_154.jpg,fore,Unspecified,0.0,0,493,2259,639,2382,146,123
14297,levle1_154.jpg,fore,Unspecified,0.0,0,532,2374,647,2489,115,115
14298,levle1_154.jpg,fore,Unspecified,0.0,0,1198,2719,1313,2849,115,130
14299,levle1_154.jpg,fore,Unspecified,0.0,0,1359,3018,1466,3171,107,153
14300,levle1_154.jpg,fore,Unspecified,0.0,0,685,2849,823,2979,138,130
14301,levle1_154.jpg,fore,Unspecified,0.0,0,761,2704,861,2842,100,138
14302,levle1_154.jpg,fore,Unspecified,0.0,0,1497,3094,1612,3202,115,108
14303,levle0_347.jpg,fore,Unspecified,0.0,0,1420,1976,1581,2121,161,145
14304,levle1_140.jpg,fore,Unspecified,0.0,0,493,2221,601,2313,108,92
14305,levle1_140.jpg,fore,Unspecified,0.0,0,1022,2251,1106,2328,84,77
14306,levle1_140.jpg,fore,Unspecified,0.0,0,853,2336,968,2435,115,99
14307,levle1_140.jpg,fore,Unspecified,0.0,0,784,2397,899,2520,115,123
14308,levle1_140.jpg,fore,Unspecified,0.0,0,692,2474,784,2596,92,122
14309,levle1_140.jpg,fore,Unspecified,0.0,0,777,2543,853,2635,76,92
14310,levle1_140.jpg,fore,Unspecified,0.0,0,915,2550,999,2696,84,146
14311,levle1_140.jpg,fore,Unspecified,0.0,0,1007,2497,1175,2619,168,122
14312,levle1_140.jpg,fore,Unspecified,0.0,0,539,2320,631,2435,92,115
14313,levle0_353.jpg,fore,Unspecified,0.0,0,769,857,892,1056,123,199
14314,levle0_353.jpg,fore,Unspecified,0.0,0,624,1018,807,1271,183,253
14315,levle1_626.jpg,fore,Unspecified,0.0,0,1283,2305,1375,2420,92,115
14316,levle1_626.jpg,fore,Unspecified,0.0,0,1221,2435,1344,2566,123,131
14317,levle1_626.jpg,fore,Unspecified,0.0,0,1145,2336,1229,2428,84,92
14318,levle1_626.jpg,fore,Unspecified,0.0,0,953,2397,1083,2481,130,84
14319,levle1_626.jpg,fore,Unspecified,0.0,0,1122,2504,1191,2589,69,85
14320,levle1_626.jpg,fore,Unspecified,0.0,0,1857,2911,2018,3018,161,107
14321,levle1_626.jpg,fore,Unspecified,0.0,0,1727,2949,1857,3048,130,99
14322,levle1_626.jpg,fore,Unspecified,0.0,0,1658,3071,1758,3156,100,85
14323,levle1_626.jpg,fore,Unspecified,0.0,0,1758,3209,1934,3309,176,100
14324,levle1_626.jpg,fore,Unspecified,0.0,0,1574,3248,1689,3409,115,161
14325,levle1_626.jpg,fore,Unspecified,0.0,0,2601,3140,2716,3263,115,123
14326,levle1_626.jpg,fore,Unspecified,0.0,0,1980,619,2057,734,77,115
14327,levle1_626.jpg,fore,Unspecified,0.0,0,2026,757,2133,865,107,108
14328,levle1_626.jpg,fore,Unspecified,0.0,0,2087,589,2210,704,123,115
14329,levle0_85.jpg,fore,Unspecified,0.0,0,1852,2665,1960,2798,108,133
14330,levle0_91.jpg,fore,Unspecified,0.0,0,532,2037,639,2206,107,169
14331,levle0_91.jpg,fore,Unspecified,0.0,0,593,1891,692,2006,99,115
14332,levle1_197.jpg,fore,Unspecified,0.0,0,1574,880,1696,956,122,76
14333,levle1_197.jpg,fore,Unspecified,0.0,0,493,2160,562,2251,69,91
14334,levle1_197.jpg,fore,Unspecified,0.0,0,570,2190,692,2274,122,84
14335,levle1_197.jpg,fore,Unspecified,0.0,0,1060,2543,1198,2612,138,69
14336,levle1_197.jpg,fore,Unspecified,0.0,0,1076,2803,1191,2918,115,115
14337,levle1_197.jpg,fore,Unspecified,0.0,0,1390,3263,1474,3416,84,153
14338,levle1_197.jpg,fore,Unspecified,0.0,0,1267,2420,1413,2497,146,77
14339,levle0_384.jpg,fore,Unspecified,0.0,0,570,1117,708,1278,138,161
14340,levle1_183.jpg,fore,,,0,493,1340,692,1462,199,122
14341,levle1_183.jpg,fore,,,0,991,3163,1229,3340,238,177
14342,levle1_183.jpg,fore,,,0,381,1612,491,1732,110,120
14343,levle1_183.jpg,fore,,,0,1229,3029,1367,3132,138,103
14344,levle1_183.jpg,fore,,,0,1029,2167,1212,2305,183,138
14345,levle1_183.jpg,fore,,,0,1570,3166,1753,3314,183,148
14346,levle0_390.jpg,fore,Unspecified,0.0,0,2386,2466,2478,2604,92,138
14347,levle2_43.jpg,fore,Unspecified,0.0,0,1160,2029,1329,2213,169,184
14348,levle2_43.jpg,fore,Unspecified,0.0,0,1114,2267,1244,2443,130,176
14349,levle2_43.jpg,fore,Unspecified,0.0,0,1022,2129,1183,2267,161,138
14350,levle2_43.jpg,fore,Unspecified,0.0,0,984,2167,1030,2274,46,107
14351,levle2_43.jpg,fore,Unspecified,0.0,0,777,2068,938,2236,161,168
14352,levle2_43.jpg,fore,Unspecified,0.0,0,715,2251,884,2397,169,146
14353,levle2_43.jpg,fore,Unspecified,0.0,0,662,2313,769,2443,107,130
14354,levle2_43.jpg,fore,Unspecified,0.0,0,555,2068,685,2213,130,145
14355,levle2_43.jpg,fore,Unspecified,0.0,0,371,1876,509,2014,138,138
14356,levle2_43.jpg,fore,Unspecified,0.0,0,302,1730,432,1899,130,169
14357,levle2_43.jpg,fore,Unspecified,0.0,0,332,1976,547,2083,215,107
14358,levle2_43.jpg,fore,Unspecified,0.0,0,302,2091,493,2236,191,145
14359,levle2_43.jpg,fore,Unspecified,0.0,0,470,2297,654,2397,184,100
14360,levle2_43.jpg,fore,Unspecified,0.0,0,440,2397,601,2504,161,107
14361,levle2_43.jpg,fore,Unspecified,0.0,0,547,2466,685,2589,138,123
14362,levle2_43.jpg,fore,Unspecified,0.0,0,593,2589,708,2750,115,161
14363,levle2_43.jpg,fore,Unspecified,0.0,0,708,2596,838,2727,130,131
14364,levle2_43.jpg,fore,Unspecified,0.0,0,731,2688,899,2872,168,184
14365,levle2_43.jpg,fore,Unspecified,0.0,0,922,2527,984,2696,62,169
14366,levle2_43.jpg,fore,Unspecified,0.0,0,968,2535,1168,2696,200,161
14367,levle2_43.jpg,fore,Unspecified,0.0,0,984,2635,1106,2819,122,184
14368,levle2_43.jpg,fore,Unspecified,0.0,0,1175,2635,1260,2803,85,168
14369,levle2_43.jpg,fore,Unspecified,0.0,0,1191,3025,1367,3140,176,115
14370,levle2_43.jpg,fore,Unspecified,0.0,0,999,2259,1083,2405,84,146
14371,levle2_43.jpg,fore,Unspecified,0.0,0,876,2282,991,2428,115,146
14372,levle2_43.jpg,fore,Unspecified,0.0,0,953,2359,1091,2558,138,199
14373,levle2_43.jpg,fore,Unspecified,0.0,0,784,2420,938,2581,154,161
14374,levle2_43.jpg,fore,Unspecified,0.0,0,1428,3010,1520,3148,92,138
14375,levle2_43.jpg,fore,Unspecified,0.0,0,1597,681,1673,757,76,76
14376,levle2_43.jpg,fore,Unspecified,0.0,0,1466,773,1597,887,131,114
14377,levle2_43.jpg,fore,Unspecified,0.0,0,1359,251,1520,397,161,146
14378,levle2_57.jpg,fore,,,0,2384,928,2508,1094,124,166
14379,levle2_57.jpg,fore,,,0,2600,770,2783,961,183,191
14380,levle2_57.jpg,fore,,,0,3090,1252,3240,1402,150,150
14381,levle2_57.jpg,fore,,,0,3223,1319,3381,1502,158,183
14382,levle2_57.jpg,fore,,,0,3514,1360,3680,1510,166,150
14383,levle2_57.jpg,fore,,,0,2974,2083,3065,2225,91,142
14384,levle2_57.jpg,fore,,,0,3099,2108,3215,2241,116,133
14385,levle2_57.jpg,fore,,,0,3639,1826,3739,1992,100,166
14386,levle2_57.jpg,fore,,,0,3606,2017,3714,2142,108,125
14387,levle2_57.jpg,fore,,,0,3564,2216,3747,2383,183,167
14388,levle2_57.jpg,fore,,,0,3323,2275,3506,2408,183,133
14389,levle2_57.jpg,fore,,,0,3414,2399,3531,2516,117,117
14390,levle2_57.jpg,fore,,,0,2758,2383,2874,2541,116,158
14391,levle2_57.jpg,fore,,,0,2899,2516,3049,2673,150,157
14392,levle2_57.jpg,fore,,,0,2991,2607,3099,2806,108,199
14393,levle2_57.jpg,fore,,,0,3115,2549,3290,2673,175,124
14394,levle2_57.jpg,fore,,,0,3298,2790,3464,3006,166,216
14395,levle2_57.jpg,fore,,,0,2683,2881,2824,3056,141,175
14396,levle2_57.jpg,fore,,,0,3074,2782,3202,2886,128,104
14397,levle2_57.jpg,fore,,,0,2814,2266,2938,2378,124,112
14398,levle2_57.jpg,fore,,,0,3350,1190,3482,1286,132,96
14399,levle0_233.jpg,fore,Unspecified,0.0,0,1313,1301,1474,1409,161,108
14400,levle0_227.jpg,fore,Unspecified,0.0,0,2447,1899,2624,2045,177,146
14401,levle2_108.jpg,fore,Unspecified,0.0,0,1068,979,1237,1148,169,169
14402,levle2_108.jpg,fore,Unspecified,0.0,0,869,1110,1014,1225,145,115
14403,levle2_108.jpg,fore,Unspecified,0.0,0,1658,1868,1850,2052,192,184
14404,levle2_108.jpg,fore,Unspecified,0.0,0,2125,1248,2233,1340,108,92
14405,levle2_108.jpg,fore,Unspecified,0.0,0,1405,2420,1543,2558,138,138
14406,levle2_108.jpg,fore,Unspecified,0.0,0,1443,2612,1566,2742,123,130
14407,levle2_108.jpg,fore,Unspecified,0.0,0,876,2121,999,2221,123,100
14408,levle2_108.jpg,fore,Unspecified,0.0,0,899,2221,1099,2328,200,107
14409,levle2_108.jpg,fore,Unspecified,0.0,0,968,2351,1053,2458,85,107
14410,levle2_108.jpg,fore,Unspecified,0.0,0,1076,2650,1191,2780,115,130
14411,levle2_108.jpg,fore,Unspecified,0.0,0,777,2581,853,2704,76,123
14412,levle2_108.jpg,fore,Unspecified,0.0,0,792,2489,930,2589,138,100
14413,levle2_108.jpg,fore,Unspecified,0.0,0,746,2320,876,2435,130,115
14414,levle2_108.jpg,fore,Unspecified,0.0,0,784,2221,861,2297,77,76
14415,levle2_108.jpg,fore,Unspecified,0.0,0,685,2091,823,2198,138,107
14416,levle2_108.jpg,fore,Unspecified,0.0,0,685,2183,807,2290,122,107
14417,levle2_108.jpg,fore,Unspecified,0.0,0,608,2206,715,2328,107,122
14418,levle2_108.jpg,fore,Unspecified,0.0,0,585,2336,692,2412,107,76
14419,levle2_108.jpg,fore,Unspecified,0.0,0,662,2428,746,2497,84,69
14420,levle2_108.jpg,fore,Unspecified,0.0,0,539,2412,631,2504,92,92
14421,levle2_108.jpg,fore,Unspecified,0.0,0,516,2244,593,2351,77,107
14422,levle2_108.jpg,fore,Unspecified,0.0,0,294,2091,371,2190,77,99
14423,levle2_108.jpg,fore,Unspecified,0.0,0,371,2190,470,2267,99,77
14424,levle2_108.jpg,fore,Unspecified,0.0,0,355,2282,447,2412,92,130
14425,levle2_108.jpg,fore,Unspecified,0.0,0,1237,2221,1359,2328,122,107
14426,levle2_108.jpg,fore,Unspecified,0.0,0,861,3056,1007,3179,146,123
14427,levle2_108.jpg,fore,Unspecified,0.0,0,1007,734,1122,834,115,100
14428,levle2_108.jpg,fore,Unspecified,0.0,0,1198,864,1275,979,77,115
14429,levle2_108.jpg,fore,Unspecified,0.0,0,1329,780,1436,895,107,115
14430,levle2_108.jpg,fore,Unspecified,0.0,0,1551,773,1627,864,76,91
14431,levle2_108.jpg,fore,Unspecified,0.0,0,1443,504,1558,627,115,123
14432,levle2_108.jpg,fore,Unspecified,0.0,0,1834,665,1934,742,100,77
14433,levle2_108.jpg,fore,Unspecified,0.0,0,1896,765,1965,849,69,84
14434,levle2_94.jpg,fore,,,0,2507,1757,2595,1889,88,132
14435,levle2_94.jpg,fore,,,0,2419,1739,2516,1889,97,150
14436,levle2_94.jpg,fore,,,0,2349,1722,2410,1818,61,96
14437,levle2_94.jpg,fore,,,0,2218,1564,2358,1669,140,105
14438,levle2_94.jpg,fore,,,0,2095,1652,2200,1748,105,96
14439,levle2_94.jpg,fore,,,0,1981,1696,2112,1810,131,114
14440,levle2_94.jpg,fore,,,0,2103,1731,2200,1810,97,79
14441,levle2_94.jpg,fore,,,0,2147,1775,2226,1862,79,87
14442,levle2_94.jpg,fore,,,0,2165,1810,2261,1906,96,96
14443,levle2_94.jpg,fore,,,0,2007,1810,2095,1897,88,87
14444,levle2_94.jpg,fore,,,0,2156,1950,2261,2038,105,88
14445,levle2_94.jpg,fore,,,0,2296,2082,2410,2160,114,78
14446,levle2_94.jpg,fore,,,0,2507,2231,2647,2318,140,87
14447,levle2_94.jpg,fore,,,0,2446,2292,2577,2406,131,114
14448,levle2_94.jpg,fore,,,0,2340,2292,2437,2353,97,61
14449,levle2_94.jpg,fore,,,0,2507,2415,2595,2503,88,88
14450,levle2_94.jpg,fore,,,0,2174,1099,2367,1275,193,176
14451,levle2_94.jpg,fore,,,0,2367,2143,2481,2239,114,96
14452,levle2_94.jpg,fore,,,0,2227,1713,2360,1822,133,109
14453,levle2_94.jpg,fore,,,0,2269,2259,2356,2343,87,84
14454,levle2_94.jpg,fore,,,0,2289,2322,2385,2418,96,96
14455,levle2_120.jpg,fore,,,0,363,1615,478,1730,115,115
14456,levle2_120.jpg,fore,,,0,248,1455,447,1600,199,145
14457,levle2_120.jpg,fore,,,0,394,2098,440,2152,46,54
14458,levle2_120.jpg,fore,,,0,317,2022,394,2144,77,122
14459,levle2_120.jpg,fore,,,0,470,2121,624,2229,154,108
14460,levle2_120.jpg,fore,,,0,470,2236,608,2359,138,123
14461,levle2_120.jpg,fore,,,0,309,2229,447,2297,138,68
14462,levle2_120.jpg,fore,,,0,876,2351,1007,2489,131,138
14463,levle2_120.jpg,fore,,,0,1007,2351,1145,2504,138,153
14464,levle2_120.jpg,fore,,,0,578,2443,654,2612,76,169
14465,levle2_120.jpg,fore,,,0,1175,3125,1321,3248,146,123
14466,levle2_120.jpg,fore,,,0,1206,2872,1420,3033,214,161
14467,levle2_120.jpg,fore,,,0,562,1102,754,1309,192,207
14468,levle2_120.jpg,fore,,,0,286,1340,424,1462,138,122
14469,levle2_120.jpg,fore,,,0,1712,1087,1865,1248,153,161
14470,levle2_120.jpg,fore,,,0,761,2520,953,2642,192,122
14471,levle2_120.jpg,fore,,,0,670,2612,853,2750,183,138
14472,levle2_120.jpg,fore,,,0,1520,2903,1620,3018,100,115
14473,levle2_120.jpg,fore,,,0,726,2036,867,2136,141,100
14474,levle2_120.jpg,fore,,,0,677,2539,788,2653,111,114
14475,levle2_120.jpg,fore,,,0,698,1319,819,1439,121,120
14476,levle2_134.jpg,fore,Unspecified,0.0,0,2309,2489,2424,2558,115,69
14477,levle2_134.jpg,fore,Unspecified,0.0,0,2363,2550,2440,2642,77,92
14478,levle2_134.jpg,fore,Unspecified,0.0,0,2233,2573,2340,2635,107,62
14479,levle2_134.jpg,fore,Unspecified,0.0,0,2202,2658,2286,2757,84,99
14480,levle2_134.jpg,fore,Unspecified,0.0,0,2087,2688,2217,2788,130,100
14481,levle2_134.jpg,fore,Unspecified,0.0,0,2125,2880,2256,2995,131,115
14482,levle2_134.jpg,fore,Unspecified,0.0,0,1949,2642,2041,2719,92,77
14483,levle2_134.jpg,fore,Unspecified,0.0,0,1765,2229,1880,2336,115,107
14484,levle2_134.jpg,fore,Unspecified,0.0,0,2057,2420,2179,2543,122,123
14485,levle2_134.jpg,fore,Unspecified,0.0,0,1842,2481,1934,2566,92,85
14486,levle2_134.jpg,fore,Unspecified,0.0,0,1520,2091,1635,2213,115,122
14487,levle2_134.jpg,fore,Unspecified,0.0,0,1397,3079,1505,3232,108,153
14488,levle2_134.jpg,fore,Unspecified,0.0,0,2478,2244,2585,2382,107,138
14489,levle2_134.jpg,fore,Unspecified,0.0,0,1581,719,1719,849,138,130
14490,levle2_134.jpg,fore,Unspecified,0.0,0,1290,972,1390,1071,100,99
14491,levle2_134.jpg,fore,Unspecified,0.0,0,1183,1110,1313,1240,130,130
14492,levle2_134.jpg,fore,Unspecified,0.0,0,1076,1439,1183,1562,107,123
14493,levle2_134.jpg,fore,Unspecified,0.0,0,999,1079,1122,1179,123,100
14494,levle2_134.jpg,fore,Unspecified,0.0,0,1045,1163,1137,1263,92,100
14495,levle2_134.jpg,fore,Unspecified,0.0,0,1160,926,1252,1010,92,84
14496,levle2_134.jpg,fore,Unspecified,0.0,0,1283,826,1397,949,114,123
14497,levle2_134.jpg,fore,Unspecified,0.0,0,945,880,1106,949,161,69
14498,levle2_134.jpg,fore,Unspecified,0.0,0,853,1033,984,1163,131,130
14499,levle1_578.jpg,fore,Unspecified,0.0,0,1827,2121,1965,2267,138,146
14500,levle1_578.jpg,fore,Unspecified,0.0,0,1735,2366,1842,2466,107,100
14501,levle1_578.jpg,fore,Unspecified,0.0,0,1781,2474,1934,2627,153,153
14502,levle1_578.jpg,fore,Unspecified,0.0,0,1229,2972,1352,3179,123,207
14503,levle1_578.jpg,fore,Unspecified,0.0,0,1520,1148,1627,1263,107,115
14504,levle1_578.jpg,fore,Unspecified,0.0,0,1597,995,1742,1117,145,122
14505,levle1_578.jpg,fore,Unspecified,0.0,0,1735,849,1896,1025,161,176
14506,levle1_578.jpg,fore,Unspecified,0.0,0,1620,650,1857,849,237,199
14507,levle1_578.jpg,fore,Unspecified,0.0,0,1359,1056,1466,1179,107,123
14508,levle1_222.jpg,fore,Unspecified,0.0,0,1873,2420,1965,2497,92,77
14509,levle1_222.jpg,fore,Unspecified,0.0,0,1942,2888,2034,2979,92,91
14510,levle1_222.jpg,fore,Unspecified,0.0,0,1727,3041,1804,3102,77,61
14511,levle1_222.jpg,fore,Unspecified,0.0,0,2110,3110,2256,3240,146,130
14512,levle1_222.jpg,fore,Unspecified,0.0,0,2240,2956,2325,3087,85,131
14513,levle1_222.jpg,fore,Unspecified,0.0,0,2011,2750,2125,2811,114,61
14514,levle1_222.jpg,fore,Unspecified,0.0,0,2394,2941,2493,3033,99,92
14515,levle1_222.jpg,fore,Unspecified,0.0,0,2463,2788,2547,2872,84,84
14516,levle1_544.jpg,fore,Unspecified,0.0,0,2179,2857,2317,2987,138,130
14517,levle1_544.jpg,fore,Unspecified,0.0,0,1988,3041,2118,3140,130,99
14518,levle1_544.jpg,fore,Unspecified,0.0,0,2003,2604,2194,2773,191,169
14519,levle1_544.jpg,fore,Unspecified,0.0,0,2202,2160,2317,2259,115,99
14520,levle1_544.jpg,fore,Unspecified,0.0,0,2501,2435,2647,2566,146,131
14521,levle1_12.jpg,fore,Unspecified,0.0,0,274,135,299,166,25,31
14522,levle1_12.jpg,fore,Unspecified,0.0,0,271,159,297,190,26,31
14523,levle1_12.jpg,fore,Unspecified,0.0,0,193,145,233,182,40,37
14524,levle1_12.jpg,fore,Unspecified,0.0,0,206,186,234,219,28,33
14525,levle1_12.jpg,fore,Unspecified,0.0,0,266,477,309,519,43,42
14526,levle1_12.jpg,fore,Unspecified,0.0,0,219,484,262,530,43,46
14527,levle1_12.jpg,fore,Unspecified,0.0,0,306,498,351,542,45,44
14528,levle1_12.jpg,fore,Unspecified,0.0,0,371,472,413,512,42,40
14529,levle1_12.jpg,fore,Unspecified,0.0,0,426,473,453,510,27,37
14530,levle1_550.jpg,fore,Unspecified,0.0,0,2386,964,2493,1056,107,92
14531,levle1_550.jpg,fore,Unspecified,0.0,0,2125,1255,2233,1317,108,62
14532,levle1_550.jpg,fore,Unspecified,0.0,0,2424,1217,2516,1294,92,77
14533,levle1_550.jpg,fore,Unspecified,0.0,0,2294,1355,2424,1447,130,92
14534,levle1_550.jpg,fore,Unspecified,0.0,0,2148,1340,2286,1424,138,84
14535,levle1_550.jpg,fore,Unspecified,0.0,0,2386,1102,2562,1194,176,92
14536,levle1_550.jpg,fore,Unspecified,0.0,0,2501,865,2601,949,100,84
14537,levle1_550.jpg,fore,Unspecified,0.0,0,2133,1761,2286,1907,153,146
14538,levle1_550.jpg,fore,Unspecified,0.0,0,1643,1761,1788,1907,145,146
14539,levle1_550.jpg,fore,Unspecified,0.0,0,1581,1899,1719,2022,138,123
14540,levle1_236.jpg,fore,Unspecified,0.0,0,1175,711,1306,826,131,115
14541,levle1_236.jpg,fore,Unspecified,0.0,0,1896,1347,1988,1455,92,108
14542,levle1_236.jpg,fore,Unspecified,0.0,0,2026,1615,2148,1707,122,92
14543,levle1_236.jpg,fore,Unspecified,0.0,0,2210,1937,2263,2045,53,108
14544,levle1_236.jpg,fore,Unspecified,0.0,0,2302,2029,2371,2213,69,184
14545,levle1_236.jpg,fore,Unspecified,0.0,0,1466,2834,1635,2979,169,145
14546,levle1_236.jpg,fore,Unspecified,0.0,0,1857,2512,1972,2619,115,107
14547,levle3_119.jpg,fore,,,0,302,8,319,35,17,27
14548,levle3_119.jpg,fore,,,0,359,24,379,46,20,22
14549,levle3_119.jpg,fore,,,0,386,46,403,66,17,20
14550,levle3_119.jpg,fore,,,0,255,60,271,79,16,19
14551,levle3_119.jpg,fore,,,0,290,47,314,67,24,20
14552,levle3_119.jpg,fore,,,0,229,125,251,142,22,17
14553,levle3_119.jpg,fore,,,0,294,164,308,186,14,22
14554,levle3_119.jpg,fore,,,0,313,162,330,177,17,15
14555,levle3_119.jpg,fore,,,0,407,206,431,238,24,32
14556,levle3_119.jpg,fore,,,0,379,279,397,304,18,25
14557,levle3_119.jpg,fore,,,0,173,274,201,306,28,32
14558,levle3_119.jpg,fore,,,0,312,38,337,60,25,22
14559,levle3_119.jpg,fore,,,0,277,28,297,52,20,24
14560,levle3_119.jpg,fore,,,0,282,64,307,81,25,17
14561,levle3_119.jpg,fore,,,0,305,74,328,99,23,25
14562,levle3_119.jpg,fore,,,0,283,94,304,111,21,17
14563,levle3_119.jpg,fore,,,0,259,94,273,111,14,17
14564,levle3_119.jpg,fore,,,0,358,51,380,70,22,19
14565,levle3_119.jpg,fore,,,0,365,68,384,90,19,22
14566,levle3_119.jpg,fore,,,0,384,84,410,114,26,30
14567,levle3_119.jpg,fore,,,0,323,96,349,117,26,21
14568,levle3_119.jpg,fore,,,0,292,111,315,137,23,26
14569,levle3_119.jpg,fore,,,0,268,122,288,143,20,21
14570,levle3_119.jpg,fore,,,0,335,150,357,172,22,22
14571,levle3_119.jpg,fore,,,0,345,118,362,139,17,21
14572,levle3_119.jpg,fore,,,0,364,153,379,172,15,19
14573,levle3_119.jpg,fore,,,0,365,106,389,139,24,33
14574,levle3_119.jpg,fore,,,0,415,139,438,162,23,23
14575,levle3_119.jpg,fore,,,0,445,91,468,111,23,20
14576,levle3_119.jpg,fore,,,0,440,135,457,159,17,24
14577,levle3_119.jpg,fore,,,0,440,165,457,184,17,19
14578,levle3_119.jpg,fore,,,0,369,182,393,207,24,25
14579,levle3_119.jpg,fore,,,0,337,198,359,225,22,27
14580,levle3_119.jpg,fore,,,0,363,207,381,227,18,20
14581,levle3_119.jpg,fore,,,0,332,228,345,250,13,22
14582,levle3_119.jpg,fore,,,0,361,229,378,246,17,17
14583,levle3_119.jpg,fore,,,0,357,250,377,271,20,21
14584,levle3_119.jpg,fore,,,0,273,267,302,296,29,29
14585,levle3_119.jpg,fore,,,0,253,259,269,276,16,17
14586,levle3_119.jpg,fore,,,0,233,254,250,276,17,22
14587,levle3_119.jpg,fore,,,0,320,280,344,307,24,27
14588,levle3_119.jpg,fore,,,0,254,188,293,228,39,40
14589,levle3_119.jpg,fore,,,0,341,1,358,11,17,10
14590,levle3_119.jpg,fore,,,0,396,1,412,13,16,12
14591,levle3_119.jpg,fore,,,0,425,93,439,108,14,15
14592,levle3_119.jpg,fore,,,0,247,157,274,173,27,16
14593,levle3_119.jpg,fore,,,0,305,207,321,220,16,13
14594,levle3_119.jpg,fore,,,0,315,200,331,212,16,12
14595,levle3_119.jpg,fore,,,0,219,292,234,308,15,16
14596,levle3_119.jpg,fore,,,0,390,244,408,256,18,12
14597,levle3_119.jpg,fore,,,0,429,182,446,201,17,19
14598,levle3_119.jpg,fore,,,0,243,328,279,346,36,18
14599,levle3_119.jpg,fore,,,0,289,307,311,323,22,16
14600,levle3_119.jpg,fore,,,0,218,263,240,282,22,19
14601,levle3_119.jpg,fore,,,0,291,227,307,241,16,14
14602,levle3_119.jpg,fore,,,0,260,172,279,186,19,14
14603,levle3_119.jpg,fore,,,0,245,105,262,123,17,18
14604,levle3_119.jpg,fore,,,0,403,27,418,42,15,15
14605,levle3_119.jpg,fore,,,0,440,117,458,136,18,19
14606,levle3_119.jpg,fore,,,0,453,129,471,151,18,22
14607,levle3_119.jpg,fore,,,0,305,145,328,166,23,21
14608,levle3_119.jpg,fore,,,0,325,178,350,197,25,19
14609,levle3_119.jpg,fore,,,0,377,224,401,240,24,16
14610,levle3_119.jpg,fore,,,0,235,140,257,156,22,16
14611,levle3_131.jpg,fore,,,0,1375,2114,1551,2183,176,69
14612,levle3_131.jpg,fore,,,0,1275,2022,1382,2075,107,53
14613,levle3_131.jpg,fore,,,0,1129,2060,1229,2144,100,84
14614,levle3_131.jpg,fore,,,0,1091,2175,1290,2297,199,122
14615,levle3_131.jpg,fore,,,0,1060,2213,1206,2397,146,184
14616,levle3_131.jpg,fore,,,0,777,2183,915,2213,138,30
14617,levle3_131.jpg,fore,,,0,876,2052,976,2098,100,46
14618,levle3_131.jpg,fore,,,0,892,2711,1060,2811,168,100
14619,levle3_131.jpg,fore,,,0,1076,2750,1275,2934,199,184
14620,levle3_131.jpg,fore,,,0,777,2757,899,2857,122,100
14621,levle3_131.jpg,fore,,,0,708,2604,861,2696,153,92
14622,levle3_131.jpg,fore,,,0,1597,3094,1765,3186,168,92
14623,levle3_131.jpg,fore,,,0,447,1899,685,2075,238,176
14624,levle3_131.jpg,fore,,,0,309,2497,524,2658,215,161
14625,levle3_131.jpg,fore,,,0,1007,2451,1129,2543,122,92
14626,levle3_131.jpg,fore,,,0,792,1907,999,2075,207,168
14627,levle3_131.jpg,fore,,,0,861,2926,999,2995,138,69
14628,levle3_131.jpg,fore,,,0,1415,484,1543,577,128,93
14629,levle3_131.jpg,fore,,,0,1381,550,1574,715,193,165
14630,levle3_131.jpg,fore,,,0,212,2129,350,2246,138,117
14631,levle3_131.jpg,fore,,,0,219,2267,353,2415,134,148
14632,levle3_131.jpg,fore,,,0,705,2829,843,2953,138,124
14633,levle3_131.jpg,fore,,,0,1246,2853,1405,2953,159,100
14634,levle3_131.jpg,fore,,,0,1171,2939,1405,3070,234,131
14635,levle3_131.jpg,fore,,,0,1022,2894,1160,3060,138,166
14636,levle3_131.jpg,fore,,,0,960,3074,1088,3177,128,103
14637,levle3_131.jpg,fore,,,0,1495,3239,1605,3343,110,104
14638,levle3_131.jpg,fore,,,0,1615,3219,1702,3329,87,110
14639,levle3_131.jpg,fore,,,0,505,2225,657,2357,152,132
14640,levle3_131.jpg,fore,,,0,595,1808,740,1922,145,114
14641,levle3_131.jpg,fore,,,0,1205,1125,1367,1305,162,180
14642,levle3_131.jpg,fore,,,0,1584,498,1708,588,124,90
14643,levle3_131.jpg,fore,,,0,1743,508,1957,629,214,121
14644,levle3_131.jpg,fore,,,0,1984,477,2088,577,104,100
14645,levle3_131.jpg,fore,,,0,1919,608,2057,732,138,124
14646,levle3_131.jpg,fore,,,0,1940,732,2064,836,124,104
14647,levle3_131.jpg,fore,,,0,1360,1977,1488,2098,128,121
14648,levle3_131.jpg,fore,,,0,1477,2281,1715,2463,238,182
14649,levle3_131.jpg,fore,,,0,1598,2077,1757,2225,159,148
14650,levle3_131.jpg,fore,,,0,1733,1950,1881,2132,148,182
14651,levle3_131.jpg,fore,,,0,484,2794,626,2957,142,163
14652,levle3_131.jpg,fore,,,0,860,2388,1029,2553,169,165
14653,levle3_131.jpg,fore,,,0,984,2560,1146,2681,162,121
14654,levle3_131.jpg,fore,,,0,1360,2636,1505,2753,145,117
14655,levle3_131.jpg,fore,,,0,208,1929,343,2025,135,96
14656,levle3_131.jpg,fore,,,0,929,1667,1057,1781,128,114
14657,levle3_131.jpg,fore,,,0,2143,1846,2260,1970,117,124
14658,levle3_131.jpg,fore,,,0,1736,2412,1846,2522,110,110
14659,levle3_131.jpg,fore,,,0,943,2005,1088,2112,145,107
14660,levle3_131.jpg,fore,,,0,546,2501,653,2608,107,107
14661,levle3_131.jpg,fore,,,0,1136,2463,1308,2643,172,180
14662,levle3_131.jpg,fore,,,0,664,2484,802,2625,138,141
14663,levle3_131.jpg,fore,,,0,1357,2408,1502,2536,145,128
14664,levle3_131.jpg,fore,,,0,1412,2463,1622,2615,210,152
14665,levle1_587.jpg,fore,Unspecified,0.0,0,899,872,1037,1033,138,161
14666,levle1_587.jpg,fore,Unspecified,0.0,0,1106,803,1313,956,207,153
14667,levle1_587.jpg,fore,Unspecified,0.0,0,1367,865,1443,972,76,107
14668,levle1_587.jpg,fore,Unspecified,0.0,0,777,1355,892,1462,115,107
14669,levle1_587.jpg,fore,Unspecified,0.0,0,432,1554,555,1715,123,161
14670,levle1_587.jpg,fore,Unspecified,0.0,0,302,1432,378,1547,76,115
14671,levle1_587.jpg,fore,Unspecified,0.0,0,1313,3294,1482,3432,169,138
14672,levle1_587.jpg,fore,Unspecified,0.0,0,1796,3248,1949,3378,153,130
14673,levle1_593.jpg,fore,Unspecified,0.0,0,1949,2405,2064,2535,115,130
14674,levle1_593.jpg,fore,Unspecified,0.0,0,1689,2566,1811,2696,122,130
14675,levle1_593.jpg,fore,Unspecified,0.0,0,1758,2420,1857,2497,99,77
14676,levle1_593.jpg,fore,Unspecified,0.0,0,1589,1968,1712,2060,123,92
14677,levle1_593.jpg,fore,Unspecified,0.0,0,2217,2497,2332,2596,115,99
14678,levle1_593.jpg,fore,Unspecified,0.0,0,2424,2014,2570,2152,146,138
14679,levle3_125.jpg,fore,Unspecified,0.0,0,100,98,120,113,20,15
14680,levle3_125.jpg,fore,Unspecified,0.0,0,185,83,198,95,13,12
14681,levle3_125.jpg,fore,Unspecified,0.0,0,177,95,193,111,16,16
14682,levle3_125.jpg,fore,Unspecified,0.0,0,143,133,158,150,15,17
14683,levle3_125.jpg,fore,Unspecified,0.0,0,70,117,88,129,18,12
14684,levle3_125.jpg,fore,Unspecified,0.0,0,15,115,35,130,20,15
14685,levle3_125.jpg,fore,Unspecified,0.0,0,219,204,236,222,17,18
14686,levle3_125.jpg,fore,Unspecified,0.0,0,13,189,20,197,7,8
14687,levle3_125.jpg,fore,Unspecified,0.0,0,129,63,146,80,17,17
14688,levle3_125.jpg,fore,Unspecified,0.0,0,145,81,159,95,14,14
14689,levle3_125.jpg,fore,Unspecified,0.0,0,161,67,172,80,11,13
14690,levle3_125.jpg,fore,Unspecified,0.0,0,165,50,178,61,13,11
14691,levle3_125.jpg,fore,Unspecified,0.0,0,174,53,183,67,9,14
14692,levle3_125.jpg,fore,Unspecified,0.0,0,199,93,207,106,8,13
14693,levle3_125.jpg,fore,Unspecified,0.0,0,208,90,224,104,16,14
14694,levle3_125.jpg,fore,Unspecified,0.0,0,202,112,222,127,20,15
14695,levle3_125.jpg,fore,Unspecified,0.0,0,184,121,197,130,13,9
14696,levle3_125.jpg,fore,Unspecified,0.0,0,175,129,194,143,19,14
14697,levle3_125.jpg,fore,Unspecified,0.0,0,192,132,210,147,18,15
14698,levle3_125.jpg,fore,Unspecified,0.0,0,210,152,222,166,12,14
14699,levle3_125.jpg,fore,Unspecified,0.0,0,188,156,199,165,11,9
14700,levle3_125.jpg,fore,Unspecified,0.0,0,181,150,189,158,8,8
14701,levle3_125.jpg,fore,Unspecified,0.0,0,169,147,181,154,12,7
14702,levle3_125.jpg,fore,Unspecified,0.0,0,158,158,171,169,13,11
14703,levle3_125.jpg,fore,Unspecified,0.0,0,123,138,131,147,8,9
14704,levle3_125.jpg,fore,Unspecified,0.0,0,137,167,148,177,11,10
14705,levle3_125.jpg,fore,Unspecified,0.0,0,77,76,87,86,10,10
14706,levle3_125.jpg,fore,Unspecified,0.0,0,90,136,101,148,11,12
14707,levle3_125.jpg,fore,Unspecified,0.0,0,101,139,112,152,11,13
14708,levle3_125.jpg,fore,Unspecified,0.0,0,107,160,118,169,11,9
14709,levle3_125.jpg,fore,Unspecified,0.0,0,117,176,128,186,11,10
14710,levle3_125.jpg,fore,Unspecified,0.0,0,119,186,127,196,8,10
14711,levle3_125.jpg,fore,Unspecified,0.0,0,156,183,170,195,14,12
14712,levle3_125.jpg,fore,Unspecified,0.0,0,146,195,159,206,13,11
14713,levle3_125.jpg,fore,Unspecified,0.0,0,148,204,157,218,9,14
14714,levle3_125.jpg,fore,Unspecified,0.0,0,158,201,163,210,5,9
14715,levle3_125.jpg,fore,Unspecified,0.0,0,176,215,185,224,9,9
14716,levle3_125.jpg,fore,Unspecified,0.0,0,192,192,200,200,8,8
14717,levle3_125.jpg,fore,Unspecified,0.0,0,188,214,196,222,8,8
14718,levle3_125.jpg,fore,Unspecified,0.0,0,201,211,213,225,12,14
14719,levle3_125.jpg,fore,Unspecified,0.0,0,134,200,147,217,13,17
14720,levle3_125.jpg,fore,Unspecified,0.0,0,140,182,153,193,13,11
14721,levle3_125.jpg,fore,Unspecified,0.0,0,124,227,137,239,13,12
14722,levle3_125.jpg,fore,Unspecified,0.0,0,149,236,164,252,15,16
14723,levle3_125.jpg,fore,Unspecified,0.0,0,131,250,147,271,16,21
14724,levle3_125.jpg,fore,Unspecified,0.0,0,96,251,112,268,16,17
14725,levle3_125.jpg,fore,Unspecified,0.0,0,63,223,77,243,14,20
14726,levle3_125.jpg,fore,Unspecified,0.0,0,64,158,76,171,12,13
14727,levle3_125.jpg,fore,Unspecified,0.0,0,46,124,55,135,9,11
14728,levle3_125.jpg,fore,Unspecified,0.0,0,44,141,57,154,13,13
14729,levle3_125.jpg,fore,Unspecified,0.0,0,14,172,27,182,13,10
14730,levle3_125.jpg,fore,Unspecified,0.0,0,38,203,51,217,13,14
14731,levle1_592.jpg,fore,Unspecified,0.0,0,1482,2972,1558,3102,76,130
14732,levle1_592.jpg,fore,Unspecified,0.0,0,1306,2941,1489,3079,183,138
14733,levle1_592.jpg,fore,Unspecified,0.0,0,1122,2918,1260,3102,138,184
14734,levle1_592.jpg,fore,Unspecified,0.0,0,892,2742,1099,2918,207,176
14735,levle1_592.jpg,fore,Unspecified,0.0,0,1206,3156,1321,3278,115,122
14736,levle1_592.jpg,fore,Unspecified,0.0,0,532,2397,670,2543,138,146
14737,levle3_124.jpg,fore,,,0,372,98,389,153,17,55
14738,levle3_124.jpg,fore,,,0,294,144,338,185,44,41
14739,levle3_124.jpg,fore,,,0,302,106,329,148,27,42
14740,levle3_124.jpg,fore,,,0,249,119,283,157,34,38
14741,levle3_124.jpg,fore,,,0,209,246,243,278,34,32
14742,levle3_124.jpg,fore,,,0,200,225,223,252,23,27
14743,levle3_124.jpg,fore,,,0,215,195,234,225,19,30
14744,levle3_124.jpg,fore,,,0,177,129,215,155,38,26
14745,levle3_124.jpg,fore,,,0,71,144,107,182,36,38
14746,levle3_124.jpg,fore,,,0,85,110,111,142,26,32
14747,levle3_124.jpg,fore,,,0,111,89,143,129,32,40
14748,levle3_124.jpg,fore,,,0,143,70,170,95,27,25
14749,levle3_124.jpg,fore,,,0,51,79,79,110,28,31
14750,levle3_124.jpg,fore,,,0,62,44,98,76,36,32
14751,levle3_124.jpg,fore,,,0,88,27,120,62,32,35
14752,levle3_124.jpg,fore,,,0,143,333,173,361,30,28
14753,levle3_124.jpg,fore,,,0,172,331,209,367,37,36
14754,levle3_124.jpg,fore,,,0,181,384,217,420,36,36
14755,levle3_124.jpg,fore,,,0,223,350,264,384,41,34
14756,levle3_124.jpg,fore,,,0,236,380,264,412,28,32
14757,levle3_124.jpg,fore,,,0,211,416,242,441,31,25
14758,levle3_124.jpg,fore,,,0,238,437,274,465,36,28
14759,levle3_124.jpg,fore,,,0,179,431,204,456,25,25
14760,levle3_124.jpg,fore,,,0,192,458,230,492,38,34
14761,levle3_124.jpg,fore,,,0,187,6,226,36,39,30
14762,levle3_124.jpg,fore,,,0,204,44,240,85,36,41
14763,levle3_124.jpg,fore,,,0,160,32,194,70,34,38
14764,levle3_124.jpg,fore,,,0,124,25,160,64,36,39
14765,levle3_124.jpg,fore,,,0,136,117,172,142,36,25
14766,levle3_124.jpg,fore,,,0,119,165,160,191,41,26
14767,levle3_124.jpg,fore,,,0,134,216,177,259,43,43
14768,levle3_124.jpg,fore,,,0,181,163,219,199,38,36
14769,levle3_124.jpg,fore,,,0,132,259,153,284,21,25
14770,levle3_124.jpg,fore,,,0,164,289,190,323,26,34
14771,levle3_124.jpg,fore,,,0,221,314,260,350,39,36
14772,levle3_124.jpg,fore,,,0,132,446,185,486,53,40
14773,levle3_124.jpg,fore,,,0,37,501,68,533,31,32
14774,levle3_124.jpg,fore,,,0,75,522,113,560,38,38
14775,levle3_124.jpg,fore,,,0,128,530,172,554,44,24
14776,levle3_124.jpg,fore,,,0,267,332,295,364,28,32
14777,levle3_124.jpg,fore,,,0,294,360,328,388,34,28
14778,levle3_124.jpg,fore,,,0,160,365,186,386,26,21
14779,levle3_124.jpg,fore,,,0,104,482,136,511,32,29
14780,levle3_124.jpg,fore,,,0,327,89,364,118,37,29
14781,levle3_124.jpg,fore,,,0,232,187,274,220,42,33
14782,levle3_124.jpg,fore,,,0,93,275,130,303,37,28
14783,levle3_124.jpg,fore,,,0,106,63,141,90,35,27
14784,levle3_124.jpg,fore,,,0,207,95,259,124,52,29
14785,levle3_124.jpg,fore,,,0,267,155,299,186,32,31
14786,levle3_124.jpg,fore,,,0,139,296,169,328,30,32
14787,levle3_124.jpg,fore,,,0,173,199,214,229,41,30
14788,levle3_124.jpg,fore,,,0,240,274,280,309,40,35
14789,levle3_124.jpg,fore,,,0,319,204,355,233,36,29
14790,levle3_124.jpg,fore,,,0,139,493,179,522,40,29
14791,levle3_124.jpg,fore,,,0,191,368,221,396,30,28
14792,levle3_124.jpg,fore,,,0,175,261,209,291,34,30
14793,levle3_124.jpg,fore,,,0,93,413,120,449,27,36
14794,levle3_130.jpg,fore,,,0,830,389,938,451,108,62
14795,levle3_130.jpg,fore,,,0,823,497,930,604,107,107
14796,levle3_130.jpg,fore,,,0,624,1853,715,1976,91,123
14797,levle3_130.jpg,fore,,,0,677,1991,761,2121,84,130
14798,levle3_130.jpg,fore,,,0,263,1922,463,2075,200,153
14799,levle3_130.jpg,fore,,,0,861,2550,968,2734,107,184
14800,levle3_130.jpg,fore,,,0,516,2581,692,2688,176,107
14801,levle3_130.jpg,fore,,,0,493,2420,647,2550,154,130
14802,levle3_130.jpg,fore,,,0,677,2259,800,2366,123,107
14803,levle3_130.jpg,fore,,,0,654,2688,800,2972,146,284
14804,levle3_130.jpg,fore,,,0,777,2857,938,3048,161,191
14805,levle3_130.jpg,fore,,,0,907,2865,1030,2941,123,76
14806,levle3_130.jpg,fore,,,0,976,2673,1122,2803,146,130
14807,levle3_130.jpg,fore,,,0,1106,2757,1306,2888,200,131
14808,levle3_130.jpg,fore,,,0,1137,2888,1191,2995,54,107
14809,levle3_130.jpg,fore,,,0,1160,3056,1283,3171,123,115
14810,levle3_130.jpg,fore,,,0,325,2244,424,2366,99,122
14811,levle3_130.jpg,fore,,,0,478,2152,662,2297,184,145
14812,levle3_130.jpg,fore,,,0,1037,2405,1137,2497,100,92
14813,levle3_130.jpg,fore,,,0,677,2412,853,2504,176,92
14814,levle3_130.jpg,fore,,,0,1283,1891,1359,2068,76,177
14815,levle3_130.jpg,fore,,,0,846,1171,999,1324,153,153
14816,levle3_130.jpg,fore,,,0,1589,780,1796,895,207,115
14817,levle3_130.jpg,fore,,,0,1696,972,1911,1148,215,176
14818,levle3_130.jpg,fore,,,0,991,313,1091,420,100,107
14819,levle3_130.jpg,fore,,,0,1114,228,1344,374,230,146
14820,levle3_130.jpg,fore,,,0,905,515,1022,619,117,104
14821,levle3_130.jpg,fore,,,0,1029,398,1129,491,100,93
14822,levle3_130.jpg,fore,,,0,1415,460,1533,539,118,79
14823,levle3_130.jpg,fore,,,0,1243,384,1395,481,152,97
14824,levle3_130.jpg,fore,,,0,1508,322,1591,405,83,83
14825,levle3_130.jpg,fore,,,0,833,912,974,1039,141,127
14826,levle3_130.jpg,fore,,,0,712,1060,891,1198,179,138
14827,levle3_130.jpg,fore,,,0,1902,832,1991,925,89,93
14828,levle3_130.jpg,fore,,,0,353,794,533,1001,180,207
14829,levle3_130.jpg,fore,,,0,467,543,636,681,169,138
14830,levle3_130.jpg,fore,,,0,533,1643,664,1750,131,107
14831,levle3_130.jpg,fore,,,0,477,1888,650,2005,173,117
14832,levle3_130.jpg,fore,,,0,998,1912,1212,2122,214,210
14833,levle3_130.jpg,fore,,,0,1681,3005,1822,3153,141,148
14834,levle3_130.jpg,fore,,,0,305,2539,443,2725,138,186
14835,levle3_130.jpg,fore,,,0,119,2198,267,2460,148,262
14836,levle3_130.jpg,fore,,,0,781,1919,977,2105,196,186
14837,levle3_130.jpg,fore,,,0,791,2101,1043,2325,252,224
14838,levle3_130.jpg,fore,,,0,1067,2136,1464,2367,397,231
14839,levle3_130.jpg,fore,,,0,1135,2370,1418,2632,283,262
14840,levle3_130.jpg,fore,,,0,577,2322,736,2460,159,138
14841,levle3_130.jpg,fore,,,0,1377,2891,1550,3050,173,159
14842,levle3_130.jpg,fore,,,0,1419,1857,1567,2108,148,251
14843,levle3_130.jpg,fore,,,0,1771,2246,1898,2381,127,135
14844,levle3_130.jpg,fore,,,0,1467,3160,1612,3301,145,141
14845,levle3_130.jpg,fore,,,0,1026,3119,1140,3250,114,131
14846,levle3_130.jpg,fore,,,0,936,2946,1126,3091,190,145
14847,levle1_586.jpg,fore,Unspecified,0.0,0,654,1194,761,1301,107,107
14848,levle1_586.jpg,fore,Unspecified,0.0,0,125,1462,256,1631,131,169
14849,levle1_586.jpg,fore,Unspecified,0.0,0,394,1999,516,2198,122,199
14850,levle1_586.jpg,fore,Unspecified,0.0,0,317,1278,463,1432,146,154
14851,levle1_586.jpg,fore,Unspecified,0.0,0,1053,635,1229,803,176,168
14852,levle1_586.jpg,fore,Unspecified,0.0,0,1336,589,1528,688,192,99
14853,levle1_586.jpg,fore,Unspecified,0.0,0,1765,811,1857,987,92,176
14854,levle1_586.jpg,fore,Unspecified,0.0,0,1650,1117,1857,1271,207,154
14855,levle1_586.jpg,fore,Unspecified,0.0,0,1260,3225,1382,3309,122,84
14856,levle1_586.jpg,fore,Unspecified,0.0,0,1114,3041,1329,3255,215,214
14857,levle1_586.jpg,fore,Unspecified,0.0,0,1459,2995,1581,3102,122,107
14858,levle1_586.jpg,fore,Unspecified,0.0,0,1689,3056,1873,3225,184,169
14859,levle3_118.jpg,fore,,,0,362,113,369,124,7,11
14860,levle3_118.jpg,fore,,,0,331,92,368,123,37,31
14861,levle3_118.jpg,fore,,,0,275,232,298,257,23,25
14862,levle3_118.jpg,fore,,,0,296,242,321,269,25,27
14863,levle3_118.jpg,fore,,,0,277,193,302,225,25,32
14864,levle3_118.jpg,fore,,,0,255,173,288,198,33,25
14865,levle3_118.jpg,fore,,,0,328,274,340,291,12,17
14866,levle3_118.jpg,fore,,,0,233,331,253,359,20,28
14867,levle3_118.jpg,fore,,,0,239,307,269,347,30,40
14868,levle3_118.jpg,fore,,,0,368,243,395,273,27,30
14869,levle3_118.jpg,fore,,,0,340,252,369,286,29,34
14870,levle3_118.jpg,fore,,,0,379,280,411,317,32,37
14871,levle3_118.jpg,fore,,,0,229,240,256,264,27,24
14872,levle3_118.jpg,fore,,,0,240,257,274,290,34,33
14873,levle3_118.jpg,fore,,,0,196,263,216,289,20,26
14874,levle3_118.jpg,fore,,,0,205,283,226,317,21,34
14875,levle3_118.jpg,fore,,,0,319,300,362,317,43,17
14876,levle3_118.jpg,fore,,,0,317,315,363,345,46,30
14877,levle3_118.jpg,fore,,,0,270,311,296,342,26,31
14878,levle3_118.jpg,fore,,,0,286,332,315,363,29,31
14879,levle3_118.jpg,fore,,,0,307,350,335,374,28,24
14880,levle3_118.jpg,fore,,,0,378,358,389,370,11,12
14881,levle3_118.jpg,fore,,,0,337,369,361,395,24,26
14882,levle3_118.jpg,fore,,,0,356,393,385,424,29,31
14883,levle3_118.jpg,fore,,,0,374,426,394,452,20,26
14884,levle3_118.jpg,fore,,,0,356,425,373,446,17,21
14885,levle3_118.jpg,fore,,,0,335,433,359,458,24,25
14886,levle3_118.jpg,fore,,,0,309,444,336,480,27,36
14887,levle3_118.jpg,fore,,,0,308,403,329,431,21,28
14888,levle3_118.jpg,fore,,,0,278,403,303,433,25,30
14889,levle3_118.jpg,fore,,,0,246,401,274,435,28,34
14890,levle3_118.jpg,fore,,,0,240,365,266,402,26,37
14891,levle3_118.jpg,fore,,,0,454,366,492,381,38,15
14892,levle3_118.jpg,fore,,,0,442,372,479,404,37,32
14893,levle3_118.jpg,fore,,,0,482,380,502,404,20,24
14894,levle3_118.jpg,fore,,,0,414,419,447,468,33,49
14895,levle3_118.jpg,fore,,,0,297,286,321,311,24,25
14896,levle3_118.jpg,fore,,,0,276,257,297,278,21,21
14897,levle3_118.jpg,fore,,,0,200,231,218,250,18,19
14898,levle3_118.jpg,fore,,,0,190,423,214,441,24,18
14899,levle3_118.jpg,fore,,,0,230,416,253,439,23,23
14900,levle3_118.jpg,fore,,,0,249,428,275,455,26,27
14901,levle3_118.jpg,fore,,,0,264,483,292,505,28,22
14902,levle3_118.jpg,fore,,,0,271,460,293,479,22,19
14903,levle3_118.jpg,fore,,,0,292,455,313,479,21,24
14904,levle3_118.jpg,fore,,,0,451,413,473,438,22,25
14905,levle3_118.jpg,fore,,,0,468,346,491,365,23,19
14906,levle3_118.jpg,fore,,,0,397,129,421,151,24,22
14907,levle3_118.jpg,fore,,,0,369,101,383,120,14,19
14908,levle3_118.jpg,fore,,,0,383,104,395,120,12,16
14909,levle3_118.jpg,fore,,,0,395,103,409,127,14,24
14910,levle3_118.jpg,fore,,,0,391,76,415,95,24,19
14911,levle3_118.jpg,fore,,,0,362,172,379,189,17,17
14912,levle3_118.jpg,fore,,,0,398,160,415,178,17,18
14913,levle3_118.jpg,fore,,,0,419,209,447,235,28,26
14914,levle3_118.jpg,fore,,,0,214,423,235,446,21,23
14915,levle3_118.jpg,fore,,,0,290,432,314,452,24,20
14916,levle3_118.jpg,fore,,,0,325,388,348,413,23,25
14917,levle3_118.jpg,fore,,,0,394,370,417,391,23,21
14918,levle3_118.jpg,fore,,,0,498,352,518,370,20,18
14919,levle3_118.jpg,fore,,,0,162,431,185,447,23,16
14920,levle3_118.jpg,fore,,,0,134,438,148,453,14,15
14921,levle3_118.jpg,fore,,,0,151,450,169,464,18,14
14922,levle3_118.jpg,fore,,,0,161,492,177,508,16,16
14923,levle3_118.jpg,fore,,,0,205,518,225,535,20,17
14924,levle1_551.jpg,fore,Unspecified,0.0,0,2256,1753,2394,1838,138,85
14925,levle1_551.jpg,fore,Unspecified,0.0,0,2156,1815,2271,1945,115,130
14926,levle1_551.jpg,fore,Unspecified,0.0,0,2286,1148,2486,1340,200,192
14927,levle1_551.jpg,fore,Unspecified,0.0,0,2463,1002,2562,1125,99,123
14928,levle1_551.jpg,fore,Unspecified,0.0,0,2555,964,2677,1094,122,130
14929,levle1_551.jpg,fore,Unspecified,0.0,0,2624,872,2754,987,130,115
14930,levle1_551.jpg,fore,Unspecified,0.0,0,2807,1240,2899,1332,92,92
14931,levle1_551.jpg,fore,Unspecified,0.0,0,2593,1148,2723,1309,130,161
14932,levle1_237.jpg,fore,Unspecified,0.0,0,1198,1861,1313,1960,115,99
14933,levle1_237.jpg,fore,Unspecified,0.0,0,1083,1638,1206,1715,123,77
14934,levle1_237.jpg,fore,Unspecified,0.0,0,1566,1891,1658,2022,92,131
14935,levle1_237.jpg,fore,Unspecified,0.0,0,1443,2075,1620,2175,177,100
14936,levle1_237.jpg,fore,Unspecified,0.0,0,1566,2297,1666,2428,100,131
14937,levle1_237.jpg,fore,Unspecified,0.0,0,1206,2566,1298,2704,92,138
14938,levle1_237.jpg,fore,Unspecified,0.0,0,1237,2734,1321,2819,84,85
14939,levle1_223.jpg,fore,Unspecified,0.0,0,1581,2911,1681,3010,100,99
14940,levle1_223.jpg,fore,Unspecified,0.0,0,1528,2489,1620,2619,92,130
14941,levle1_223.jpg,fore,Unspecified,0.0,0,1014,3056,1122,3232,108,176
14942,levle1_223.jpg,fore,Unspecified,0.0,0,1037,2949,1122,3033,85,84
14943,levle1_223.jpg,fore,Unspecified,0.0,0,1237,3148,1290,3263,53,115
14944,levle1_223.jpg,fore,Unspecified,0.0,0,1244,3010,1344,3133,100,123
14945,levle1_223.jpg,fore,Unspecified,0.0,0,1252,2834,1352,2926,100,92
14946,levle1_223.jpg,fore,Unspecified,0.0,0,1007,2857,1083,2911,76,54
14947,levle1_223.jpg,fore,Unspecified,0.0,0,930,2918,976,3002,46,84
14948,levle1_13.jpg,fore,Unspecified,0.0,0,199,384,223,413,24,29
14949,levle1_13.jpg,fore,Unspecified,0.0,0,230,349,255,382,25,33
14950,levle1_13.jpg,fore,Unspecified,0.0,0,139,311,162,332,23,21
14951,levle1_13.jpg,fore,Unspecified,0.0,0,144,275,163,295,19,20
14952,levle1_13.jpg,fore,Unspecified,0.0,0,64,136,86,153,22,17
14953,levle1_13.jpg,fore,Unspecified,0.0,0,160,74,184,100,24,26
14954,levle1_13.jpg,fore,Unspecified,0.0,0,204,130,223,156,19,26
14955,levle1_13.jpg,fore,Unspecified,0.0,0,172,339,190,360,18,21
14956,levle1_13.jpg,fore,Unspecified,0.0,0,176,362,198,381,22,19
14957,levle1_545.jpg,fore,Unspecified,0.0,0,1160,1117,1283,1232,123,115
14958,levle1_545.jpg,fore,Unspecified,0.0,0,1037,750,1175,872,138,122
14959,levle1_545.jpg,fore,Unspecified,0.0,0,1735,2290,1842,2412,107,122
14960,levle1_545.jpg,fore,Unspecified,0.0,0,1673,2144,1804,2282,131,138
14961,levle1_545.jpg,fore,Unspecified,0.0,0,1811,2520,1903,2635,92,115
14962,levle1_545.jpg,fore,Unspecified,0.0,0,2133,2504,2294,2665,161,161
14963,levle1_545.jpg,fore,Unspecified,0.0,0,2256,2343,2417,2466,161,123
14964,levle1_545.jpg,fore,Unspecified,0.0,0,1827,2979,1972,3125,145,146
14965,levle1_545.jpg,fore,Unspecified,0.0,0,2003,3025,2079,3140,76,115
14966,levle1_545.jpg,fore,Unspecified,0.0,0,2087,2995,2179,3087,92,92
14967,levle1_579.jpg,fore,Unspecified,0.0,0,1083,727,1214,834,131,107
14968,levle1_579.jpg,fore,Unspecified,0.0,0,1597,1393,1689,1524,92,131
14969,levle1_579.jpg,fore,Unspecified,0.0,0,332,2198,440,2366,108,168
14970,levle1_579.jpg,fore,Unspecified,0.0,0,125,2251,240,2428,115,177
14971,levle1_579.jpg,fore,Unspecified,0.0,0,271,2397,371,2550,100,153
14972,levle1_579.jpg,fore,Unspecified,0.0,0,555,2389,700,2527,145,138
14973,levle1_579.jpg,fore,Unspecified,0.0,0,624,2642,738,2865,114,223
14974,levle1_579.jpg,fore,Unspecified,0.0,0,953,2788,1114,2972,161,184
14975,levle1_579.jpg,fore,Unspecified,0.0,0,1214,2267,1428,2412,214,145
14976,levle1_579.jpg,fore,Unspecified,0.0,0,1451,2979,1604,3133,153,154
14977,levle2_135.jpg,fore,Unspecified,0.0,0,1942,3209,2018,3309,76,100
14978,levle2_135.jpg,fore,Unspecified,0.0,0,1857,3079,1965,3225,108,146
14979,levle2_135.jpg,fore,Unspecified,0.0,0,1459,2566,1543,2681,84,115
14980,levle2_135.jpg,fore,Unspecified,0.0,0,1313,2589,1436,2711,123,122
14981,levle2_135.jpg,fore,Unspecified,0.0,0,1244,2765,1397,2949,153,184
14982,levle2_135.jpg,fore,Unspecified,0.0,0,838,2872,961,3002,123,130
14983,levle2_135.jpg,fore,Unspecified,0.0,0,677,2773,807,2941,130,168
14984,levle2_135.jpg,fore,Unspecified,0.0,0,692,2627,784,2719,92,92
14985,levle2_135.jpg,fore,Unspecified,0.0,0,1129,2504,1206,2635,77,131
14986,levle2_135.jpg,fore,Unspecified,0.0,0,1336,2282,1443,2458,107,176
14987,levle2_135.jpg,fore,Unspecified,0.0,0,1152,2236,1260,2397,108,161
14988,levle2_135.jpg,fore,Unspecified,0.0,0,907,2297,1037,2458,130,161
14989,levle2_135.jpg,fore,Unspecified,0.0,0,1589,2167,1704,2282,115,115
14990,levle2_135.jpg,fore,Unspecified,0.0,0,562,857,685,979,123,122
14991,levle2_135.jpg,fore,Unspecified,0.0,0,853,681,915,796,62,115
14992,levle2_135.jpg,fore,Unspecified,0.0,0,1160,719,1275,864,115,145
14993,levle2_135.jpg,fore,Unspecified,0.0,0,1129,995,1244,1133,115,138
14994,levle2_135.jpg,fore,Unspecified,0.0,0,1719,1171,1842,1294,123,123
14995,levle2_135.jpg,fore,Unspecified,0.0,0,1604,1048,1750,1209,146,161
14996,levle2_135.jpg,fore,Unspecified,0.0,0,1589,1202,1719,1309,130,107
14997,levle2_135.jpg,fore,Unspecified,0.0,0,1375,987,1520,1110,145,123
14998,levle2_135.jpg,fore,Unspecified,0.0,0,1443,1960,1627,2121,184,161
14999,levle2_135.jpg,fore,Unspecified,0.0,0,2133,3102,2256,3148,123,46
15000,levle2_121.jpg,fore,,,0,899,1148,1099,1324,200,176
15001,levle2_121.jpg,fore,,,0,639,1424,830,1569,191,145
15002,levle2_121.jpg,fore,,,0,394,1455,616,1569,222,114
15003,levle2_121.jpg,fore,,,0,440,1569,601,1654,161,85
15004,levle2_121.jpg,fore,,,0,478,1654,654,1799,176,145
15005,levle2_121.jpg,fore,,,0,401,2267,547,2412,146,145
15006,levle2_121.jpg,fore,,,0,570,2359,708,2458,138,99
15007,levle2_121.jpg,fore,,,0,662,2543,830,2696,168,153
15008,levle2_121.jpg,fore,,,0,968,2627,1045,2773,77,146
15009,levle2_121.jpg,fore,,,0,1206,2642,1352,2727,146,85
15010,levle2_121.jpg,fore,,,0,1267,2727,1405,2842,138,115
15011,levle2_121.jpg,fore,,,0,1352,2911,1482,3056,130,145
15012,levle2_121.jpg,fore,,,0,1543,3179,1673,3294,130,115
15013,levle2_121.jpg,fore,,,0,1053,3163,1221,3309,168,146
15014,levle2_121.jpg,fore,,,0,1842,1041,1911,1156,69,115
15015,levle2_121.jpg,fore,,,0,1696,949,1804,1087,108,138
15016,levle2_121.jpg,fore,,,0,700,2121,861,2251,161,130
15017,levle2_121.jpg,fore,,,0,1076,2520,1191,2627,115,107
15018,levle2_121.jpg,fore,,,0,998,2815,1105,2919,107,104
15019,levle2_121.jpg,fore,,,0,660,2219,808,2360,148,141
15020,levle2_121.jpg,fore,,,0,833,1432,960,1546,127,114
15021,levle2_95.jpg,fore,,,0,3410,1538,3542,1634,132,96
15022,levle2_95.jpg,fore,,,0,3454,1625,3533,1783,79,158
15023,levle2_95.jpg,fore,,,0,3217,1538,3349,1634,132,96
15024,levle2_95.jpg,fore,,,0,3095,1564,3200,1678,105,114
15025,levle2_95.jpg,fore,,,0,2981,1617,3103,1722,122,105
15026,levle2_95.jpg,fore,,,0,3016,1704,3077,1792,61,88
15027,levle2_95.jpg,fore,,,0,3042,1748,3139,1862,97,114
15028,levle2_95.jpg,fore,,,0,3112,1880,3174,2003,62,123
15029,levle2_95.jpg,fore,,,0,3033,2029,3226,2125,193,96
15030,levle2_95.jpg,fore,,,0,2928,2020,3042,2152,114,132
15031,levle2_95.jpg,fore,,,0,2832,2152,2928,2257,96,105
15032,levle2_95.jpg,fore,,,0,3384,1880,3454,1985,70,105
15033,levle2_95.jpg,fore,,,0,3200,1836,3296,1941,96,105
15034,levle2_95.jpg,fore,,,0,3191,1897,3323,2064,132,167
15035,levle2_95.jpg,fore,,,0,3209,1678,3279,1739,70,61
15036,levle2_95.jpg,fore,,,0,3253,1722,3393,1827,140,105
15037,levle2_95.jpg,fore,,,0,2877,2388,2935,2463,58,75
15038,levle2_95.jpg,fore,,,0,3202,2093,3277,2180,75,87
15039,levle2_95.jpg,fore,,,0,2973,2213,3089,2343,116,130
15040,levle2_95.jpg,fore,,,0,3431,1801,3514,1876,83,75
15041,levle2_95.jpg,fore,,,0,3127,1718,3206,1809,79,91
15042,levle2_109.jpg,fore,Unspecified,0.0,0,1995,734,2110,872,115,138
15043,levle2_109.jpg,fore,Unspecified,0.0,0,2003,865,2141,1033,138,168
15044,levle2_109.jpg,fore,Unspecified,0.0,0,1719,2880,1888,2949,169,69
15045,levle2_109.jpg,fore,Unspecified,0.0,0,2463,2635,2624,2780,161,145
15046,levle2_109.jpg,fore,Unspecified,0.0,0,2034,2796,2202,2949,168,153
15047,levle2_109.jpg,fore,Unspecified,0.0,0,2095,2412,2263,2573,168,161
15048,levle2_109.jpg,fore,Unspecified,0.0,0,884,1983,1014,2091,130,108
15049,levle2_109.jpg,fore,Unspecified,0.0,0,1030,1907,1137,2052,107,145
15050,levle2_109.jpg,fore,Unspecified,0.0,0,1290,6,1535,213,245,207
15051,levle2_109.jpg,fore,Unspecified,0.0,0,1329,259,1497,466,168,207
15052,levle2_109.jpg,fore,Unspecified,0.0,0,1145,811,1244,941,99,130
15053,levle2_109.jpg,fore,Unspecified,0.0,0,1650,190,1758,343,108,153
15054,levle2_109.jpg,fore,Unspecified,0.0,0,2102,144,2187,251,85,107
15055,levle2_109.jpg,fore,Unspecified,0.0,0,2248,2098,2386,2290,138,192
15056,levle2_109.jpg,fore,Unspecified,0.0,0,2417,2091,2524,2206,107,115
15057,levle2_109.jpg,fore,Unspecified,0.0,0,2830,2313,2991,2451,161,138
15058,levle2_109.jpg,fore,Unspecified,0.0,0,2815,2520,2991,2612,176,92
15059,levle2_109.jpg,fore,Unspecified,0.0,0,2815,2650,2915,2719,100,69
15060,levle2_109.jpg,fore,Unspecified,0.0,0,2639,1799,2777,1945,138,146
15061,levle2_109.jpg,fore,Unspecified,0.0,0,2647,2068,2807,2213,160,145
15062,levle2_109.jpg,fore,Unspecified,0.0,0,1827,2995,1957,3064,130,69
15063,levle2_109.jpg,fore,Unspecified,0.0,0,1888,3087,2011,3240,123,153
15064,levle2_109.jpg,fore,Unspecified,0.0,0,2079,3156,2210,3248,131,92
15065,levle2_109.jpg,fore,Unspecified,0.0,0,2256,2995,2378,3094,122,99
15066,levle2_109.jpg,fore,Unspecified,0.0,0,2401,2972,2509,3056,108,84
15067,levle2_109.jpg,fore,Unspecified,0.0,0,2532,2834,2662,2956,130,122
15068,levle2_109.jpg,fore,Unspecified,0.0,0,1911,221,2072,374,161,153
15069,levle2_81.jpg,fore,,,0,1306,558,1466,642,160,84
15070,levle2_81.jpg,fore,,,0,1283,351,1558,535,275,184
15071,levle2_81.jpg,fore,,,0,1666,1769,1857,1891,191,122
15072,levle2_81.jpg,fore,,,0,1727,1953,1865,2083,138,130
15073,levle2_81.jpg,fore,,,0,1244,1792,1405,1899,161,107
15074,levle2_81.jpg,fore,,,0,2501,910,2608,1064,107,154
15075,levle2_81.jpg,fore,,,0,2792,1324,2884,1462,92,138
15076,levle2_81.jpg,fore,,,0,2325,1470,2539,1631,214,161
15077,levle2_81.jpg,fore,,,0,2179,1822,2317,1968,138,146
15078,levle2_81.jpg,fore,,,0,2263,2244,2463,2382,200,138
15079,levle2_81.jpg,fore,,,0,1819,2221,1965,2374,146,153
15080,levle2_81.jpg,fore,,,0,1788,2658,1926,2796,138,138
15081,levle2_81.jpg,fore,,,0,1712,3079,1903,3255,191,176
15082,levle2_81.jpg,fore,,,0,2401,2826,2555,2956,154,130
15083,levle2_81.jpg,fore,,,0,2578,2121,2739,2282,161,161
15084,levle2_81.jpg,fore,,,0,1091,765,1237,887,146,122
15085,levle2_81.jpg,fore,,,0,1244,1516,1397,1707,153,191
15086,levle2_81.jpg,fore,,,0,2112,1436,2243,1550,131,114
15087,levle2_81.jpg,fore,,,0,2019,2605,2236,2815,217,210
15088,levle2_81.jpg,fore,,,0,2164,2314,2347,2449,183,135
15089,levle2_81.jpg,fore,,,0,1381,743,1536,898,155,155
15090,levle0_226.jpg,fore,Unspecified,0.0,0,2507,1196,2612,1310,105,114
15091,levle0_226.jpg,fore,Unspecified,0.0,0,1700,1731,1849,1915,149,184
15092,levle0_232.jpg,fore,Unspecified,0.0,0,1873,1914,2049,2037,176,123
15093,levle2_56.jpg,fore,Unspecified,0.0,0,2691,1651,2824,1817,133,166
15094,levle2_56.jpg,fore,Unspecified,0.0,0,2733,1842,2874,1967,141,125
15095,levle2_56.jpg,fore,Unspecified,0.0,0,2808,1984,2966,2125,158,141
15096,levle2_56.jpg,fore,Unspecified,0.0,0,2392,1959,2525,2117,133,158
15097,levle2_56.jpg,fore,Unspecified,0.0,0,2434,2083,2550,2150,116,67
15098,levle2_56.jpg,fore,Unspecified,0.0,0,2134,1984,2242,2100,108,116
15099,levle2_56.jpg,fore,Unspecified,0.0,0,2226,2083,2301,2158,75,75
15100,levle2_56.jpg,fore,Unspecified,0.0,0,2242,2183,2425,2283,183,100
15101,levle2_56.jpg,fore,Unspecified,0.0,0,2309,2283,2425,2408,116,125
15102,levle2_56.jpg,fore,Unspecified,0.0,0,2234,2308,2292,2408,58,100
15103,levle2_56.jpg,fore,Unspecified,0.0,0,2151,2449,2251,2516,100,67
15104,levle2_56.jpg,fore,Unspecified,0.0,0,2259,2491,2367,2599,108,108
15105,levle2_56.jpg,fore,Unspecified,0.0,0,2367,2366,2542,2482,175,116
15106,levle2_56.jpg,fore,Unspecified,0.0,0,2700,2391,2833,2507,133,116
15107,levle2_56.jpg,fore,Unspecified,0.0,0,3074,2316,3173,2466,99,150
15108,levle2_56.jpg,fore,Unspecified,0.0,0,2907,2449,2966,2532,59,83
15109,levle2_56.jpg,fore,Unspecified,0.0,0,2891,2565,3065,2673,174,108
15110,levle2_56.jpg,fore,Unspecified,0.0,0,2700,2607,2874,2757,174,150
15111,levle2_56.jpg,fore,Unspecified,0.0,0,2816,2682,2899,2840,83,158
15112,levle2_56.jpg,fore,Unspecified,0.0,0,2966,2715,3090,2881,124,166
15113,levle2_56.jpg,fore,Unspecified,0.0,0,2982,2856,3099,3014,117,158
15114,levle2_56.jpg,fore,Unspecified,0.0,0,3647,2632,3772,2856,125,224
15115,levle2_56.jpg,fore,Unspecified,0.0,0,2508,2565,2650,2682,142,117
15116,levle2_56.jpg,fore,Unspecified,0.0,0,2542,2665,2625,2757,83,92
15117,levle2_56.jpg,fore,Unspecified,0.0,0,2600,2740,2725,2856,125,116
15118,levle2_42.jpg,fore,,,0,1482,2160,1589,2282,107,122
15119,levle2_42.jpg,fore,,,0,1658,2121,1781,2282,123,161
15120,levle2_42.jpg,fore,,,0,1735,2114,1934,2267,199,153
15121,levle2_42.jpg,fore,,,0,1781,2236,1988,2397,207,161
15122,levle2_42.jpg,fore,,,0,1635,2305,1742,2428,107,123
15123,levle2_42.jpg,fore,,,0,1627,2366,1773,2504,146,138
15124,levle2_42.jpg,fore,,,0,1712,2489,1850,2627,138,138
15125,levle2_42.jpg,fore,,,0,1781,2558,1896,2673,115,115
15126,levle2_42.jpg,fore,,,0,1888,2688,1972,2826,84,138
15127,levle2_42.jpg,fore,,,0,1972,2681,2133,2849,161,168
15128,levle2_42.jpg,fore,,,0,1903,2865,2057,3002,154,137
15129,levle2_42.jpg,fore,,,0,1290,3002,1474,3102,184,100
15130,levle2_42.jpg,fore,,,0,1474,2979,1666,3133,192,154
15131,levle2_42.jpg,fore,,,0,2202,2221,2302,2320,100,99
15132,levle2_42.jpg,fore,,,0,2271,2083,2417,2213,146,130
15133,levle2_42.jpg,fore,,,0,2256,2229,2409,2351,153,122
15134,levle2_42.jpg,fore,,,0,1957,2244,2133,2412,176,168
15135,levle2_42.jpg,fore,,,0,2064,2045,2233,2152,169,107
15136,levle2_42.jpg,fore,,,0,2095,1884,2233,2037,138,153
15137,levle2_42.jpg,fore,,,0,2263,1822,2470,2014,207,192
15138,levle2_42.jpg,fore,,,0,1957,2139,2088,2253,131,114
15139,levle0_391.jpg,fore,Unspecified,0.0,0,2478,2052,2624,2190,146,138
15140,levle0_391.jpg,fore,Unspecified,0.0,0,2386,1554,2539,1746,153,192
15141,levle1_182.jpg,fore,,,0,171,1432,309,1577,138,145
15142,levle1_182.jpg,fore,,,0,884,3018,1045,3194,161,176
15143,levle1_182.jpg,fore,,,0,1045,2842,1206,2979,161,137
15144,levle1_182.jpg,fore,,,0,1505,2888,1581,3033,76,145
15145,levle1_182.jpg,fore,,,0,1508,1970,1602,2053,94,83
15146,levle1_182.jpg,fore,,,0,267,2522,433,2639,166,117
15147,levle0_385.jpg,fore,Unspecified,0.0,0,1122,3125,1198,3232,76,107
15148,levle1_196.jpg,fore,Unspecified,0.0,0,2670,2098,2784,2236,114,138
15149,levle1_196.jpg,fore,Unspecified,0.0,0,1758,2466,1919,2604,161,138
15150,levle1_196.jpg,fore,Unspecified,0.0,0,2555,2612,2677,2765,122,153
15151,levle1_196.jpg,fore,Unspecified,0.0,0,2325,2313,2455,2443,130,130
15152,levle1_196.jpg,fore,Unspecified,0.0,0,1083,933,1260,1025,177,92
15153,levle1_196.jpg,fore,Unspecified,0.0,0,2478,2811,2639,3002,161,191
15154,levle1_196.jpg,fore,Unspecified,0.0,0,2486,2259,2624,2451,138,192
15155,levle0_90.jpg,fore,Unspecified,0.0,0,1903,2619,2102,2788,199,169
15156,levle0_90.jpg,fore,Unspecified,0.0,0,1459,3186,1604,3317,145,131
15157,levle1_141.jpg,fore,Unspecified,0.0,0,1106,1914,1221,2083,115,169
15158,levle1_141.jpg,fore,Unspecified,0.0,0,654,1807,823,1999,169,192
15159,levle1_141.jpg,fore,Unspecified,0.0,0,670,2052,792,2259,122,207
15160,levle1_141.jpg,fore,Unspecified,0.0,0,532,2083,677,2221,145,138
15161,levle1_141.jpg,fore,Unspecified,0.0,0,1336,2497,1505,2596,169,99
15162,levle1_141.jpg,fore,Unspecified,0.0,0,1612,987,1735,1110,123,123
15163,levle1_627.jpg,fore,Unspecified,0.0,0,578,1485,692,1592,114,107
15164,levle1_627.jpg,fore,Unspecified,0.0,0,279,2083,386,2259,107,176
15165,levle1_627.jpg,fore,Unspecified,0.0,0,486,2359,639,2481,153,122
15166,levle1_627.jpg,fore,Unspecified,0.0,0,509,2596,670,2696,161,100
15167,levle1_627.jpg,fore,Unspecified,0.0,0,493,2711,670,2895,177,184
15168,levle1_627.jpg,fore,Unspecified,0.0,0,677,2665,815,2796,138,131
15169,levle1_627.jpg,fore,Unspecified,0.0,0,792,2382,945,2520,153,138
15170,levle1_627.jpg,fore,Unspecified,0.0,0,991,2121,1145,2267,154,146
15171,levle1_627.jpg,fore,Unspecified,0.0,0,884,2918,1014,3048,130,130
15172,levle1_633.jpg,fore,Unspecified,0.0,0,1942,1815,2118,1976,176,161
15173,levle1_633.jpg,fore,Unspecified,0.0,0,2171,1692,2340,1776,169,84
15174,levle1_633.jpg,fore,Unspecified,0.0,0,2095,2320,2286,2458,191,138
15175,levle1_633.jpg,fore,Unspecified,0.0,0,2095,2796,2217,2949,122,153
15176,levle1_633.jpg,fore,Unspecified,0.0,0,2302,2734,2501,2865,199,131
15177,levle1_633.jpg,fore,Unspecified,0.0,0,1122,834,1229,987,107,153
15178,levle0_420.jpg,fore,Unspecified,0.0,0,1850,1592,1972,1715,122,123
15179,levle0_420.jpg,fore,Unspecified,0.0,0,2202,1079,2248,1194,46,115
15180,levle0_346.jpg,fore,Unspecified,0.0,0,815,1117,884,1225,69,108
15181,levle0_346.jpg,fore,Unspecified,0.0,0,1765,3117,1850,3171,85,54
15182,levle0_346.jpg,fore,Unspecified,0.0,0,1191,3202,1306,3317,115,115
15183,levle1_155.jpg,fore,,,0,1191,2213,1290,2343,99,130
15184,levle1_155.jpg,fore,,,0,1627,2336,1696,2466,69,130
15185,levle1_155.jpg,fore,,,0,1244,2535,1313,2650,69,115
15186,levle1_155.jpg,fore,,,0,1321,2719,1382,2826,61,107
15187,levle1_155.jpg,fore,,,0,1957,2229,2026,2328,69,99
15188,levle1_155.jpg,fore,,,0,1446,2946,1533,3019,87,73
15189,levle0_53.jpg,fore,Unspecified,0.0,0,2317,2336,2470,2535,153,199
15190,levle0_53.jpg,fore,Unspecified,0.0,0,2486,2428,2654,2627,168,199
15191,levle0_47.jpg,fore,Unspecified,0.0,0,869,1991,1030,2160,161,169
15192,levle0_47.jpg,fore,Unspecified,0.0,0,654,926,823,1048,169,122
15193,levle1_169.jpg,fore,Unspecified,0.0,0,1313,619,1428,734,115,115
15194,levle1_169.jpg,fore,Unspecified,0.0,0,1214,2343,1290,2481,76,138
15195,levle1_169.jpg,fore,Unspecified,0.0,0,1114,2497,1191,2627,77,130
15196,levle1_169.jpg,fore,Unspecified,0.0,0,1528,2627,1627,2711,99,84
15197,levle1_169.jpg,fore,Unspecified,0.0,0,907,2428,984,2543,77,115
15198,levle1_169.jpg,fore,Unspecified,0.0,0,1405,2397,1535,2543,130,146
15199,levle1_380.jpg,fore,Unspecified,0.0,0,1474,1891,1620,2037,146,146
15200,levle1_380.jpg,fore,Unspecified,0.0,0,1321,2290,1466,2405,145,115
15201,levle1_380.jpg,fore,Unspecified,0.0,0,1620,2175,1742,2313,122,138
15202,levle1_380.jpg,fore,Unspecified,0.0,0,1367,2412,1505,2527,138,115
15203,levle1_380.jpg,fore,Unspecified,0.0,0,1520,2750,1666,2872,146,122
15204,levle1_380.jpg,fore,Unspecified,0.0,0,2202,527,2332,681,130,154
15205,levle0_193.jpg,fore,Unspecified,0.0,0,2133,2497,2325,2612,192,115
15206,levle0_193.jpg,fore,Unspecified,0.0,0,2639,2566,2754,2750,115,184
15207,levle1_394.jpg,fore,Unspecified,0.0,0,18,1585,171,1730,153,145
15208,levle1_394.jpg,fore,Unspecified,0.0,0,156,1991,294,2114,138,123
15209,levle1_394.jpg,fore,Unspecified,0.0,0,210,2121,378,2251,168,130
15210,levle1_394.jpg,fore,Unspecified,0.0,0,286,2443,424,2573,138,130
15211,levle1_394.jpg,fore,Unspecified,0.0,0,401,2267,524,2397,123,130
15212,levle1_394.jpg,fore,Unspecified,0.0,0,723,2075,1022,2244,299,169
15213,levle1_394.jpg,fore,Unspecified,0.0,0,754,2259,930,2389,176,130
15214,levle1_394.jpg,fore,Unspecified,0.0,0,792,2481,976,2642,184,161
15215,levle1_394.jpg,fore,Unspecified,0.0,0,1137,2412,1260,2566,123,154
15216,levle1_394.jpg,fore,Unspecified,0.0,0,1175,2773,1298,2888,123,115
15217,levle1_394.jpg,fore,Unspecified,0.0,0,777,2880,945,3125,168,245
15218,levle1_394.jpg,fore,Unspecified,0.0,0,953,2918,1160,3186,207,268
15219,levle1_394.jpg,fore,Unspecified,0.0,0,1405,3125,1558,3286,153,161
15220,levle0_187.jpg,fore,Unspecified,0.0,0,1053,1830,1244,1991,191,161
15221,levle1_425.jpg,fore,Unspecified,0.0,0,1275,2137,1436,2290,161,153
15222,levle1_425.jpg,fore,Unspecified,0.0,0,1811,512,1988,719,177,207
15223,levle1_425.jpg,fore,Unspecified,0.0,0,1397,2642,1459,2819,62,177
15224,levle1_425.jpg,fore,Unspecified,0.0,0,1290,2757,1359,2888,69,131
15225,levle1_425.jpg,fore,Unspecified,0.0,0,1214,2520,1336,2704,122,184
15226,levle1_425.jpg,fore,Unspecified,0.0,0,731,1991,815,2121,84,130
15227,levle1_343.jpg,fore,Unspecified,0.0,0,1030,2512,1175,2696,145,184
15228,levle1_343.jpg,fore,Unspecified,0.0,0,1106,2351,1237,2497,131,146
15229,levle1_343.jpg,fore,Unspecified,0.0,0,930,2152,1114,2297,184,145
15230,levle1_343.jpg,fore,Unspecified,0.0,0,853,2320,1022,2412,169,92
15231,levle0_150.jpg,fore,Unspecified,0.0,0,1558,2121,1704,2282,146,161
15232,levle0_150.jpg,fore,Unspecified,0.0,0,1742,2052,1819,2152,77,100
15233,levle3_16.jpg,fore,,,0,375,290,415,328,40,38
15234,levle3_16.jpg,fore,,,0,364,249,417,296,53,47
15235,levle3_16.jpg,fore,,,0,244,308,293,339,49,31
15236,levle3_16.jpg,fore,,,0,228,361,266,412,38,51
15237,levle3_16.jpg,fore,,,0,275,367,317,379,42,12
15238,levle3_16.jpg,fore,,,0,291,398,322,426,31,28
15239,levle3_16.jpg,fore,,,0,201,414,234,447,33,33
15240,levle3_16.jpg,fore,,,0,258,420,291,441,33,21
15241,levle3_16.jpg,fore,,,0,326,383,370,420,44,37
15242,levle3_16.jpg,fore,,,0,277,430,322,471,45,41
15243,levle3_16.jpg,fore,,,0,315,420,364,459,49,39
15244,levle3_16.jpg,fore,,,0,307,457,348,492,41,35
15245,levle3_16.jpg,fore,,,0,303,490,342,528,39,38
15246,levle3_16.jpg,fore,,,0,279,502,319,545,40,43
15247,levle3_16.jpg,fore,,,0,262,545,305,585,43,40
15248,levle3_16.jpg,fore,,,0,262,581,293,616,31,35
15249,levle3_16.jpg,fore,,,0,324,555,348,583,24,28
15250,levle3_16.jpg,fore,,,0,340,594,368,624,28,30
15251,levle3_16.jpg,fore,,,0,299,600,336,636,37,36
15252,levle3_16.jpg,fore,,,0,360,622,413,667,53,45
15253,levle3_16.jpg,fore,,,0,360,551,399,579,39,28
15254,levle3_16.jpg,fore,,,0,389,577,421,614,32,37
15255,levle3_16.jpg,fore,,,0,430,563,466,604,36,41
15256,levle3_16.jpg,fore,,,0,458,545,491,581,33,36
15257,levle3_16.jpg,fore,,,0,391,706,424,743,33,37
15258,levle3_16.jpg,fore,,,0,491,592,523,641,32,49
15259,levle3_16.jpg,fore,,,0,577,547,607,590,30,43
15260,levle3_16.jpg,fore,,,0,560,594,597,630,37,36
15261,levle3_16.jpg,fore,,,0,503,483,542,518,39,35
15262,levle3_16.jpg,fore,,,0,534,457,583,504,49,47
15263,levle3_16.jpg,fore,,,0,528,524,593,573,65,49
15264,levle3_16.jpg,fore,,,0,381,386,419,430,38,44
15265,levle3_16.jpg,fore,,,0,401,386,452,434,51,48
15266,levle3_16.jpg,fore,,,0,428,351,477,394,49,43
15267,levle3_16.jpg,fore,,,0,479,351,507,388,28,37
15268,levle3_16.jpg,fore,,,0,493,394,523,430,30,36
15269,levle3_16.jpg,fore,,,0,528,375,562,416,34,41
15270,levle3_16.jpg,fore,,,0,558,373,607,424,49,51
15271,levle3_16.jpg,fore,,,0,452,402,499,459,47,57
15272,levle3_16.jpg,fore,,,0,397,469,470,528,73,59
15273,levle3_16.jpg,fore,,,0,430,608,462,655,32,47
15274,levle3_16.jpg,fore,,,0,542,559,585,598,43,39
15275,levle3_16.jpg,fore,,,0,482,88,528,138,46,50
15276,levle3_16.jpg,fore,,,0,309,349,355,380,46,31
15277,levle3_16.jpg,fore,,,0,247,440,278,481,31,41
15278,levle3_16.jpg,fore,,,0,420,684,458,716,38,32
15279,levle3_16.jpg,fore,,,0,256,482,304,512,48,30
15280,levle3_16.jpg,fore,,,0,496,335,535,374,39,39
15281,levle3_16.jpg,fore,,,0,541,327,589,367,48,40
15282,levle3_16.jpg,fore,,,0,444,727,478,757,34,30
15283,levle3_16.jpg,fore,,,0,419,722,446,753,27,31
15284,levle3_16.jpg,fore,,,0,357,674,396,716,39,42
15285,levle3_16.jpg,fore,,,0,526,666,558,697,32,31
15286,levle3_16.jpg,fore,,,0,472,628,509,670,37,42
15287,levle3_16.jpg,fore,,,0,316,224,352,266,36,42
15288,levle3_16.jpg,fore,,,0,438,246,479,276,41,30
15289,levle3_16.jpg,fore,,,0,325,522,360,558,35,36
15290,levle3_16.jpg,fore,,,0,337,492,365,523,28,31
15291,levle3_16.jpg,fore,,,0,360,466,393,507,33,41
15292,levle3_16.jpg,fore,,,0,360,518,403,555,43,37
15293,levle3_16.jpg,fore,,,0,386,437,419,474,33,37
15294,levle3_16.jpg,fore,,,0,422,430,457,476,35,46
15295,levle3_16.jpg,fore,,,0,492,441,539,482,47,41
15296,levle3_16.jpg,fore,,,0,529,429,565,456,36,27
15297,levle3_16.jpg,fore,,,0,410,534,460,564,50,30
15298,levle1_357.jpg,fore,Unspecified,0.0,0,1765,2297,1896,2443,131,146
15299,levle1_357.jpg,fore,Unspecified,0.0,0,1888,2412,2026,2550,138,138
15300,levle1_357.jpg,fore,Unspecified,0.0,0,1834,2619,1957,2780,123,161
15301,levle1_357.jpg,fore,Unspecified,0.0,0,1980,2796,2133,2972,153,176
15302,levle1_357.jpg,fore,Unspecified,0.0,0,2325,2443,2417,2612,92,169
15303,levle1_357.jpg,fore,Unspecified,0.0,0,2332,2290,2470,2397,138,107
15304,levle0_144.jpg,fore,Unspecified,0.0,0,2210,1922,2325,2045,115,123
15305,levle1_431.jpg,fore,Unspecified,0.0,0,2447,2466,2547,2596,100,130
15306,levle1_431.jpg,fore,Unspecified,0.0,0,2470,2604,2685,2819,215,215
15307,levle1_431.jpg,fore,Unspecified,0.0,0,1750,2834,1926,3010,176,176
15308,levle1_431.jpg,fore,Unspecified,0.0,0,1995,2796,2133,2895,138,99
15309,levle1_431.jpg,fore,Unspecified,0.0,0,2187,3171,2348,3332,161,161
15310,levle1_431.jpg,fore,Unspecified,0.0,0,1397,3002,1558,3117,161,115
15311,levle1_431.jpg,fore,Unspecified,0.0,0,1543,3317,1696,3455,153,138
15312,levle1_431.jpg,fore,Unspecified,0.0,0,1114,2098,1229,2236,115,138
15313,levle1_419.jpg,fore,Unspecified,0.0,0,1298,1209,1413,1363,115,154
15314,levle1_419.jpg,fore,Unspecified,0.0,0,2608,1960,2723,2121,115,161
15315,levle1_419.jpg,fore,Unspecified,0.0,0,2516,2428,2662,2589,146,161
15316,levle1_419.jpg,fore,Unspecified,0.0,0,2325,2297,2432,2458,107,161
15317,levle1_419.jpg,fore,Unspecified,0.0,0,2202,2374,2332,2512,130,138
15318,levle1_419.jpg,fore,Unspecified,0.0,0,2309,2550,2417,2696,108,146
15319,levle1_419.jpg,fore,Unspecified,0.0,0,2202,2750,2371,2911,169,161
15320,levle1_419.jpg,fore,Unspecified,0.0,0,1443,3110,1551,3240,108,130
15321,levle1_419.jpg,fore,Unspecified,0.0,0,1574,2627,1773,2834,199,207
15322,levle0_178.jpg,fore,Unspecified,0.0,0,1558,2819,1712,2972,154,153
15323,levle3_28.jpg,fore,,,0,50,238,62,247,12,9
15324,levle3_28.jpg,fore,,,0,57,249,66,262,9,13
15325,levle3_28.jpg,fore,,,0,77,240,85,249,8,9
15326,levle3_28.jpg,fore,,,0,79,227,87,239,8,12
15327,levle3_28.jpg,fore,,,0,90,221,100,233,10,12
15328,levle3_28.jpg,fore,,,0,118,224,131,239,13,15
15329,levle3_28.jpg,fore,,,0,101,219,110,233,9,14
15330,levle3_28.jpg,fore,,,0,110,244,124,254,14,10
15331,levle3_28.jpg,fore,,,0,22,140,36,152,14,12
15332,levle3_28.jpg,fore,,,0,21,154,32,168,11,14
15333,levle3_28.jpg,fore,,,0,115,187,120,193,5,6
15334,levle3_28.jpg,fore,,,0,106,185,117,200,11,15
15335,levle3_28.jpg,fore,,,0,111,208,124,223,13,15
15336,levle3_28.jpg,fore,,,0,127,182,139,202,12,20
15337,levle3_28.jpg,fore,,,0,46,161,70,177,24,16
15338,levle3_28.jpg,fore,,,0,84,62,93,73,9,11
15339,levle3_28.jpg,fore,,,0,88,50,106,64,18,14
15340,levle3_28.jpg,fore,,,0,74,36,91,51,17,15
15341,levle3_28.jpg,fore,,,0,36,73,54,86,18,13
15342,levle3_28.jpg,fore,,,0,54,40,66,53,12,13
15343,levle3_28.jpg,fore,,,0,44,53,55,71,11,18
15344,levle3_28.jpg,fore,,,0,85,168,102,185,17,17
15345,levle3_28.jpg,fore,,,0,78,186,97,194,19,8
15346,levle3_28.jpg,fore,,,0,83,192,100,205,17,13
15347,levle3_28.jpg,fore,,,0,88,204,106,218,18,14
15348,levle3_28.jpg,fore,,,0,69,200,88,214,19,14
15349,levle3_28.jpg,fore,,,0,74,214,88,230,14,16
15350,levle3_28.jpg,fore,,,0,45,191,64,205,19,14
15351,levle3_28.jpg,fore,,,0,48,230,67,240,19,10
15352,levle3_28.jpg,fore,,,0,92,247,110,266,18,19
15353,levle3_28.jpg,fore,,,0,111,90,127,104,16,14
15354,levle3_28.jpg,fore,,,0,93,85,104,94,11,9
15355,levle3_28.jpg,fore,,,0,99,93,108,102,9,9
15356,levle3_28.jpg,fore,,,0,55,70,67,82,12,12
15357,levle3_28.jpg,fore,,,0,40,218,50,228,10,10
15358,levle3_28.jpg,fore,,,0,47,213,56,223,9,10
15359,levle3_28.jpg,fore,,,0,59,212,73,223,14,11
15360,levle3_28.jpg,fore,,,0,73,251,83,259,10,8
15361,levle3_28.jpg,fore,,,0,83,255,94,263,11,8
15362,levle3_28.jpg,fore,,,0,77,264,86,271,9,7
15363,levle3_28.jpg,fore,,,0,76,259,84,267,8,8
15364,levle3_28.jpg,fore,,,0,69,261,76,269,7,8
15365,levle3_28.jpg,fore,,,0,70,270,80,278,10,8
15366,levle3_28.jpg,fore,,,0,60,267,71,276,11,9
15367,levle3_28.jpg,fore,,,0,69,178,80,188,11,10
15368,levle3_28.jpg,fore,,,0,77,83,88,93,11,10
15369,levle3_28.jpg,fore,,,0,84,80,95,91,11,11
15370,levle3_28.jpg,fore,,,0,110,105,121,117,11,12
15371,levle3_28.jpg,fore,,,0,91,36,105,47,14,11
15372,levle3_28.jpg,fore,,,0,25,199,39,208,14,9
15373,levle3_28.jpg,fore,,,0,17,193,29,203,12,10
15374,levle3_28.jpg,fore,,,0,43,139,55,147,12,8
15375,levle3_28.jpg,fore,,,0,56,182,65,191,9,9
15376,levle3_28.jpg,fore,,,0,73,169,87,182,14,13
15377,levle3_28.jpg,fore,,,0,36,242,47,255,11,13
15378,levle3_28.jpg,fore,,,0,38,233,48,241,10,8
15379,levle3_28.jpg,fore,,,0,135,202,148,217,13,15
15380,levle3_28.jpg,fore,,,0,36,212,45,220,9,8
15381,levle3_28.jpg,fore,,,0,66,223,76,236,10,13
15382,levle3_28.jpg,fore,,,0,33,154,47,170,14,16
15383,levle3_28.jpg,fore,,,0,37,146,51,157,14,11
15384,levle3_28.jpg,fore,,,0,106,70,117,82,11,12
15385,levle1_369.jpg,fore,Unspecified,0.0,0,1742,2711,1873,2811,131,100
15386,levle1_369.jpg,fore,Unspecified,0.0,0,1765,2819,1903,2941,138,122
15387,levle1_369.jpg,fore,Unspecified,0.0,0,1804,2926,1980,3041,176,115
15388,levle1_369.jpg,fore,Unspecified,0.0,0,1428,2865,1566,3002,138,137
15389,levle1_369.jpg,fore,Unspecified,0.0,0,1275,2826,1413,2964,138,138
15390,levle1_369.jpg,fore,Unspecified,0.0,0,1206,2704,1344,2834,138,130
15391,levle1_369.jpg,fore,Unspecified,0.0,0,784,2895,922,3048,138,153
15392,levle0_152.jpg,fore,Unspecified,0.0,0,1781,1953,1880,2068,99,115
15393,levle1_341.jpg,fore,Unspecified,0.0,0,2011,2297,2087,2412,76,115
15394,levle1_341.jpg,fore,Unspecified,0.0,0,1919,2022,2064,2098,145,76
15395,levle1_341.jpg,fore,Unspecified,0.0,0,1696,2244,1819,2428,123,184
15396,levle1_341.jpg,fore,Unspecified,0.0,0,1175,2888,1260,3064,85,176
15397,levle1_341.jpg,fore,Unspecified,0.0,0,884,2888,1007,3002,123,114
15398,levle1_341.jpg,fore,Unspecified,0.0,0,555,2343,731,2550,176,207
15399,levle1_341.jpg,fore,Unspecified,0.0,0,616,2175,815,2343,199,168
15400,levle1_341.jpg,fore,Unspecified,0.0,0,1873,2420,2026,2604,153,184
15401,levle1_427.jpg,fore,Unspecified,0.0,0,1742,1064,1865,1194,123,130
15402,levle1_427.jpg,fore,Unspecified,0.0,0,1359,811,1535,1010,176,199
15403,levle1_427.jpg,fore,Unspecified,0.0,0,1014,987,1198,1094,184,107
15404,levle1_427.jpg,fore,Unspecified,0.0,0,1742,2504,1827,2627,85,123
15405,levle1_427.jpg,fore,Unspecified,0.0,0,1965,2688,2072,2796,107,108
15406,levle1_427.jpg,fore,Unspecified,0.0,0,1528,3125,1666,3271,138,146
15407,levle1_427.jpg,fore,Unspecified,0.0,0,1420,2765,1497,2888,77,123
15408,levle1_427.jpg,fore,Unspecified,0.0,0,2348,2451,2478,2627,130,176
15409,levle1_427.jpg,fore,Unspecified,0.0,0,1152,1171,1206,1278,54,107
15410,levle1_427.jpg,fore,Unspecified,0.0,0,1543,2435,1658,2589,115,154
15411,levle1_433.jpg,fore,Unspecified,0.0,0,1405,3202,1528,3347,123,145
15412,levle1_433.jpg,fore,Unspecified,0.0,0,1459,2811,1604,2987,145,176
15413,levle1_433.jpg,fore,Unspecified,0.0,0,2248,2359,2432,2481,184,122
15414,levle1_433.jpg,fore,Unspecified,0.0,0,2317,2512,2501,2688,184,176
15415,levle1_433.jpg,fore,Unspecified,0.0,0,1160,1999,1298,2167,138,168
15416,levle1_433.jpg,fore,Unspecified,0.0,0,976,1945,1106,2083,130,138
15417,levle0_146.jpg,fore,Unspecified,0.0,0,1957,2949,2095,3079,138,130
15418,levle0_146.jpg,fore,Unspecified,0.0,0,1474,2336,1612,2466,138,130
15419,levle0_146.jpg,fore,Unspecified,0.0,0,1443,2451,1612,2604,169,153
15420,levle1_355.jpg,fore,Unspecified,0.0,0,1842,1807,1995,1937,153,130
15421,levle1_355.jpg,fore,Unspecified,0.0,0,2110,1807,2279,1953,169,146
15422,levle1_355.jpg,fore,Unspecified,0.0,0,2171,2022,2325,2144,154,122
15423,levle1_355.jpg,fore,Unspecified,0.0,0,2133,2129,2279,2320,146,191
15424,levle1_355.jpg,fore,Unspecified,0.0,0,2018,2206,2118,2320,100,114
15425,levle1_355.jpg,fore,Unspecified,0.0,0,2003,2029,2102,2167,99,138
15426,levle1_355.jpg,fore,Unspecified,0.0,0,1995,1140,2125,1309,130,169
15427,levle3_14.jpg,fore,,,0,599,341,652,414,53,73
15428,levle3_14.jpg,fore,,,0,440,318,489,383,49,65
15429,levle3_14.jpg,fore,,,0,399,353,436,386,37,33
15430,levle3_14.jpg,fore,,,0,366,377,401,410,35,33
15431,levle3_14.jpg,fore,,,0,383,406,399,445,16,39
15432,levle3_14.jpg,fore,,,0,415,412,452,449,37,37
15433,levle3_14.jpg,fore,,,0,399,437,432,469,33,32
15434,levle3_14.jpg,fore,,,0,468,441,517,500,49,59
15435,levle3_14.jpg,fore,,,0,426,467,464,500,38,33
15436,levle3_14.jpg,fore,,,0,432,508,468,547,36,39
15437,levle3_14.jpg,fore,,,0,462,494,491,534,29,40
15438,levle3_14.jpg,fore,,,0,366,514,405,539,39,25
15439,levle3_14.jpg,fore,,,0,373,565,407,606,34,41
15440,levle3_14.jpg,fore,,,0,342,567,377,606,35,39
15441,levle3_14.jpg,fore,,,0,350,541,377,573,27,32
15442,levle3_14.jpg,fore,,,0,354,604,393,661,39,57
15443,levle3_14.jpg,fore,,,0,322,641,364,685,42,44
15444,levle3_14.jpg,fore,,,0,332,683,375,732,43,49
15445,levle3_14.jpg,fore,,,0,277,645,328,700,51,55
15446,levle3_14.jpg,fore,,,0,222,577,244,614,22,37
15447,levle3_14.jpg,fore,,,0,246,587,279,620,33,33
15448,levle3_14.jpg,fore,,,0,275,610,297,641,22,31
15449,levle3_14.jpg,fore,,,0,258,553,275,590,17,37
15450,levle3_14.jpg,fore,,,0,262,532,301,571,39,39
15451,levle3_14.jpg,fore,,,0,309,561,332,610,23,49
15452,levle3_14.jpg,fore,,,0,289,496,328,528,39,32
15453,levle3_14.jpg,fore,,,0,342,465,389,530,47,65
15454,levle3_14.jpg,fore,,,0,328,396,364,428,36,32
15455,levle3_14.jpg,fore,,,0,297,455,344,490,47,35
15456,levle3_14.jpg,fore,,,0,236,477,295,541,59,64
15457,levle3_14.jpg,fore,,,0,297,381,324,432,27,51
15458,levle3_14.jpg,fore,,,0,252,363,305,404,53,41
15459,levle3_14.jpg,fore,,,0,228,363,256,418,28,55
15460,levle3_14.jpg,fore,,,0,228,330,271,371,43,41
15461,levle3_14.jpg,fore,,,0,222,267,252,296,30,29
15462,levle3_14.jpg,fore,,,0,244,235,307,286,63,51
15463,levle3_14.jpg,fore,,,0,199,430,228,459,29,29
15464,levle3_14.jpg,fore,,,0,256,394,295,451,39,57
15465,levle3_14.jpg,fore,,,0,342,359,378,394,36,35
15466,levle3_14.jpg,fore,,,0,382,670,425,706,43,36
15467,levle3_14.jpg,fore,,,0,383,726,419,764,36,38
15468,levle3_14.jpg,fore,,,0,367,744,403,779,36,35
15469,levle3_14.jpg,fore,,,0,340,745,373,787,33,42
15470,levle3_14.jpg,fore,,,0,399,526,439,568,40,42
15471,levle3_14.jpg,fore,,,0,301,320,339,358,38,38
15472,levle3_14.jpg,fore,,,0,193,374,232,416,39,42
15473,levle3_14.jpg,fore,,,0,226,292,258,323,32,31
15474,levle3_14.jpg,fore,,,0,251,304,294,348,43,44
15475,levle3_14.jpg,fore,,,0,329,610,371,652,42,42
15476,levle3_14.jpg,fore,,,0,514,382,556,427,42,45
15477,levle3_14.jpg,fore,,,0,275,574,312,613,37,39
15478,levle3_14.jpg,fore,,,0,503,563,551,594,48,31
15479,levle3_14.jpg,fore,,,0,407,773,450,812,43,39
15480,levle3_14.jpg,fore,,,0,551,370,602,432,51,62
15481,levle3_14.jpg,fore,,,0,527,436,579,476,52,40
15482,levle1_382.jpg,fore,Unspecified,0.0,0,938,2535,1076,2704,138,169
15483,levle1_382.jpg,fore,Unspecified,0.0,0,1045,2696,1168,2811,123,115
15484,levle1_382.jpg,fore,Unspecified,0.0,0,1106,2796,1244,2926,138,130
15485,levle1_382.jpg,fore,Unspecified,0.0,0,769,2121,876,2274,107,153
15486,levle1_382.jpg,fore,Unspecified,0.0,0,876,2343,1007,2466,131,123
15487,levle1_382.jpg,fore,Unspecified,0.0,0,486,2152,616,2244,130,92
15488,levle1_382.jpg,fore,Unspecified,0.0,0,501,2259,608,2374,107,115
15489,levle1_382.jpg,fore,Unspecified,0.0,0,501,2619,601,2734,100,115
15490,levle1_382.jpg,fore,Unspecified,0.0,0,432,2711,532,2811,100,100
15491,levle1_382.jpg,fore,Unspecified,0.0,0,662,2895,807,3033,145,138
15492,levle0_185.jpg,fore,Unspecified,0.0,0,2585,2160,2723,2328,138,168
15493,levle0_185.jpg,fore,Unspecified,0.0,0,1083,2466,1290,2635,207,169
15494,levle0_185.jpg,fore,Unspecified,0.0,0,1758,2259,1934,2443,176,184
15495,levle1_396.jpg,fore,Unspecified,0.0,0,2440,2083,2624,2206,184,123
15496,levle1_396.jpg,fore,Unspecified,0.0,0,2478,2213,2670,2343,192,130
15497,levle1_396.jpg,fore,Unspecified,0.0,0,2003,2221,2156,2366,153,145
15498,levle1_396.jpg,fore,Unspecified,0.0,0,1489,2374,1658,2481,169,107
15499,levle1_396.jpg,fore,Unspecified,0.0,0,1696,2949,1911,3117,215,168
15500,levle1_396.jpg,fore,Unspecified,0.0,0,1505,3094,1643,3209,138,115
15501,levle0_51.jpg,fore,Unspecified,0.0,0,1520,2497,1612,2627,92,130
15502,levle0_51.jpg,fore,Unspecified,0.0,0,1681,2627,1727,2719,46,92
15503,levle0_51.jpg,fore,Unspecified,0.0,0,1735,2520,1888,2612,153,92
15504,levle0_51.jpg,fore,Unspecified,0.0,0,1819,2688,1965,2826,146,138
15505,levle1_619.jpg,fore,Unspecified,0.0,0,677,2267,807,2366,130,99
15506,levle1_619.jpg,fore,Unspecified,0.0,0,539,2274,654,2397,115,123
15507,levle1_619.jpg,fore,Unspecified,0.0,0,1390,2489,1535,2589,145,100
15508,levle1_619.jpg,fore,Unspecified,0.0,0,1382,2704,1505,2811,123,107
15509,levle1_619.jpg,fore,Unspecified,0.0,0,1183,2803,1298,2926,115,123
15510,levle1_619.jpg,fore,Unspecified,0.0,0,1053,2834,1168,2964,115,130
15511,levle1_619.jpg,fore,Unspecified,0.0,0,1673,2842,1788,2934,115,92
15512,levle1_619.jpg,fore,Unspecified,0.0,0,1512,2911,1673,3010,161,99
15513,levle1_619.jpg,fore,Unspecified,0.0,0,1336,2888,1451,3010,115,122
15514,levle1_619.jpg,fore,Unspecified,0.0,0,1076,3232,1214,3355,138,123
15515,levle1_619.jpg,fore,Unspecified,0.0,0,1405,3156,1505,3255,100,99
15516,levle1_619.jpg,fore,Unspecified,0.0,0,1505,3255,1597,3393,92,138
15517,levle1_619.jpg,fore,Unspecified,0.0,0,1604,3179,1719,3294,115,115
15518,levle1_619.jpg,fore,Unspecified,0.0,0,1650,3294,1788,3409,138,115
15519,levle1_619.jpg,fore,Unspecified,0.0,0,1750,3117,1888,3179,138,62
15520,levle1_619.jpg,fore,Unspecified,0.0,0,1773,3202,1911,3309,138,107
15521,levle1_619.jpg,fore,Unspecified,0.0,0,1788,2964,1896,3071,108,107
15522,levle0_378.jpg,fore,Unspecified,0.0,0,1673,1217,1781,1340,108,123
15523,levle0_378.jpg,fore,Unspecified,0.0,0,1099,2405,1260,2527,161,122
15524,levle0_45.jpg,fore,Unspecified,0.0,0,1543,3033,1742,3255,199,222
15525,levle0_45.jpg,fore,Unspecified,0.0,0,1934,2382,2026,2474,92,92
15526,levle0_436.jpg,fore,Unspecified,0.0,0,1045,2964,1160,3048,115,84
15527,levle1_625.jpg,fore,Unspecified,0.0,0,2463,2397,2509,2481,46,84
15528,levle1_625.jpg,fore,Unspecified,0.0,0,2524,2313,2654,2428,130,115
15529,levle1_625.jpg,fore,Unspecified,0.0,0,2539,2520,2654,2642,115,122
15530,levle1_625.jpg,fore,Unspecified,0.0,0,2662,2650,2823,2811,161,161
15531,levle1_625.jpg,fore,Unspecified,0.0,0,2194,2934,2340,3025,146,91
15532,levle1_625.jpg,fore,Unspecified,0.0,0,2011,3025,2156,3133,145,108
15533,levle1_625.jpg,fore,Unspecified,0.0,0,1903,2972,2018,3071,115,99
15534,levle1_625.jpg,fore,Unspecified,0.0,0,1857,2788,2018,2941,161,153
15535,levle1_625.jpg,fore,Unspecified,0.0,0,1888,2566,2011,2681,123,115
15536,levle1_625.jpg,fore,Unspecified,0.0,0,1796,2481,1911,2589,115,108
15537,levle1_625.jpg,fore,Unspecified,0.0,0,1750,3048,1888,3156,138,108
15538,levle1_625.jpg,fore,Unspecified,0.0,0,1957,3133,2041,3248,84,115
15539,levle1_625.jpg,fore,Unspecified,0.0,0,2041,3225,2164,3347,123,122
15540,levle1_625.jpg,fore,Unspecified,0.0,0,1788,3332,1873,3393,85,61
15541,levle1_625.jpg,fore,Unspecified,0.0,0,1589,3041,1712,3202,123,161
15542,levle1_625.jpg,fore,Unspecified,0.0,0,991,3202,1122,3370,131,168
15543,levle1_625.jpg,fore,Unspecified,0.0,0,1313,2627,1405,2734,92,107
15544,levle1_625.jpg,fore,Unspecified,0.0,0,2248,1294,2348,1439,100,145
15545,levle1_625.jpg,fore,Unspecified,0.0,0,1206,1439,1344,1623,138,184
15546,levle1_625.jpg,fore,Unspecified,0.0,0,1160,1010,1306,1125,146,115
15547,levle1_143.jpg,fore,Unspecified,0.0,0,1505,1508,1689,1654,184,146
15548,levle1_143.jpg,fore,Unspecified,0.0,0,2187,1784,2355,1914,168,130
15549,levle1_143.jpg,fore,Unspecified,0.0,0,1367,1861,1505,1999,138,138
15550,levle1_143.jpg,fore,Unspecified,0.0,0,2639,1730,2784,1861,145,131
15551,levle1_143.jpg,fore,Unspecified,0.0,0,2784,1815,2930,1937,146,122
15552,levle1_143.jpg,fore,Unspecified,0.0,0,2394,2435,2585,2566,191,131
15553,levle1_143.jpg,fore,Unspecified,0.0,0,1528,1922,1673,2052,145,130
15554,levle0_350.jpg,fore,Unspecified,0.0,0,2057,1715,2148,1876,91,161
15555,levle1_157.jpg,fore,Unspecified,0.0,0,1183,2297,1306,2397,123,100
15556,levle1_157.jpg,fore,Unspecified,0.0,0,1122,2382,1206,2474,84,92
15557,levle1_157.jpg,fore,Unspecified,0.0,0,1689,1945,1788,2014,99,69
15558,levle1_157.jpg,fore,Unspecified,0.0,0,1375,2481,1459,2581,84,100
15559,levle1_157.jpg,fore,Unspecified,0.0,0,1773,2911,1888,3033,115,122
15560,levle1_157.jpg,fore,Unspecified,0.0,0,1528,2734,1666,2826,138,92
15561,levle1_157.jpg,fore,Unspecified,0.0,0,1313,2949,1397,3041,84,92
15562,levle1_157.jpg,fore,Unspecified,0.0,0,1375,3018,1443,3125,68,107
15563,levle1_157.jpg,fore,Unspecified,0.0,0,1489,3064,1612,3163,123,99
15564,levle0_79.jpg,fore,Unspecified,0.0,0,1835,1169,2026,1385,191,216
15565,levle0_79.jpg,fore,Unspecified,0.0,0,1652,2341,1810,2466,158,125
15566,levle0_422.jpg,fore,Unspecified,0.0,0,1152,1278,1267,1409,115,131
15567,levle0_422.jpg,fore,Unspecified,0.0,0,1221,3133,1352,3240,131,107
15568,levle1_631.jpg,fore,Unspecified,0.0,0,2340,1815,2470,1884,130,69
15569,levle1_631.jpg,fore,Unspecified,0.0,0,2378,1999,2562,2152,184,153
15570,levle1_631.jpg,fore,Unspecified,0.0,0,2677,2190,2769,2313,92,123
15571,levle1_631.jpg,fore,Unspecified,0.0,0,2823,2114,2907,2328,84,214
15572,levle1_631.jpg,fore,Unspecified,0.0,0,2424,2773,2555,2849,131,76
15573,levle1_631.jpg,fore,Unspecified,0.0,0,2240,2857,2478,3048,238,191
15574,levle0_92.jpg,fore,Unspecified,0.0,0,555,2152,761,2282,206,130
15575,levle0_92.jpg,fore,Unspecified,0.0,0,601,1907,784,2121,183,214
15576,levle0_86.jpg,fore,Unspecified,0.0,0,2301,2258,2442,2449,141,191
15577,levle1_180.jpg,fore,,,0,1842,2573,1926,2757,84,184
15578,levle1_180.jpg,fore,,,0,1980,2612,2148,2765,168,153
15579,levle1_180.jpg,fore,,,0,1420,3025,1566,3194,146,169
15580,levle1_180.jpg,fore,,,0,2191,1353,2346,1470,155,117
15581,levle1_180.jpg,fore,,,0,1446,1288,1526,1357,80,69
15582,levle1_180.jpg,fore,,,0,1350,1332,1433,1405,83,73
15583,levle0_393.jpg,fore,Unspecified,0.0,0,2125,1953,2363,2152,238,199
15584,levle1_194.jpg,fore,Unspecified,0.0,0,1819,359,1957,512,138,153
15585,levle1_194.jpg,fore,Unspecified,0.0,0,1367,566,1482,750,115,184
15586,levle1_194.jpg,fore,Unspecified,0.0,0,1558,1868,1681,2022,123,154
15587,levle1_194.jpg,fore,Unspecified,0.0,0,1443,1999,1581,2160,138,161
15588,levle1_194.jpg,fore,Unspecified,0.0,0,1106,2504,1260,2627,154,123
15589,levle1_194.jpg,fore,Unspecified,0.0,0,1436,2780,1543,2934,107,154
15590,levle1_194.jpg,fore,Unspecified,0.0,0,1681,1822,1850,1953,169,131
15591,levle1_194.jpg,fore,Unspecified,0.0,0,1581,3025,1727,3117,146,92
15592,levle1_194.jpg,fore,Unspecified,0.0,0,2003,2857,2125,3048,122,191
15593,levle1_194.jpg,fore,Unspecified,0.0,0,2125,872,2286,1018,161,146
15594,levle0_387.jpg,fore,Unspecified,0.0,0,1727,3002,1911,3133,184,131
15595,levle2_54.jpg,fore,Unspecified,0.0,0,3190,1061,3431,1286,241,225
15596,levle2_54.jpg,fore,Unspecified,0.0,0,3248,679,3398,911,150,232
15597,levle2_54.jpg,fore,Unspecified,0.0,0,3065,463,3223,637,158,174
15598,levle2_54.jpg,fore,Unspecified,0.0,0,3015,321,3182,463,167,142
15599,levle2_54.jpg,fore,Unspecified,0.0,0,2991,712,3157,853,166,141
15600,levle2_54.jpg,fore,Unspecified,0.0,0,2808,413,2974,537,166,124
15601,levle2_54.jpg,fore,Unspecified,0.0,0,2616,1909,2741,2092,125,183
15602,levle2_54.jpg,fore,Unspecified,0.0,0,2542,2075,2733,2208,191,133
15603,levle2_54.jpg,fore,Unspecified,0.0,0,2583,2158,2741,2308,158,150
15604,levle2_54.jpg,fore,Unspecified,0.0,0,2425,2208,2567,2391,142,183
15605,levle2_54.jpg,fore,Unspecified,0.0,0,2583,2299,2675,2408,92,109
15606,levle2_54.jpg,fore,Unspecified,0.0,0,2450,1950,2525,2133,75,183
15607,levle2_54.jpg,fore,Unspecified,0.0,0,2035,1792,2193,1934,158,142
15608,levle2_54.jpg,fore,Unspecified,0.0,0,2159,1884,2259,2017,100,133
15609,levle2_54.jpg,fore,Unspecified,0.0,0,1968,1892,2068,2009,100,117
15610,levle2_54.jpg,fore,Unspecified,0.0,0,1918,1984,2110,2133,192,149
15611,levle2_54.jpg,fore,Unspecified,0.0,0,2126,2100,2276,2250,150,150
15612,levle2_54.jpg,fore,Unspecified,0.0,0,2176,2341,2284,2432,108,91
15613,levle2_54.jpg,fore,Unspecified,0.0,0,2159,2482,2317,2599,158,117
15614,levle2_54.jpg,fore,Unspecified,0.0,0,2118,1086,2209,1227,91,141
15615,levle2_54.jpg,fore,Unspecified,0.0,0,2251,1826,2434,1992,183,166
15616,levle2_54.jpg,fore,Unspecified,0.0,0,2276,1992,2459,2191,183,199
15617,levle0_218.jpg,fore,Unspecified,0.0,0,1099,3255,1283,3424,184,169
15618,levle0_218.jpg,fore,Unspecified,0.0,0,578,2075,738,2251,160,176
15619,levle2_40.jpg,fore,,,0,976,2014,1060,2114,84,100
15620,levle2_40.jpg,fore,,,0,309,2313,524,2466,215,153
15621,levle2_40.jpg,fore,,,0,56,2251,164,2435,108,184
15622,levle2_40.jpg,fore,,,0,95,2198,294,2382,199,184
15623,levle2_40.jpg,fore,,,0,240,1976,340,2106,100,130
15624,levle2_40.jpg,fore,,,0,148,1876,279,2006,131,130
15625,levle2_40.jpg,fore,,,0,10,1822,187,2037,177,215
15626,levle2_40.jpg,fore,,,0,118,1715,340,1830,222,115
15627,levle2_40.jpg,fore,,,0,110,1623,248,1738,138,115
15628,levle2_40.jpg,fore,,,0,156,1547,325,1700,169,153
15629,levle2_40.jpg,fore,,,0,141,1416,240,1531,99,115
15630,levle2_40.jpg,fore,,,0,286,1340,447,1439,161,99
15631,levle2_40.jpg,fore,,,0,95,1194,225,1309,130,115
15632,levle2_40.jpg,fore,,,0,225,1125,386,1301,161,176
15633,levle2_40.jpg,fore,,,0,1229,596,1352,727,123,131
15634,levle2_40.jpg,fore,,,0,1313,865,1505,1110,192,245
15635,levle2_40.jpg,fore,,,0,1099,3140,1214,3278,115,138
15636,levle2_40.jpg,fore,,,0,539,2244,731,2389,192,145
15637,levle2_40.jpg,fore,,,0,884,2274,1007,2489,123,215
15638,levle2_40.jpg,fore,,,0,386,1133,547,1370,161,237
15639,levle2_40.jpg,fore,,,0,1233,381,1336,488,103,107
15640,levle0_224.jpg,fore,Unspecified,0.0,0,95,105,107,125,12,20
15641,levle0_224.jpg,fore,Unspecified,0.0,0,59,110,76,120,17,10
15642,levle0_224.jpg,fore,Unspecified,0.0,0,136,119,155,136,19,17
15643,levle2_68.jpg,fore,Unspecified,0.0,0,2841,1942,2949,2108,108,166
15644,levle2_68.jpg,fore,Unspecified,0.0,0,2018,1950,2134,2092,116,142
15645,levle2_68.jpg,fore,Unspecified,0.0,0,2035,1826,2242,1975,207,149
15646,levle2_68.jpg,fore,Unspecified,0.0,0,2567,1551,2683,1643,116,92
15647,levle2_68.jpg,fore,Unspecified,0.0,0,3398,1003,3531,1186,133,183
15648,levle2_68.jpg,fore,Unspecified,0.0,0,1902,1776,2043,1867,141,91
15649,levle2_68.jpg,fore,Unspecified,0.0,0,1844,1876,1968,2000,124,124
15650,levle2_68.jpg,fore,Unspecified,0.0,0,2284,1934,2400,2025,116,91
15651,levle2_68.jpg,fore,Unspecified,0.0,0,2193,2042,2309,2167,116,125
15652,levle2_68.jpg,fore,Unspecified,0.0,0,2484,1643,2592,1817,108,174
15653,levle2_68.jpg,fore,Unspecified,0.0,0,2575,1826,2733,1934,158,108
15654,levle2_68.jpg,fore,Unspecified,0.0,0,2916,1759,3032,1892,116,133
15655,levle2_68.jpg,fore,Unspecified,0.0,0,2891,2150,3032,2283,141,133
15656,levle2_68.jpg,fore,Unspecified,0.0,0,3099,2092,3215,2241,116,149
15657,levle2_68.jpg,fore,Unspecified,0.0,0,2766,2740,2916,2881,150,141
15658,levle2_68.jpg,fore,Unspecified,0.0,0,3099,2715,3223,2865,124,150
15659,levle2_68.jpg,fore,Unspecified,0.0,0,3148,2840,3315,3014,167,174
15660,levle0_230.jpg,fore,Unspecified,0.0,0,2348,1240,2455,1370,107,130
15661,levle0_230.jpg,fore,Unspecified,0.0,0,2034,2412,2156,2596,122,184
15662,levle0_230.jpg,fore,Unspecified,0.0,0,2501,2389,2708,2596,207,207
15663,levle2_97.jpg,fore,Unspecified,0.0,0,1543,543,1620,681,77,138
15664,levle2_97.jpg,fore,Unspecified,0.0,0,1620,933,1765,1117,145,184
15665,levle2_97.jpg,fore,Unspecified,0.0,0,1919,895,2049,1018,130,123
15666,levle2_97.jpg,fore,Unspecified,0.0,0,1995,704,2087,834,92,130
15667,levle2_97.jpg,fore,Unspecified,0.0,0,907,1286,968,1470,61,184
15668,levle2_97.jpg,fore,Unspecified,0.0,0,800,1746,991,1922,191,176
15669,levle2_97.jpg,fore,Unspecified,0.0,0,654,1953,830,2091,176,138
15670,levle2_97.jpg,fore,Unspecified,0.0,0,1834,1692,1942,1853,108,161
15671,levle2_97.jpg,fore,Unspecified,0.0,0,1620,1715,1765,1861,145,146
15672,levle2_97.jpg,fore,Unspecified,0.0,0,1191,2190,1382,2351,191,161
15673,levle2_97.jpg,fore,Unspecified,0.0,0,1581,2849,1696,2995,115,146
15674,levle2_97.jpg,fore,Unspecified,0.0,0,1367,3056,1474,3217,107,161
15675,levle2_97.jpg,fore,Unspecified,0.0,0,1597,3209,1773,3378,176,169
15676,levle2_97.jpg,fore,Unspecified,0.0,0,968,2773,1152,2941,184,168
15677,levle2_97.jpg,fore,Unspecified,0.0,0,677,2872,838,3033,161,161
15678,levle2_97.jpg,fore,Unspecified,0.0,0,869,2612,1099,2734,230,122
15679,levle2_97.jpg,fore,Unspecified,0.0,0,838,2397,984,2566,146,169
15680,levle2_97.jpg,fore,Unspecified,0.0,0,945,2343,1106,2504,161,161
15681,levle2_97.jpg,fore,Unspecified,0.0,0,1091,2458,1275,2642,184,184
15682,levle2_97.jpg,fore,Unspecified,0.0,0,501,2320,624,2489,123,169
15683,levle2_97.jpg,fore,Unspecified,0.0,0,647,2443,800,2604,153,161
15684,levle2_97.jpg,fore,Unspecified,0.0,0,2225,2014,2363,2190,138,176
15685,levle2_97.jpg,fore,Unspecified,0.0,0,1275,1907,1443,2075,168,168
15686,levle2_97.jpg,fore,Unspecified,0.0,0,731,2114,1106,2328,375,214
15687,levle2_83.jpg,fore,,,0,1367,1815,1474,1953,107,138
15688,levle2_83.jpg,fore,,,0,1451,3071,1604,3217,153,146
15689,levle2_83.jpg,fore,,,0,1819,512,1911,650,92,138
15690,levle2_83.jpg,fore,,,0,1520,290,1681,420,161,130
15691,levle2_83.jpg,fore,,,0,1604,711,1773,895,169,184
15692,levle2_83.jpg,fore,,,0,156,1485,294,1654,138,169
15693,levle2_83.jpg,fore,,,0,746,2198,876,2351,130,153
15694,levle2_83.jpg,fore,,,0,815,2068,1037,2251,222,183
15695,levle2_83.jpg,fore,,,0,1068,2144,1290,2297,222,153
15696,levle2_83.jpg,fore,,,0,1091,1876,1206,2014,115,138
15697,levle2_83.jpg,fore,,,0,1581,1792,1735,1999,154,207
15698,levle2_83.jpg,fore,,,0,1758,1700,1934,1891,176,191
15699,levle2_83.jpg,fore,,,0,478,2573,647,2757,169,184
15700,levle2_83.jpg,fore,,,0,539,2865,723,3064,184,199
15701,levle2_83.jpg,fore,,,0,1566,2213,1750,2343,184,130
15702,levle2_83.jpg,fore,,,0,1045,520,1229,688,184,168
15703,levle2_83.jpg,fore,,,0,1390,481,1520,658,130,177
15704,levle2_83.jpg,fore,,,0,754,1884,884,2052,130,168
15705,levle2_83.jpg,fore,,,0,360,2670,560,2815,200,145
15706,levle2_83.jpg,fore,,,0,1046,2291,1205,2432,159,141
15707,levle2_83.jpg,fore,,,0,1922,1919,2033,2053,111,134
15708,levle2_137.jpg,fore,Unspecified,0.0,0,325,1692,486,1838,161,146
15709,levle2_137.jpg,fore,Unspecified,0.0,0,340,1845,493,1953,153,108
15710,levle2_137.jpg,fore,Unspecified,0.0,0,486,1769,624,1899,138,130
15711,levle2_137.jpg,fore,Unspecified,0.0,0,692,1838,807,1960,115,122
15712,levle2_137.jpg,fore,Unspecified,0.0,0,562,1968,677,2114,115,146
15713,levle2_137.jpg,fore,Unspecified,0.0,0,493,2114,616,2206,123,92
15714,levle2_137.jpg,fore,Unspecified,0.0,0,601,2167,700,2274,99,107
15715,levle2_137.jpg,fore,Unspecified,0.0,0,654,2236,784,2382,130,146
15716,levle2_137.jpg,fore,Unspecified,0.0,0,861,1999,968,2114,107,115
15717,levle2_137.jpg,fore,Unspecified,0.0,0,915,2244,1030,2359,115,115
15718,levle2_137.jpg,fore,Unspecified,0.0,0,1137,2328,1290,2451,153,123
15719,levle2_137.jpg,fore,Unspecified,0.0,0,1083,2566,1252,2711,169,145
15720,levle2_137.jpg,fore,Unspecified,0.0,0,999,2742,1137,2857,138,115
15721,levle2_137.jpg,fore,Unspecified,0.0,0,853,2642,945,2788,92,146
15722,levle2_137.jpg,fore,Unspecified,0.0,0,830,2803,915,2911,85,108
15723,levle2_137.jpg,fore,Unspecified,0.0,0,1076,2949,1252,3094,176,145
15724,levle2_137.jpg,fore,Unspecified,0.0,0,1252,2819,1397,2903,145,84
15725,levle2_137.jpg,fore,Unspecified,0.0,0,1267,2895,1459,2995,192,100
15726,levle2_137.jpg,fore,Unspecified,0.0,0,1283,3018,1436,3163,153,145
15727,levle2_137.jpg,fore,Unspecified,0.0,0,1298,3156,1459,3240,161,84
15728,levle2_137.jpg,fore,Unspecified,0.0,0,1512,3133,1589,3232,77,99
15729,levle2_137.jpg,fore,Unspecified,0.0,0,1620,3033,1750,3179,130,146
15730,levle2_137.jpg,fore,Unspecified,0.0,0,1819,2895,1980,3056,161,161
15731,levle2_137.jpg,fore,Unspecified,0.0,0,1535,1638,1635,1730,100,92
15732,levle2_137.jpg,fore,Unspecified,0.0,0,930,2420,1114,2573,184,153
15733,levle2_123.jpg,fore,Unspecified,0.0,0,220,88,241,107,21,19
15734,levle2_123.jpg,fore,Unspecified,0.0,0,207,57,222,78,15,21
15735,levle2_123.jpg,fore,Unspecified,0.0,0,245,55,273,79,28,24
15736,levle2_123.jpg,fore,Unspecified,0.0,0,253,93,275,114,22,21
15737,levle2_123.jpg,fore,Unspecified,0.0,0,200,175,221,196,21,21
15738,levle2_123.jpg,fore,Unspecified,0.0,0,187,150,206,172,19,22
15739,levle2_123.jpg,fore,Unspecified,0.0,0,186,81,206,95,20,14
15740,levle2_123.jpg,fore,Unspecified,0.0,0,151,72,174,95,23,23
15741,levle2_123.jpg,fore,Unspecified,0.0,0,116,83,145,108,29,25
15742,levle2_123.jpg,fore,Unspecified,0.0,0,38,119,57,146,19,27
15743,levle2_123.jpg,fore,Unspecified,0.0,0,82,173,96,191,14,18
15744,levle2_123.jpg,fore,Unspecified,0.0,0,107,224,129,248,22,24
15745,levle2_123.jpg,fore,Unspecified,0.0,0,72,234,92,260,20,26
15746,levle2_123.jpg,fore,Unspecified,0.0,0,19,254,41,270,22,16
15747,levle2_123.jpg,fore,Unspecified,0.0,0,42,267,63,285,21,18
15748,levle2_123.jpg,fore,Unspecified,0.0,0,197,276,225,300,28,24
15749,levle2_123.jpg,fore,Unspecified,0.0,0,212,315,232,355,20,40
15750,levle2_123.jpg,fore,Unspecified,0.0,0,233,335,261,355,28,20
15751,levle2_123.jpg,fore,Unspecified,0.0,0,258,323,280,354,22,31
15752,levle2_123.jpg,fore,Unspecified,0.0,0,195,391,220,412,25,21
15753,levle2_123.jpg,fore,Unspecified,0.0,0,213,365,244,388,31,23
15754,levle2_123.jpg,fore,Unspecified,0.0,0,142,394,165,414,23,20
15755,levle2_123.jpg,fore,Unspecified,0.0,0,118,344,138,359,20,15
15756,levle2_123.jpg,fore,Unspecified,0.0,0,51,405,73,422,22,17
15757,levle2_123.jpg,fore,Unspecified,0.0,0,36,415,67,444,31,29
15758,levle1_209.jpg,fore,Unspecified,0.0,0,455,2504,539,2604,84,100
15759,levle1_209.jpg,fore,Unspecified,0.0,0,570,2596,631,2734,61,138
15760,levle1_209.jpg,fore,Unspecified,0.0,0,677,2558,769,2696,92,138
15761,levle1_209.jpg,fore,Unspecified,0.0,0,777,2581,884,2742,107,161
15762,levle1_209.jpg,fore,Unspecified,0.0,0,953,2956,1099,3125,146,169
15763,levle1_209.jpg,fore,Unspecified,0.0,0,555,2888,624,2995,69,107
15764,levle1_39.jpg,fore,Unspecified,0.0,0,922,504,1114,612,192,108
15765,levle1_39.jpg,fore,Unspecified,0.0,0,930,612,1099,742,169,130
15766,levle1_39.jpg,fore,Unspecified,0.0,0,1995,1891,2217,2068,222,177
15767,levle1_39.jpg,fore,Unspecified,0.0,0,2233,1976,2363,2114,130,138
15768,levle1_39.jpg,fore,Unspecified,0.0,0,1926,2106,2095,2267,169,161
15769,levle1_39.jpg,fore,Unspecified,0.0,0,1781,2121,1926,2259,145,138
15770,levle1_39.jpg,fore,Unspecified,0.0,0,1589,2129,1735,2251,146,122
15771,levle1_39.jpg,fore,Unspecified,0.0,0,1666,2412,1811,2558,145,146
15772,levle1_39.jpg,fore,Unspecified,0.0,0,1873,2359,2026,2535,153,176
15773,levle1_39.jpg,fore,Unspecified,0.0,0,2049,2351,2156,2558,107,207
15774,levle1_39.jpg,fore,Unspecified,0.0,0,1489,2711,1643,2819,154,108
15775,levle1_235.jpg,fore,,,0,1306,727,1405,887,99,160
15776,levle1_235.jpg,fore,,,0,1965,1416,2072,1508,107,92
15777,levle1_235.jpg,fore,,,0,1283,2167,1390,2313,107,146
15778,levle1_235.jpg,fore,,,0,1321,2474,1413,2604,92,130
15779,levle1_235.jpg,fore,,,0,2064,1684,2179,1868,115,184
15780,levle1_235.jpg,fore,,,0,1488,1701,1581,1787,93,86
15781,levle1_553.jpg,fore,Unspecified,0.0,0,1888,765,1995,872,107,107
15782,levle1_553.jpg,fore,Unspecified,0.0,0,1627,780,1704,887,77,107
15783,levle1_553.jpg,fore,Unspecified,0.0,0,1329,2389,1459,2466,130,77
15784,levle1_553.jpg,fore,Unspecified,0.0,0,1244,803,1359,941,115,138
15785,levle1_553.jpg,fore,Unspecified,0.0,0,961,1148,968,1163,7,15
15786,levle1_553.jpg,fore,Unspecified,0.0,0,884,1041,961,1148,77,107
15787,levle1_553.jpg,fore,Unspecified,0.0,0,1007,964,1145,1102,138,138
15788,levle1_553.jpg,fore,Unspecified,0.0,0,838,811,945,972,107,161
15789,levle1_553.jpg,fore,Unspecified,0.0,0,493,1455,616,1669,123,214
15790,levle1_553.jpg,fore,Unspecified,0.0,0,501,1868,585,2014,84,146
15791,levle1_553.jpg,fore,Unspecified,0.0,0,1037,2229,1160,2343,123,114
15792,levle1_11.jpg,fore,Unspecified,0.0,0,75,254,96,272,21,18
15793,levle1_11.jpg,fore,Unspecified,0.0,0,119,301,140,321,21,20
15794,levle1_11.jpg,fore,Unspecified,0.0,0,110,316,128,338,18,22
15795,levle1_11.jpg,fore,Unspecified,0.0,0,64,226,80,245,16,19
15796,levle1_11.jpg,fore,Unspecified,0.0,0,80,223,96,244,16,21
15797,levle1_11.jpg,fore,Unspecified,0.0,0,88,212,105,225,17,13
15798,levle1_11.jpg,fore,Unspecified,0.0,0,59,184,78,200,19,16
15799,levle1_11.jpg,fore,Unspecified,0.0,0,108,176,123,192,15,16
15800,levle1_11.jpg,fore,Unspecified,0.0,0,161,185,184,205,23,20
15801,levle1_11.jpg,fore,Unspecified,0.0,0,138,215,164,242,26,27
15802,levle1_11.jpg,fore,Unspecified,0.0,0,173,231,199,248,26,17
15803,levle1_11.jpg,fore,Unspecified,0.0,0,195,197,209,217,14,20
15804,levle1_11.jpg,fore,Unspecified,0.0,0,133,168,148,192,15,24
15805,levle1_11.jpg,fore,Unspecified,0.0,0,137,280,166,304,29,24
15806,levle1_11.jpg,fore,Unspecified,0.0,0,165,252,187,273,22,21
15807,levle1_11.jpg,fore,Unspecified,0.0,0,149,255,164,272,15,17
15808,levle1_547.jpg,fore,Unspecified,0.0,0,846,1110,1022,1309,176,199
15809,levle1_547.jpg,fore,Unspecified,0.0,0,976,1010,1099,1087,123,77
15810,levle1_547.jpg,fore,Unspecified,0.0,0,1704,1799,1811,1899,107,100
15811,levle1_547.jpg,fore,Unspecified,0.0,0,1765,1968,1873,2098,108,130
15812,levle1_547.jpg,fore,Unspecified,0.0,0,1436,1968,1574,2152,138,184
15813,levle1_547.jpg,fore,Unspecified,0.0,0,1145,1815,1252,1976,107,161
15814,levle1_221.jpg,fore,Unspecified,0.0,0,2325,1309,2455,1439,130,130
15815,levle1_221.jpg,fore,Unspecified,0.0,0,922,1937,1030,2060,108,123
15816,levle1_221.jpg,fore,Unspecified,0.0,0,1306,696,1451,826,145,130
15817,levle1_221.jpg,fore,Unspecified,0.0,0,1160,887,1267,1025,107,138
15818,levle1_221.jpg,fore,Unspecified,0.0,0,1420,489,1482,596,62,107
15819,levle1_221.jpg,fore,Unspecified,0.0,0,2501,1355,2624,1501,123,146
15820,levle1_221.jpg,fore,Unspecified,0.0,0,2486,1707,2601,1830,115,123
15821,levle1_221.jpg,fore,Unspecified,0.0,0,2601,1784,2739,1861,138,77
15822,levle1_221.jpg,fore,Unspecified,0.0,0,2570,1845,2700,1968,130,123
15823,levle1_221.jpg,fore,Unspecified,0.0,0,2616,1983,2693,2098,77,115
15824,levle1_221.jpg,fore,Unspecified,0.0,0,2547,2221,2616,2428,69,207
15825,levle1_221.jpg,fore,Unspecified,0.0,0,2348,1439,2501,1600,153,161
15826,levle3_126.jpg,fore,Unspecified,0.0,0,593,78,620,93,27,15
15827,levle3_126.jpg,fore,Unspecified,0.0,0,588,92,622,127,34,35
15828,levle3_126.jpg,fore,Unspecified,0.0,0,612,199,637,225,25,26
15829,levle3_126.jpg,fore,Unspecified,0.0,0,598,156,623,180,25,24
15830,levle3_126.jpg,fore,Unspecified,0.0,0,458,153,488,178,30,25
15831,levle3_126.jpg,fore,Unspecified,0.0,0,520,200,550,233,30,33
15832,levle3_126.jpg,fore,Unspecified,0.0,0,521,251,546,278,25,27
15833,levle3_126.jpg,fore,Unspecified,0.0,0,517,162,534,183,17,21
15834,levle3_126.jpg,fore,Unspecified,0.0,0,497,80,516,111,19,31
15835,levle3_126.jpg,fore,Unspecified,0.0,0,411,98,427,131,16,33
15836,levle3_126.jpg,fore,Unspecified,0.0,0,414,177,456,208,42,31
15837,levle3_126.jpg,fore,Unspecified,0.0,0,347,46,366,64,19,18
15838,levle3_126.jpg,fore,Unspecified,0.0,0,292,18,314,39,22,21
15839,levle3_126.jpg,fore,Unspecified,0.0,0,271,95,306,104,35,9
15840,levle3_126.jpg,fore,Unspecified,0.0,0,209,47,248,74,39,27
15841,levle3_126.jpg,fore,Unspecified,0.0,0,173,86,203,112,30,26
15842,levle3_126.jpg,fore,Unspecified,0.0,0,143,135,173,162,30,27
15843,levle3_126.jpg,fore,Unspecified,0.0,0,97,153,136,195,39,42
15844,levle3_126.jpg,fore,Unspecified,0.0,0,75,242,112,266,37,24
15845,levle3_126.jpg,fore,Unspecified,0.0,0,8,233,18,254,10,21
15846,levle3_126.jpg,fore,Unspecified,0.0,0,112,285,139,314,27,29
15847,levle3_126.jpg,fore,Unspecified,0.0,0,143,241,168,273,25,32
15848,levle3_126.jpg,fore,Unspecified,0.0,0,168,214,199,246,31,32
15849,levle3_126.jpg,fore,Unspecified,0.0,0,199,201,220,223,21,22
15850,levle3_126.jpg,fore,Unspecified,0.0,0,221,228,238,253,17,25
15851,levle3_126.jpg,fore,Unspecified,0.0,0,189,257,215,281,26,24
15852,levle3_126.jpg,fore,Unspecified,0.0,0,205,279,240,308,35,29
15853,levle3_126.jpg,fore,Unspecified,0.0,0,211,317,235,341,24,24
15854,levle3_126.jpg,fore,Unspecified,0.0,0,145,361,171,390,26,29
15855,levle3_126.jpg,fore,Unspecified,0.0,0,286,292,324,330,38,38
15856,levle3_126.jpg,fore,Unspecified,0.0,0,324,311,350,344,26,33
15857,levle3_126.jpg,fore,Unspecified,0.0,0,355,297,388,326,33,29
15858,levle3_126.jpg,fore,Unspecified,0.0,0,293,336,327,366,34,30
15859,levle3_126.jpg,fore,Unspecified,0.0,0,338,348,359,377,21,29
15860,levle3_126.jpg,fore,Unspecified,0.0,0,303,213,324,246,21,33
15861,levle3_126.jpg,fore,Unspecified,0.0,0,335,191,373,214,38,23
15862,levle3_126.jpg,fore,Unspecified,0.0,0,370,239,401,273,31,34
15863,levle3_126.jpg,fore,Unspecified,0.0,0,399,333,428,361,29,28
15864,levle3_126.jpg,fore,Unspecified,0.0,0,439,225,467,261,28,36
15865,levle3_126.jpg,fore,Unspecified,0.0,0,443,281,467,313,24,32
15866,levle3_126.jpg,fore,Unspecified,0.0,0,360,444,386,473,26,29
15867,levle3_126.jpg,fore,Unspecified,0.0,0,405,442,428,467,23,25
15868,levle3_126.jpg,fore,Unspecified,0.0,0,445,426,480,464,35,38
15869,levle3_126.jpg,fore,Unspecified,0.0,0,459,396,479,418,20,22
15870,levle3_126.jpg,fore,Unspecified,0.0,0,472,359,498,387,26,28
15871,levle3_126.jpg,fore,Unspecified,0.0,0,490,396,517,425,27,29
15872,levle3_126.jpg,fore,Unspecified,0.0,0,333,383,372,416,39,33
15873,levle3_126.jpg,fore,Unspecified,0.0,0,527,293,549,325,22,32
15874,levle3_126.jpg,fore,Unspecified,0.0,0,325,147,371,180,46,33
15875,levle3_126.jpg,fore,Unspecified,0.0,0,290,134,321,157,31,23
15876,levle3_126.jpg,fore,Unspecified,0.0,0,373,109,412,139,39,30
15877,levle3_126.jpg,fore,Unspecified,0.0,0,253,127,272,145,19,18
15878,levle3_126.jpg,fore,Unspecified,0.0,0,205,91,236,116,31,25
15879,levle3_126.jpg,fore,Unspecified,0.0,0,308,7,354,39,46,32
15880,levle1_590.jpg,fore,Unspecified,0.0,0,617,215,680,271,63,56
15881,levle1_590.jpg,fore,Unspecified,0.0,0,487,199,548,254,61,55
15882,levle1_590.jpg,fore,Unspecified,0.0,0,559,269,619,327,60,58
15883,levle1_590.jpg,fore,Unspecified,0.0,0,513,316,572,366,59,50
15884,levle1_590.jpg,fore,Unspecified,0.0,0,390,397,433,444,43,47
15885,levle1_590.jpg,fore,Unspecified,0.0,0,1096,449,1133,485,37,36
15886,levle1_590.jpg,fore,Unspecified,0.0,0,1113,650,1154,700,41,50
15887,levle1_590.jpg,fore,Unspecified,0.0,0,1079,743,1141,786,62,43
15888,levle1_590.jpg,fore,Unspecified,0.0,0,1074,698,1120,734,46,36
15889,levle1_590.jpg,fore,Unspecified,0.0,0,1018,732,1068,778,50,46
15890,levle1_590.jpg,fore,Unspecified,0.0,0,977,711,1018,765,41,54
15891,levle1_590.jpg,fore,Unspecified,0.0,0,1016,613,1055,648,39,35
15892,levle1_590.jpg,fore,Unspecified,0.0,0,871,724,905,760,34,36
15893,levle1_590.jpg,fore,Unspecified,0.0,0,899,765,953,819,54,54
15894,levle1_590.jpg,fore,Unspecified,0.0,0,734,600,775,652,41,52
15895,levle1_590.jpg,fore,Unspecified,0.0,0,797,674,845,721,48,47
15896,levle1_590.jpg,fore,Unspecified,0.0,0,879,566,916,626,37,60
15897,levle1_590.jpg,fore,Unspecified,0.0,0,743,505,782,555,39,50
15898,levle1_590.jpg,fore,Unspecified,0.0,0,860,457,923,524,63,67
15899,levle1_584.jpg,fore,Unspecified,0.0,0,2700,1462,2762,1569,62,107
15900,levle1_584.jpg,fore,Unspecified,0.0,0,2861,1524,2976,1615,115,91
15901,levle1_584.jpg,fore,Unspecified,0.0,0,2447,1179,2539,1294,92,115
15902,levle1_584.jpg,fore,Unspecified,0.0,0,2026,780,2164,964,138,184
15903,levle1_584.jpg,fore,Unspecified,0.0,0,1497,903,1635,1002,138,99
15904,levle1_584.jpg,fore,Unspecified,0.0,0,2363,727,2524,880,161,153
15905,levle1_584.jpg,fore,Unspecified,0.0,0,2708,2121,2861,2221,153,100
15906,levle1_584.jpg,fore,Unspecified,0.0,0,2807,2267,2907,2359,100,92
15907,levle1_584.jpg,fore,Unspecified,0.0,0,2846,2351,2976,2481,130,130
15908,levle1_584.jpg,fore,Unspecified,0.0,0,1819,3202,2011,3355,192,153
15909,levle1_584.jpg,fore,Unspecified,0.0,0,2003,3041,2179,3163,176,122
15910,levle1_584.jpg,fore,Unspecified,0.0,0,2110,3194,2187,3271,77,77
15911,levle3_132.jpg,fore,,,0,2700,2014,2792,2167,92,153
15912,levle3_132.jpg,fore,,,0,2501,1945,2654,2045,153,100
15913,levle3_132.jpg,fore,,,0,2294,1753,2440,1922,146,169
15914,levle3_132.jpg,fore,,,0,2179,1730,2286,1868,107,138
15915,levle3_132.jpg,fore,,,0,1620,1922,1742,2037,122,115
15916,levle3_132.jpg,fore,,,0,1727,1884,1903,2022,176,138
15917,levle3_132.jpg,fore,,,0,1727,2029,1888,2175,161,146
15918,levle3_132.jpg,fore,,,0,1436,2098,1574,2251,138,153
15919,levle3_132.jpg,fore,,,0,2194,2022,2317,2114,123,92
15920,levle3_132.jpg,fore,,,0,1857,2190,1988,2290,131,100
15921,levle3_132.jpg,fore,,,0,2041,1876,2171,1976,130,100
15922,levle3_132.jpg,fore,,,0,2240,2359,2401,2451,161,92
15923,levle3_132.jpg,fore,,,0,2133,2290,2294,2435,161,145
15924,levle3_132.jpg,fore,,,0,1942,2351,2049,2435,107,84
15925,levle3_132.jpg,fore,,,0,1620,2351,1735,2489,115,138
15926,levle3_132.jpg,fore,,,0,1865,2504,2003,2627,138,123
15927,levle3_132.jpg,fore,,,0,1942,2642,2064,2865,122,223
15928,levle3_132.jpg,fore,,,0,2210,2504,2332,2619,122,115
15929,levle3_132.jpg,fore,,,0,2233,2627,2394,2765,161,138
15930,levle3_132.jpg,fore,,,0,1704,2673,1834,2826,130,153
15931,levle3_132.jpg,fore,,,0,1773,803,1957,956,184,153
15932,levle3_132.jpg,fore,,,0,1535,650,1712,819,177,169
15933,levle3_132.jpg,fore,,,0,1022,864,1168,979,146,115
15934,levle3_132.jpg,fore,,,0,761,803,961,979,200,176
15935,levle3_132.jpg,fore,,,0,1114,1271,1290,1447,176,176
15936,levle3_132.jpg,fore,,,0,1589,2075,1704,2244,115,169
15937,levle3_132.jpg,fore,,,0,2371,1983,2539,2183,168,200
15938,levle3_132.jpg,fore,,,0,2110,2083,2294,2251,184,168
15939,levle3_132.jpg,fore,,,0,1796,2359,1919,2535,123,176
15940,levle3_132.jpg,fore,,,0,1926,1715,2072,1830,146,115
15941,levle3_132.jpg,fore,,,0,2386,2474,2570,2658,184,184
15942,levle3_132.jpg,fore,,,0,1673,2842,1888,3071,215,229
15943,levle3_132.jpg,fore,,,0,1489,2903,1635,3064,146,161
15944,levle3_132.jpg,fore,,,0,2217,3094,2394,3278,177,184
15945,levle3_132.jpg,fore,,,0,1095,1594,1212,1736,117,142
15946,levle3_132.jpg,fore,,,0,1243,1653,1371,1750,128,97
15947,levle3_132.jpg,fore,,,0,1977,3039,2102,3122,125,83
15948,levle3_132.jpg,fore,,,0,1543,3132,1657,3239,114,107
15949,levle3_132.jpg,fore,,,0,977,2991,1071,3119,94,128
15950,levle3_132.jpg,fore,,,0,1346,2774,1457,2905,111,131
15951,levle3_132.jpg,fore,,,0,1412,2550,1584,2719,172,169
15952,levle3_132.jpg,fore,,,0,1608,2477,1708,2567,100,90
15953,levle3_132.jpg,fore,,,0,2060,2529,2164,2722,104,193
15954,levle3_132.jpg,fore,,,0,2522,2491,2640,2643,118,152
15955,levle3_132.jpg,fore,,,0,1936,2063,2074,2184,138,121
15956,levle3_132.jpg,fore,,,0,1719,2194,1871,2346,152,152
15957,levle3_132.jpg,fore,,,0,881,984,1088,1132,207,148
15958,levle3_132.jpg,fore,,,0,1298,825,1398,936,100,111
15959,levle3_132.jpg,fore,,,0,960,763,1091,843,131,80
15960,levle3_132.jpg,fore,,,0,1174,2846,1302,2939,128,93
15961,levle3_132.jpg,fore,,,0,1077,2908,1191,3032,114,124
15962,levle3_132.jpg,fore,,,0,929,2912,1022,2994,93,82
15963,levle3_132.jpg,fore,,,0,1605,146,1736,243,131,97
15964,levle3_132.jpg,fore,,,0,1753,339,1898,450,145,111
15965,levle1_585.jpg,fore,Unspecified,0.0,0,1673,3018,1773,3110,100,92
15966,levle1_585.jpg,fore,Unspecified,0.0,0,1911,2987,2018,3094,107,107
15967,levle1_585.jpg,fore,Unspecified,0.0,0,1796,3033,1857,3140,61,107
15968,levle1_585.jpg,fore,Unspecified,0.0,0,2716,1225,2800,1401,84,176
15969,levle1_585.jpg,fore,Unspecified,0.0,0,2440,1248,2593,1386,153,138
15970,levle1_585.jpg,fore,Unspecified,0.0,0,2256,956,2409,1163,153,207
15971,levle1_585.jpg,fore,Unspecified,0.0,0,1781,581,2018,796,237,215
15972,levle1_585.jpg,fore,Unspecified,0.0,0,2164,497,2256,642,92,145
15973,levle1_585.jpg,fore,Unspecified,0.0,0,2616,2098,2670,2137,54,39
15974,levle1_585.jpg,fore,Unspecified,0.0,0,2631,2114,2700,2198,69,84
15975,levle1_585.jpg,fore,Unspecified,0.0,0,2677,2144,2807,2259,130,115
15976,levle3_133.jpg,fore,,,0,2332,1723,2455,1899,123,176
15977,levle3_133.jpg,fore,,,0,2187,1769,2317,1914,130,145
15978,levle3_133.jpg,fore,,,0,1919,1730,2125,1876,206,146
15979,levle3_133.jpg,fore,,,0,1781,1960,1957,2075,176,115
15980,levle3_133.jpg,fore,,,0,2256,1899,2447,1945,191,46
15981,levle3_133.jpg,fore,,,0,2271,1999,2432,2160,161,161
15982,levle3_133.jpg,fore,,,0,1980,2229,2133,2351,153,122
15983,levle3_133.jpg,fore,,,0,1926,2336,2141,2474,215,138
15984,levle3_133.jpg,fore,,,0,2302,2259,2409,2412,107,153
15985,levle3_133.jpg,fore,,,0,2171,2183,2325,2336,154,153
15986,levle3_133.jpg,fore,,,0,2371,2405,2539,2504,168,99
15987,levle3_133.jpg,fore,,,0,1949,2466,2118,2619,169,153
15988,levle3_133.jpg,fore,,,0,1689,2458,1827,2612,138,154
15989,levle3_133.jpg,fore,,,0,1804,2075,1942,2206,138,131
15990,levle3_133.jpg,fore,,,0,1980,2068,2148,2206,168,138
15991,levle3_133.jpg,fore,,,0,1796,2926,1949,3094,153,168
15992,levle3_133.jpg,fore,,,0,1788,2742,1942,2918,154,176
15993,levle3_133.jpg,fore,,,0,1972,2688,2164,2949,192,261
15994,levle3_133.jpg,fore,,,0,1635,2872,1827,3018,192,146
15995,levle3_133.jpg,fore,,,0,1635,3033,1834,3133,199,100
15996,levle3_133.jpg,fore,,,0,1620,3117,1834,3271,214,154
15997,levle3_133.jpg,fore,,,0,1206,3048,1359,3179,153,131
15998,levle3_133.jpg,fore,,,0,1053,3041,1221,3225,168,184
15999,levle3_133.jpg,fore,,,0,853,1117,999,1255,146,138
16000,levle3_133.jpg,fore,,,0,1336,910,1558,1048,222,138
16001,levle3_133.jpg,fore,,,0,1528,2213,1658,2328,130,115
16002,levle3_133.jpg,fore,,,0,1612,2351,1742,2405,130,54
16003,levle3_133.jpg,fore,,,0,1834,2236,1942,2343,108,107
16004,levle3_133.jpg,fore,,,0,2210,2481,2371,2665,161,184
16005,levle3_133.jpg,fore,,,0,2141,2658,2325,2788,184,130
16006,levle3_133.jpg,fore,,,0,1667,2267,1808,2377,141,110
16007,levle3_133.jpg,fore,,,0,1488,3201,1598,3288,110,87
16008,levle3_133.jpg,fore,,,0,2129,2339,2215,2439,86,100
16009,levle3_133.jpg,fore,,,0,1646,1988,1777,2101,131,113
16010,levle3_133.jpg,fore,,,0,998,1053,1129,1170,131,117
16011,levle3_133.jpg,fore,,,0,1122,1694,1229,1843,107,149
16012,levle3_133.jpg,fore,,,0,2095,1908,2226,2043,131,135
16013,levle3_133.jpg,fore,,,0,1757,946,1884,1057,127,111
16014,levle3_133.jpg,fore,,,0,1515,794,1619,881,104,87
16015,levle3_133.jpg,fore,,,0,1512,184,1636,315,124,131
16016,levle3_133.jpg,fore,,,0,1608,339,1802,488,194,149
16017,levle3_133.jpg,fore,,,0,1195,1070,1298,1163,103,93
16018,levle3_133.jpg,fore,,,0,1491,3001,1615,3084,124,83
16019,levle3_133.jpg,fore,,,0,1291,2960,1391,3036,100,76
16020,levle3_133.jpg,fore,,,0,1819,2660,1908,2774,89,114
16021,levle3_133.jpg,fore,,,0,1822,2432,1977,2615,155,183
16022,levle3_133.jpg,fore,,,0,2122,2039,2260,2153,138,114
16023,levle3_133.jpg,fore,,,0,2522,1884,2643,2005,121,121
16024,levle3_133.jpg,fore,,,0,2529,1681,2653,1815,124,134
16025,levle3_133.jpg,fore,,,0,2105,2539,2208,2653,103,114
16026,levle3_133.jpg,fore,,,0,1908,3005,2005,3112,97,107
16027,levle3_133.jpg,fore,,,0,1560,2698,1688,2839,128,141
16028,levle3_133.jpg,fore,,,0,2002,1998,2088,2108,86,110
16029,levle3_133.jpg,fore,,,0,1822,1870,1933,1988,111,118
16030,levle3_133.jpg,fore,,,0,1460,2877,1595,2967,135,90
16031,levle3_133.jpg,fore,,,0,2495,1546,2584,1639,89,93
16032,levle3_133.jpg,fore,,,0,2415,1512,2519,1598,104,86
16033,levle3_133.jpg,fore,,,0,1681,2177,1788,2250,107,73
16034,levle3_133.jpg,fore,,,0,1953,2636,2060,2746,107,110
16035,levle3_133.jpg,fore,,,0,1391,2970,1498,3070,107,100
16036,levle3_133.jpg,fore,,,0,1312,3160,1446,3263,134,103
16037,levle3_133.jpg,fore,,,0,1619,3253,1705,3343,86,90
16038,levle3_127.jpg,fore,,,0,110,3,121,17,11,14
16039,levle3_127.jpg,fore,,,0,118,13,130,25,12,12
16040,levle3_127.jpg,fore,,,0,113,27,138,40,25,13
16041,levle3_127.jpg,fore,,,0,107,45,128,60,21,15
16042,levle3_127.jpg,fore,,,0,94,48,102,58,8,10
16043,levle3_127.jpg,fore,,,0,104,61,111,68,7,7
16044,levle3_127.jpg,fore,,,0,151,24,167,41,16,17
16045,levle3_127.jpg,fore,,,0,143,50,157,62,14,12
16046,levle3_127.jpg,fore,,,0,159,57,175,65,16,8
16047,levle3_127.jpg,fore,,,0,155,68,169,82,14,14
16048,levle3_127.jpg,fore,,,0,130,66,152,81,22,15
16049,levle3_127.jpg,fore,,,0,118,83,140,99,22,16
16050,levle3_127.jpg,fore,,,0,171,66,187,90,16,24
16051,levle3_127.jpg,fore,,,0,138,112,161,124,23,12
16052,levle3_127.jpg,fore,,,0,181,123,198,141,17,18
16053,levle3_127.jpg,fore,,,0,124,120,144,140,20,20
16054,levle3_127.jpg,fore,,,0,131,147,150,161,19,14
16055,levle3_127.jpg,fore,,,0,106,132,123,149,17,17
16056,levle3_127.jpg,fore,,,0,83,146,106,165,23,19
16057,levle3_127.jpg,fore,,,0,86,165,109,184,23,19
16058,levle3_127.jpg,fore,,,0,51,160,72,181,21,21
16059,levle3_127.jpg,fore,,,0,73,160,87,185,14,25
16060,levle3_127.jpg,fore,,,0,112,169,133,190,21,21
16061,levle3_127.jpg,fore,,,0,140,167,155,183,15,16
16062,levle3_127.jpg,fore,,,0,160,142,175,160,15,18
16063,levle3_127.jpg,fore,,,0,159,184,181,207,22,23
16064,levle3_127.jpg,fore,,,0,140,193,160,213,20,20
16065,levle3_127.jpg,fore,,,0,138,223,154,242,16,19
16066,levle3_127.jpg,fore,,,0,150,235,171,250,21,15
16067,levle3_127.jpg,fore,,,0,123,234,142,250,19,16
16068,levle3_127.jpg,fore,,,0,112,222,125,236,13,14
16069,levle3_127.jpg,fore,,,0,102,197,117,218,15,21
16070,levle3_127.jpg,fore,,,0,77,216,92,239,15,23
16071,levle3_127.jpg,fore,,,0,68,240,88,256,20,16
16072,levle3_127.jpg,fore,,,0,82,256,99,273,17,17
16073,levle3_127.jpg,fore,,,0,55,292,68,304,13,12
16074,levle3_127.jpg,fore,,,0,120,270,133,281,13,11
16075,levle3_127.jpg,fore,,,0,33,219,47,231,14,12
16076,levle3_127.jpg,fore,,,0,101,221,113,233,12,12
16077,levle3_127.jpg,fore,,,0,101,231,115,243,14,12
16078,levle3_127.jpg,fore,,,0,164,163,181,178,17,15
16079,levle3_127.jpg,fore,,,0,121,100,134,112,13,12
16080,levle3_127.jpg,fore,,,0,138,95,155,106,17,11
16081,levle3_127.jpg,fore,,,0,85,29,99,41,14,12
16082,levle3_127.jpg,fore,,,0,62,213,78,226,16,13
16083,levle3_127.jpg,fore,,,0,84,196,102,211,18,15
16084,levle3_127.jpg,fore,,,0,97,254,111,266,14,12
16085,levle3_127.jpg,fore,,,0,62,259,76,269,14,10
16086,levle3_127.jpg,fore,,,0,75,273,90,285,15,12
16087,levle3_127.jpg,fore,,,0,119,145,134,160,15,15
16088,levle3_127.jpg,fore,,,0,108,155,121,167,13,12
16089,levle3_127.jpg,fore,,,0,43,290,57,304,14,14
16090,levle3_127.jpg,fore,,,0,74,295,88,307,14,12
16091,levle3_127.jpg,fore,,,0,99,279,112,290,13,11
16092,levle3_127.jpg,fore,,,0,117,199,133,213,16,14
16093,levle3_127.jpg,fore,,,0,124,210,141,223,17,13
16094,levle3_127.jpg,fore,,,0,130,4,146,18,16,14
16095,levle3_127.jpg,fore,,,0,94,240,108,253,14,13
16096,levle3_127.jpg,fore,,,0,78,285,94,297,16,12
16097,levle3_127.jpg,fore,,,0,67,282,81,295,14,13
16098,levle3_127.jpg,fore,,,0,47,261,61,271,14,10
16099,levle3_127.jpg,fore,,,0,43,269,57,279,14,10
16100,levle3_127.jpg,fore,,,0,34,281,47,292,13,11
16101,levle1_591.jpg,fore,Unspecified,0.0,0,2041,2635,2210,2742,169,107
16102,levle1_591.jpg,fore,Unspecified,0.0,0,1896,3079,2034,3255,138,176
16103,levle1_591.jpg,fore,Unspecified,0.0,0,2072,3102,2233,3309,161,207
16104,levle1_591.jpg,fore,Unspecified,0.0,0,2225,3025,2340,3148,115,123
16105,levle1_591.jpg,fore,Unspecified,0.0,0,2700,1524,2800,1723,100,199
16106,levle1_591.jpg,fore,Unspecified,0.0,0,2217,2412,2325,2520,108,108
16107,levle1_591.jpg,fore,Unspecified,0.0,0,1321,2903,1443,3025,122,122
16108,levle1_591.jpg,fore,Unspecified,0.0,0,1497,2888,1650,3041,153,153
16109,levle1_591.jpg,fore,Unspecified,0.0,0,2102,2926,2217,3025,115,99
16110,levle1_591.jpg,fore,Unspecified,0.0,0,2279,2750,2401,2888,122,138
16111,levle1_591.jpg,fore,Unspecified,0.0,0,2348,2313,2532,2481,184,168
16112,levle1_546.jpg,fore,Unspecified,0.0,0,1551,2313,1658,2458,107,145
16113,levle1_546.jpg,fore,Unspecified,0.0,0,1712,2405,1804,2566,92,161
16114,levle1_546.jpg,fore,Unspecified,0.0,0,2079,2359,2279,2466,200,107
16115,levle1_546.jpg,fore,Unspecified,0.0,0,2325,2305,2455,2443,130,138
16116,levle1_546.jpg,fore,Unspecified,0.0,0,2309,1999,2455,2175,146,176
16117,levle1_546.jpg,fore,Unspecified,0.0,0,2087,2106,2256,2297,169,191
16118,levle1_546.jpg,fore,Unspecified,0.0,0,2049,2642,2133,2711,84,69
16119,levle1_546.jpg,fore,Unspecified,0.0,0,1788,2688,1957,2819,169,131
16120,levle1_546.jpg,fore,Unspecified,0.0,0,1712,3071,1857,3248,145,177
16121,levle1_546.jpg,fore,Unspecified,0.0,0,1627,2137,1727,2274,100,137
16122,levle1_10.jpg,fore,Unspecified,0.0,0,228,432,256,464,28,32
16123,levle1_10.jpg,fore,Unspecified,0.0,0,168,109,185,132,17,23
16124,levle1_10.jpg,fore,Unspecified,0.0,0,148,99,179,112,31,13
16125,levle1_10.jpg,fore,Unspecified,0.0,0,135,227,159,263,24,36
16126,levle1_10.jpg,fore,Unspecified,0.0,0,134,189,151,213,17,24
16127,levle1_10.jpg,fore,Unspecified,0.0,0,315,159,328,185,13,26
16128,levle1_10.jpg,fore,Unspecified,0.0,0,283,141,306,165,23,24
16129,levle1_10.jpg,fore,Unspecified,0.0,0,310,122,328,152,18,30
16130,levle1_10.jpg,fore,Unspecified,0.0,0,287,85,308,108,21,23
16131,levle1_10.jpg,fore,Unspecified,0.0,0,398,153,420,175,22,22
16132,levle1_10.jpg,fore,Unspecified,0.0,0,351,55,394,77,43,22
16133,levle1_10.jpg,fore,Unspecified,0.0,0,184,67,228,98,44,31
16134,levle1_10.jpg,fore,Unspecified,0.0,0,348,94,379,119,31,25
16135,levle1_10.jpg,fore,Unspecified,0.0,0,314,616,347,636,33,20
16136,levle1_10.jpg,fore,Unspecified,0.0,0,298,571,328,595,30,24
16137,levle1_10.jpg,fore,Unspecified,0.0,0,235,82,279,124,44,42
16138,levle1_10.jpg,fore,Unspecified,0.0,0,378,77,419,109,41,32
16139,levle1_220.jpg,fore,Unspecified,0.0,0,624,2236,715,2336,91,100
16140,levle1_220.jpg,fore,Unspecified,0.0,0,1451,711,1512,842,61,131
16141,levle1_220.jpg,fore,Unspecified,0.0,0,1352,2987,1451,3064,99,77
16142,levle1_220.jpg,fore,Unspecified,0.0,0,1512,3064,1558,3225,46,161
16143,levle1_220.jpg,fore,Unspecified,0.0,0,1742,3002,1850,3117,108,115
16144,levle1_220.jpg,fore,Unspecified,0.0,0,1551,2934,1643,3033,92,99
16145,levle1_220.jpg,fore,Unspecified,0.0,0,1375,2474,1505,2604,130,130
16146,levle1_220.jpg,fore,Unspecified,0.0,0,1551,2589,1635,2719,84,130
16147,levle1_220.jpg,fore,Unspecified,0.0,0,984,658,1099,757,115,99
16148,levle1_234.jpg,fore,,,0,1865,1822,1957,1945,92,123
16149,levle1_234.jpg,fore,,,0,1689,2665,1765,2765,76,100
16150,levle1_234.jpg,fore,,,0,1106,3048,1191,3163,85,115
16151,levle1_234.jpg,fore,,,0,1321,313,1436,443,115,130
16152,levle1_234.jpg,fore,,,0,1735,2374,1842,2497,107,123
16153,levle1_234.jpg,fore,,,0,2202,915,2284,1001,82,86
16154,levle1_552.jpg,fore,Unspecified,0.0,0,685,1347,830,1462,145,115
16155,levle1_552.jpg,fore,Unspecified,0.0,0,432,1953,585,2068,153,115
16156,levle1_552.jpg,fore,Unspecified,0.0,0,409,2106,547,2251,138,145
16157,levle1_552.jpg,fore,Unspecified,0.0,0,830,2060,999,2160,169,100
16158,levle1_552.jpg,fore,Unspecified,0.0,0,869,1930,1030,2037,161,107
16159,levle1_552.jpg,fore,Unspecified,0.0,0,915,995,1083,1186,168,191
16160,levle1_208.jpg,fore,,,0,1819,2221,1911,2351,92,130
16161,levle1_208.jpg,fore,,,0,2079,1853,2187,1999,108,146
16162,levle1_208.jpg,fore,,,0,1903,2336,1988,2435,85,99
16163,levle1_208.jpg,fore,,,0,1742,2550,1850,2704,108,154
16164,levle1_208.jpg,fore,,,0,2049,2267,2125,2412,76,145
16165,levle1_208.jpg,fore,,,0,1836,2763,1936,2857,100,94
16166,levle1_38.jpg,fore,Unspecified,0.0,0,1099,949,1214,1079,115,130
16167,levle1_38.jpg,fore,Unspecified,0.0,0,876,918,976,1064,100,146
16168,levle1_38.jpg,fore,Unspecified,0.0,0,1091,719,1214,903,123,184
16169,levle1_38.jpg,fore,Unspecified,0.0,0,2325,1822,2432,1983,107,161
16170,levle1_38.jpg,fore,Unspecified,0.0,0,2455,2006,2547,2152,92,146
16171,levle1_38.jpg,fore,Unspecified,0.0,0,2217,2229,2325,2343,108,114
16172,levle1_38.jpg,fore,Unspecified,0.0,0,2286,2343,2378,2443,92,100
16173,levle1_38.jpg,fore,Unspecified,0.0,0,2263,2052,2401,2221,138,169
16174,levle1_38.jpg,fore,Unspecified,0.0,0,2079,2121,2210,2282,131,161
16175,levle1_38.jpg,fore,Unspecified,0.0,0,1788,2251,1942,2405,154,154
16176,levle1_38.jpg,fore,Unspecified,0.0,0,1604,2297,1673,2397,69,100
16177,levle1_38.jpg,fore,Unspecified,0.0,0,1880,2543,2011,2688,131,145
16178,levle1_38.jpg,fore,Unspecified,0.0,0,1934,2137,2041,2236,107,99
16179,levle2_122.jpg,fore,Unspecified,0.0,0,1681,1317,1765,1439,84,122
16180,levle2_122.jpg,fore,Unspecified,0.0,0,455,1516,593,1638,138,122
16181,levle2_122.jpg,fore,Unspecified,0.0,0,263,1485,371,1684,108,199
16182,levle2_122.jpg,fore,Unspecified,0.0,0,294,1332,440,1432,146,100
16183,levle2_122.jpg,fore,Unspecified,0.0,0,401,1409,516,1531,115,122
16184,levle2_122.jpg,fore,Unspecified,0.0,0,1037,941,1129,1033,92,92
16185,levle2_122.jpg,fore,Unspecified,0.0,0,815,1960,907,2091,92,131
16186,levle2_122.jpg,fore,Unspecified,0.0,0,409,2045,516,2167,107,122
16187,levle2_122.jpg,fore,Unspecified,0.0,0,616,2114,708,2206,92,92
16188,levle2_122.jpg,fore,Unspecified,0.0,0,409,2175,486,2244,77,69
16189,levle2_122.jpg,fore,Unspecified,0.0,0,378,2343,501,2451,123,108
16190,levle2_122.jpg,fore,Unspecified,0.0,0,608,2420,715,2550,107,130
16191,levle2_122.jpg,fore,Unspecified,0.0,0,999,3102,1145,3225,146,123
16192,levle2_122.jpg,fore,Unspecified,0.0,0,915,2681,1022,2788,107,107
16193,levle2_122.jpg,fore,Unspecified,0.0,0,853,2458,945,2604,92,146
16194,levle2_122.jpg,fore,Unspecified,0.0,0,1298,2972,1459,3102,161,130
16195,levle2_122.jpg,fore,Unspecified,0.0,0,1183,665,1290,765,107,100
16196,levle2_122.jpg,fore,Unspecified,0.0,0,1206,750,1336,895,130,145
16197,levle2_122.jpg,fore,Unspecified,0.0,0,1666,780,1781,903,115,123
16198,levle2_122.jpg,fore,Unspecified,0.0,0,677,2206,769,2336,92,130
16199,levle2_122.jpg,fore,Unspecified,0.0,0,1114,2619,1229,2681,115,62
16200,levle2_122.jpg,fore,Unspecified,0.0,0,1045,2550,1160,2612,115,62
16201,levle2_122.jpg,fore,Unspecified,0.0,0,999,2420,1068,2520,69,100
16202,levle2_122.jpg,fore,Unspecified,0.0,0,1413,3179,1512,3309,99,130
16203,levle2_136.jpg,fore,Unspecified,0.0,0,1758,2152,1896,2290,138,138
16204,levle2_136.jpg,fore,Unspecified,0.0,0,1566,2167,1643,2328,77,161
16205,levle2_136.jpg,fore,Unspecified,0.0,0,1612,1922,1765,2083,153,161
16206,levle2_136.jpg,fore,Unspecified,0.0,0,1267,2198,1474,2359,207,161
16207,levle2_136.jpg,fore,Unspecified,0.0,0,846,2581,1037,2727,191,146
16208,levle2_136.jpg,fore,Unspecified,0.0,0,279,2405,378,2497,99,92
16209,levle2_136.jpg,fore,Unspecified,0.0,0,248,2512,340,2627,92,115
16210,levle2_136.jpg,fore,Unspecified,0.0,0,348,2512,463,2604,115,92
16211,levle2_136.jpg,fore,Unspecified,0.0,0,355,2665,478,2757,123,92
16212,levle2_136.jpg,fore,Unspecified,0.0,0,562,2213,631,2343,69,130
16213,levle2_136.jpg,fore,Unspecified,0.0,0,647,2114,738,2183,91,69
16214,levle2_136.jpg,fore,Unspecified,0.0,0,700,2267,800,2412,100,145
16215,levle2_136.jpg,fore,Unspecified,0.0,0,899,2313,915,2343,16,30
16216,levle2_136.jpg,fore,Unspecified,0.0,0,800,2229,899,2366,99,137
16217,levle2_136.jpg,fore,Unspecified,0.0,0,708,2481,815,2558,107,77
16218,levle2_136.jpg,fore,Unspecified,0.0,0,1650,1409,1788,1524,138,115
16219,levle2_136.jpg,fore,Unspecified,0.0,0,1558,872,1643,949,85,77
16220,levle2_136.jpg,fore,Unspecified,0.0,0,1735,819,1788,926,53,107
16221,levle2_136.jpg,fore,Unspecified,0.0,0,1781,918,1842,972,61,54
16222,levle2_136.jpg,fore,Unspecified,0.0,0,1796,956,1896,1071,100,115
16223,levle2_136.jpg,fore,Unspecified,0.0,0,1942,987,2057,1110,115,123
16224,levle2_136.jpg,fore,Unspecified,0.0,0,1604,972,1719,1117,115,145
16225,levle2_136.jpg,fore,Unspecified,0.0,0,593,2604,708,2780,115,176
16226,levle2_136.jpg,fore,Unspecified,0.0,0,478,2681,662,2888,184,207
16227,levle2_136.jpg,fore,Unspecified,0.0,0,1436,3309,1535,3393,99,84
16228,levle2_82.jpg,fore,Unspecified,0.0,0,1528,665,1689,780,161,115
16229,levle2_82.jpg,fore,Unspecified,0.0,0,1466,543,1627,658,161,115
16230,levle2_82.jpg,fore,Unspecified,0.0,0,1581,382,1696,527,115,145
16231,levle2_82.jpg,fore,Unspecified,0.0,0,1796,274,1949,466,153,192
16232,levle2_82.jpg,fore,Unspecified,0.0,0,754,612,907,727,153,115
16233,levle2_82.jpg,fore,Unspecified,0.0,0,608,627,731,750,123,123
16234,levle2_82.jpg,fore,Unspecified,0.0,0,578,765,685,887,107,122
16235,levle2_82.jpg,fore,Unspecified,0.0,0,700,796,823,910,123,114
16236,levle2_82.jpg,fore,Unspecified,0.0,0,555,1033,685,1179,130,146
16237,levle2_82.jpg,fore,Unspecified,0.0,0,432,1232,608,1386,176,154
16238,levle2_82.jpg,fore,Unspecified,0.0,0,447,1554,631,1723,184,169
16239,levle2_82.jpg,fore,Unspecified,0.0,0,210,1600,302,1669,92,69
16240,levle2_82.jpg,fore,Unspecified,0.0,0,332,1677,440,1815,108,138
16241,levle2_82.jpg,fore,Unspecified,0.0,0,455,1669,624,1845,169,176
16242,levle2_82.jpg,fore,Unspecified,0.0,0,378,1976,509,2137,131,161
16243,levle2_82.jpg,fore,Unspecified,0.0,0,593,1983,746,2137,153,154
16244,levle2_82.jpg,fore,Unspecified,0.0,0,670,1776,823,1953,153,177
16245,levle2_82.jpg,fore,Unspecified,0.0,0,516,2282,631,2405,115,123
16246,levle2_82.jpg,fore,Unspecified,0.0,0,516,2573,662,2811,146,238
16247,levle2_82.jpg,fore,Unspecified,0.0,0,631,2918,876,3209,245,291
16248,levle2_82.jpg,fore,Unspecified,0.0,0,1007,2527,1206,2750,199,223
16249,levle2_82.jpg,fore,Unspecified,0.0,0,1191,2911,1306,3079,115,168
16250,levle2_82.jpg,fore,Unspecified,0.0,0,1214,3064,1375,3240,161,176
16251,levle2_82.jpg,fore,Unspecified,0.0,0,1083,535,1344,727,261,192
16252,levle2_82.jpg,fore,Unspecified,0.0,0,1106,167,1237,374,131,207
16253,levle2_96.jpg,fore,Unspecified,0.0,0,2233,2029,2440,2183,207,154
16254,levle2_96.jpg,fore,Unspecified,0.0,0,2386,2137,2516,2251,130,114
16255,levle2_96.jpg,fore,Unspecified,0.0,0,2447,2221,2562,2359,115,138
16256,levle2_96.jpg,fore,Unspecified,0.0,0,2294,2397,2463,2527,169,130
16257,levle2_96.jpg,fore,Unspecified,0.0,0,1965,2443,2125,2573,160,130
16258,levle2_96.jpg,fore,Unspecified,0.0,0,2087,2773,2271,2903,184,130
16259,levle2_96.jpg,fore,Unspecified,0.0,0,2309,2811,2463,2926,154,115
16260,levle2_96.jpg,fore,Unspecified,0.0,0,2317,2512,2478,2673,161,161
16261,levle2_96.jpg,fore,Unspecified,0.0,0,2578,1930,2693,2075,115,145
16262,levle2_96.jpg,fore,Unspecified,0.0,0,1397,956,1543,1064,146,108
16263,levle2_96.jpg,fore,Unspecified,0.0,0,1367,3140,1436,3278,69,138
16264,levle2_96.jpg,fore,Unspecified,0.0,0,1658,2903,1796,3025,138,122
16265,levle2_96.jpg,fore,Unspecified,0.0,0,1773,2918,1911,3064,138,146
16266,levle2_96.jpg,fore,Unspecified,0.0,0,1543,3202,1788,3393,245,191
16267,levle2_96.jpg,fore,Unspecified,0.0,0,1367,1370,1497,1516,130,146
16268,levle2_96.jpg,fore,Unspecified,0.0,0,1183,1715,1405,1937,222,222
16269,levle2_96.jpg,fore,Unspecified,0.0,0,1405,2052,1558,2251,153,199
16270,levle2_96.jpg,fore,Unspecified,0.0,0,1666,2190,1819,2336,153,146
16271,levle2_96.jpg,fore,Unspecified,0.0,0,1459,2956,1589,3125,130,169
16272,levle2_96.jpg,fore,Unspecified,0.0,0,2256,2972,2447,3148,191,176
16273,levle2_96.jpg,fore,Unspecified,0.0,0,2593,2313,2769,2497,176,184
16274,levle2_96.jpg,fore,Unspecified,0.0,0,2501,2198,2716,2305,215,107
16275,levle0_231.jpg,fore,Unspecified,0.0,0,2355,2060,2516,2221,161,161
16276,levle2_69.jpg,fore,Unspecified,0.0,0,1378,1186,1536,1310,158,124
16277,levle2_69.jpg,fore,Unspecified,0.0,0,1436,1061,1603,1161,167,100
16278,levle2_69.jpg,fore,Unspecified,0.0,0,2168,978,2317,1103,149,125
16279,levle2_69.jpg,fore,Unspecified,0.0,0,1478,1551,1594,1701,116,150
16280,levle2_69.jpg,fore,Unspecified,0.0,0,2284,1601,2500,1768,216,167
16281,levle2_69.jpg,fore,Unspecified,0.0,0,2517,1477,2691,1610,174,133
16282,levle2_69.jpg,fore,Unspecified,0.0,0,2076,1643,2251,1768,175,125
16283,levle2_69.jpg,fore,Unspecified,0.0,0,2758,1668,2907,1751,149,83
16284,levle2_69.jpg,fore,Unspecified,0.0,0,2916,1759,3090,1867,174,108
16285,levle2_69.jpg,fore,Unspecified,0.0,0,2309,1867,2500,2000,191,133
16286,levle2_69.jpg,fore,Unspecified,0.0,0,2459,1859,2616,1950,157,91
16287,levle2_69.jpg,fore,Unspecified,0.0,0,2517,1950,2600,2092,83,142
16288,levle2_69.jpg,fore,Unspecified,0.0,0,2359,2058,2492,2175,133,117
16289,levle2_69.jpg,fore,Unspecified,0.0,0,2484,2133,2575,2299,91,166
16290,levle2_69.jpg,fore,Unspecified,0.0,0,3024,1867,3140,1950,116,83
16291,levle2_69.jpg,fore,Unspecified,0.0,0,3040,1984,3232,2150,192,166
16292,levle2_69.jpg,fore,Unspecified,0.0,0,1885,2366,2076,2432,191,66
16293,levle2_69.jpg,fore,Unspecified,0.0,0,2558,2607,2808,2757,250,150
16294,levle2_69.jpg,fore,Unspecified,0.0,0,2616,1809,2749,1876,133,67
16295,levle2_69.jpg,fore,Unspecified,0.0,0,2608,1925,2716,2050,108,125
16296,levle2_69.jpg,fore,Unspecified,0.0,0,2691,1967,2841,2092,150,125
16297,levle2_69.jpg,fore,Unspecified,0.0,0,2799,1984,2941,2117,142,133
16298,levle2_69.jpg,fore,Unspecified,0.0,0,2841,1801,2966,1901,125,100
16299,levle2_69.jpg,fore,Unspecified,0.0,0,2550,2075,2683,2191,133,116
16300,levle2_69.jpg,fore,Unspecified,0.0,0,2691,2133,2858,2291,167,158
16301,levle2_69.jpg,fore,Unspecified,0.0,0,2542,2216,2658,2333,116,117
16302,levle2_69.jpg,fore,Unspecified,0.0,0,2392,2333,2517,2449,125,116
16303,levle2_69.jpg,fore,Unspecified,0.0,0,1977,2582,2143,2732,166,150
16304,levle2_69.jpg,fore,Unspecified,0.0,0,1844,2516,2018,2632,174,116
16305,levle2_69.jpg,fore,Unspecified,0.0,0,1852,2673,2018,2765,166,92
16306,levle2_69.jpg,fore,Unspecified,0.0,0,2101,2690,2251,2865,150,175
16307,levle2_69.jpg,fore,Unspecified,0.0,0,2234,2773,2508,2923,274,150
16308,levle0_225.jpg,fore,Unspecified,0.0,0,2042,1818,2112,1932,70,114
16309,levle0_225.jpg,fore,Unspecified,0.0,0,1937,1590,1998,1678,61,88
16310,levle0_225.jpg,fore,Unspecified,0.0,0,2235,2152,2349,2301,114,149
16311,levle0_225.jpg,fore,Unspecified,0.0,0,1919,1950,2016,2003,97,53
16312,levle2_41.jpg,fore,Unspecified,0.0,0,1390,773,1543,964,153,191
16313,levle2_41.jpg,fore,Unspecified,0.0,0,961,719,1152,865,191,146
16314,levle2_41.jpg,fore,Unspecified,0.0,0,991,788,1099,1041,108,253
16315,levle2_41.jpg,fore,Unspecified,0.0,0,2363,1799,2547,1930,184,131
16316,levle2_41.jpg,fore,Unspecified,0.0,0,2455,1845,2608,2045,153,200
16317,levle2_41.jpg,fore,Unspecified,0.0,0,2432,2006,2509,2106,77,100
16318,levle2_41.jpg,fore,Unspecified,0.0,0,2509,2022,2647,2144,138,122
16319,levle2_41.jpg,fore,Unspecified,0.0,0,2501,2114,2608,2282,107,168
16320,levle2_41.jpg,fore,Unspecified,0.0,0,2371,2167,2501,2274,130,107
16321,levle2_41.jpg,fore,Unspecified,0.0,0,2240,2083,2424,2244,184,161
16322,levle2_41.jpg,fore,Unspecified,0.0,0,2102,2045,2233,2213,131,168
16323,levle2_41.jpg,fore,Unspecified,0.0,0,1957,2106,2072,2236,115,130
16324,levle2_41.jpg,fore,Unspecified,0.0,0,1865,2152,2003,2313,138,161
16325,levle2_41.jpg,fore,Unspecified,0.0,0,1911,2267,2072,2397,161,130
16326,levle2_41.jpg,fore,Unspecified,0.0,0,1880,2359,1972,2481,92,122
16327,levle2_41.jpg,fore,Unspecified,0.0,0,1980,2343,2148,2520,168,177
16328,levle2_41.jpg,fore,Unspecified,0.0,0,2049,2267,2171,2397,122,130
16329,levle2_41.jpg,fore,Unspecified,0.0,0,2202,2297,2325,2435,123,138
16330,levle2_41.jpg,fore,Unspecified,0.0,0,2309,2251,2463,2397,154,146
16331,levle2_41.jpg,fore,Unspecified,0.0,0,2409,2351,2478,2497,69,146
16332,levle2_41.jpg,fore,Unspecified,0.0,0,2478,2374,2616,2527,138,153
16333,levle2_41.jpg,fore,Unspecified,0.0,0,1965,2512,2194,2673,229,161
16334,levle2_41.jpg,fore,Unspecified,0.0,0,2248,2589,2432,2742,184,153
16335,levle2_41.jpg,fore,Unspecified,0.0,0,2095,2658,2248,2765,153,107
16336,levle2_41.jpg,fore,Unspecified,0.0,0,1298,2880,1420,3018,122,138
16337,levle2_41.jpg,fore,Unspecified,0.0,0,2187,2803,2332,2926,145,123
16338,levle2_41.jpg,fore,Unspecified,0.0,0,1995,2796,2210,2979,215,183
16339,levle0_219.jpg,fore,Unspecified,0.0,0,1244,2895,1397,3064,153,169
16340,levle0_219.jpg,fore,Unspecified,0.0,0,1076,3056,1206,3225,130,169
16341,levle2_55.jpg,fore,Unspecified,0.0,0,2849,1418,3032,1635,183,217
16342,levle2_55.jpg,fore,Unspecified,0.0,0,2658,1394,2849,1576,191,182
16343,levle2_55.jpg,fore,Unspecified,0.0,0,2575,2075,2683,2175,108,100
16344,levle2_55.jpg,fore,Unspecified,0.0,0,2525,2333,2633,2449,108,116
16345,levle2_55.jpg,fore,Unspecified,0.0,0,2733,1934,2816,2075,83,141
16346,levle2_55.jpg,fore,Unspecified,0.0,0,3049,2333,3148,2482,99,149
16347,levle2_55.jpg,fore,Unspecified,0.0,0,2874,2308,3040,2474,166,166
16348,levle2_55.jpg,fore,Unspecified,0.0,0,2666,2482,2816,2590,150,108
16349,levle2_55.jpg,fore,Unspecified,0.0,0,2833,2466,2932,2565,99,99
16350,levle2_55.jpg,fore,Unspecified,0.0,0,2733,2574,2808,2707,75,133
16351,levle2_55.jpg,fore,Unspecified,0.0,0,3331,2316,3514,2466,183,150
16352,levle2_55.jpg,fore,Unspecified,0.0,0,3522,2358,3672,2466,150,108
16353,levle2_55.jpg,fore,Unspecified,0.0,0,3431,2457,3531,2574,100,117
16354,levle2_55.jpg,fore,Unspecified,0.0,0,3340,2441,3473,2590,133,149
16355,levle2_55.jpg,fore,Unspecified,0.0,0,3273,2399,3381,2607,108,208
16356,levle2_55.jpg,fore,Unspecified,0.0,0,3132,2565,3306,2723,174,158
16357,levle2_55.jpg,fore,Unspecified,0.0,0,2916,2582,2982,2649,66,67
16358,levle2_55.jpg,fore,Unspecified,0.0,0,2916,2649,3057,2773,141,124
16359,levle2_55.jpg,fore,Unspecified,0.0,0,2841,2798,2974,2890,133,92
16360,levle2_55.jpg,fore,Unspecified,0.0,0,3115,2698,3240,2865,125,167
16361,levle2_55.jpg,fore,Unspecified,0.0,0,3074,2840,3173,2915,99,75
16362,levle2_55.jpg,fore,Unspecified,0.0,0,3132,2865,3215,2998,83,133
16363,levle2_55.jpg,fore,Unspecified,0.0,0,3215,2698,3356,2831,141,133
16364,levle2_55.jpg,fore,Unspecified,0.0,0,3414,2582,3514,2682,100,100
16365,levle0_386.jpg,fore,Unspecified,0.0,0,1298,2573,1459,2673,161,100
16366,levle0_386.jpg,fore,Unspecified,0.0,0,348,2167,555,2389,207,222
16367,levle1_195.jpg,fore,Unspecified,0.0,0,1581,2796,1758,2949,177,153
16368,levle1_195.jpg,fore,Unspecified,0.0,0,1957,2336,2087,2497,130,161
16369,levle1_195.jpg,fore,Unspecified,0.0,0,2095,2566,2294,2773,199,207
16370,levle1_195.jpg,fore,Unspecified,0.0,0,2417,2121,2578,2313,161,192
16371,levle1_195.jpg,fore,Unspecified,0.0,0,2478,1953,2654,2091,176,138
16372,levle1_195.jpg,fore,Unspecified,0.0,0,1152,765,1290,864,138,99
16373,levle1_195.jpg,fore,Unspecified,0.0,0,1183,2773,1290,2895,107,122
16374,levle1_195.jpg,fore,Unspecified,0.0,0,1873,2512,1988,2627,115,115
16375,levle0_392.jpg,fore,Unspecified,0.0,0,968,2527,1106,2635,138,108
16376,levle0_392.jpg,fore,Unspecified,0.0,0,922,3179,1129,3378,207,199
16377,levle1_181.jpg,fore,Unspecified,0.0,0,2072,2750,2294,2949,222,199
16378,levle0_87.jpg,fore,Unspecified,0.0,0,1885,2557,1977,2665,92,108
16379,levle0_87.jpg,fore,Unspecified,0.0,0,1977,2541,2168,2765,191,224
16380,levle0_345.jpg,fore,Unspecified,0.0,0,853,1133,991,1294,138,161
16381,levle1_156.jpg,fore,Unspecified,0.0,0,1443,1470,1627,1638,184,168
16382,levle1_156.jpg,fore,Unspecified,0.0,0,1129,2489,1260,2612,131,123
16383,levle1_156.jpg,fore,Unspecified,0.0,0,1022,2535,1083,2627,61,92
16384,levle1_156.jpg,fore,Unspecified,0.0,0,1267,2435,1413,2550,146,115
16385,levle1_156.jpg,fore,Unspecified,0.0,0,1750,2520,1850,2627,100,107
16386,levle1_156.jpg,fore,Unspecified,0.0,0,363,2351,478,2458,115,107
16387,levle1_156.jpg,fore,Unspecified,0.0,0,394,2144,555,2297,161,153
16388,levle1_156.jpg,fore,Unspecified,0.0,0,378,2527,509,2619,131,92
16389,levle1_156.jpg,fore,Unspecified,0.0,0,562,2405,708,2550,146,145
16390,levle1_630.jpg,fore,Unspecified,0.0,0,1988,956,2156,1125,168,169
16391,levle1_630.jpg,fore,Unspecified,0.0,0,2256,1746,2447,1937,191,191
16392,levle1_630.jpg,fore,Unspecified,0.0,0,2325,1976,2486,2121,161,145
16393,levle1_630.jpg,fore,Unspecified,0.0,0,1965,1884,2133,2075,168,191
16394,levle1_630.jpg,fore,Unspecified,0.0,0,1949,2428,2057,2642,108,214
16395,levle1_630.jpg,fore,Unspecified,0.0,0,2233,2267,2371,2412,138,145
16396,levle1_630.jpg,fore,Unspecified,0.0,0,2639,2190,2746,2305,107,115
16397,levle1_630.jpg,fore,Unspecified,0.0,0,2769,2160,2953,2389,184,229
16398,levle1_630.jpg,fore,Unspecified,0.0,0,2363,2742,2578,2857,215,115
16399,levle1_630.jpg,fore,Unspecified,0.0,0,2233,2834,2440,2995,207,161
16400,levle1_630.jpg,fore,Unspecified,0.0,0,2555,2435,2731,2589,176,154
16401,levle0_423.jpg,fore,Unspecified,0.0,0,1804,1738,1911,1891,107,153
16402,levle0_423.jpg,fore,Unspecified,0.0,0,2018,3079,2133,3186,115,107
16403,levle0_78.jpg,fore,Unspecified,0.0,0,4046,2707,4270,2873,224,166
16404,levle1_624.jpg,fore,Unspecified,0.0,0,593,1355,700,1470,107,115
16405,levle1_624.jpg,fore,Unspecified,0.0,0,601,887,761,1048,160,161
16406,levle1_624.jpg,fore,Unspecified,0.0,0,440,2183,616,2320,176,137
16407,levle1_624.jpg,fore,Unspecified,0.0,0,501,2412,608,2543,107,131
16408,levle1_624.jpg,fore,Unspecified,0.0,0,455,2650,624,2788,169,138
16409,levle1_624.jpg,fore,Unspecified,0.0,0,784,2842,945,3018,161,176
16410,levle1_624.jpg,fore,Unspecified,0.0,0,1160,2803,1290,2911,130,108
16411,levle0_351.jpg,fore,Unspecified,0.0,0,746,1079,884,1194,138,115
16412,levle0_351.jpg,fore,Unspecified,0.0,0,1037,3248,1160,3363,123,115
16413,levle1_142.jpg,fore,Unspecified,0.0,0,1329,558,1420,673,91,115
16414,levle1_142.jpg,fore,Unspecified,0.0,0,2210,1240,2348,1416,138,176
16415,levle1_142.jpg,fore,Unspecified,0.0,0,1896,2359,2011,2474,115,115
16416,levle1_142.jpg,fore,Unspecified,0.0,0,1834,2596,1942,2711,108,115
16417,levle1_142.jpg,fore,Unspecified,0.0,0,1957,2696,2072,2788,115,92
16418,levle1_142.jpg,fore,Unspecified,0.0,0,2057,2849,2210,2979,153,130
16419,levle0_379.jpg,fore,Unspecified,0.0,0,1666,1110,1727,1217,61,107
16420,levle0_379.jpg,fore,Unspecified,0.0,0,1727,1370,1850,1439,123,69
16421,levle0_44.jpg,fore,Unspecified,0.0,0,2141,2566,2279,2765,138,199
16422,levle0_44.jpg,fore,Unspecified,0.0,0,2102,2274,2210,2412,108,138
16423,levle0_44.jpg,fore,Unspecified,0.0,0,1145,3010,1329,3209,184,199
16424,levle0_44.jpg,fore,Unspecified,0.0,0,1689,3133,1842,3263,153,130
16425,levle1_618.jpg,fore,Unspecified,0.0,0,2440,1930,2631,2106,191,176
16426,levle1_618.jpg,fore,Unspecified,0.0,0,2148,2037,2271,2190,123,153
16427,levle1_618.jpg,fore,Unspecified,0.0,0,2348,2160,2524,2267,176,107
16428,levle1_618.jpg,fore,Unspecified,0.0,0,2210,2267,2401,2412,191,145
16429,levle1_618.jpg,fore,Unspecified,0.0,0,1712,2374,1888,2535,176,161
16430,levle1_618.jpg,fore,Unspecified,0.0,0,1957,2497,2141,2665,184,168
16431,levle1_618.jpg,fore,Unspecified,0.0,0,2202,2520,2317,2635,115,115
16432,levle1_618.jpg,fore,Unspecified,0.0,0,2102,2650,2279,2811,177,161
16433,levle0_50.jpg,fore,Unspecified,0.0,0,1359,3225,1482,3370,123,145
16434,levle0_50.jpg,fore,Unspecified,0.0,0,2018,2673,2194,2796,176,123
16435,levle1_397.jpg,fore,Unspecified,0.0,0,1313,2934,1489,3064,176,130
16436,levle1_397.jpg,fore,Unspecified,0.0,0,1505,2895,1673,3064,168,169
16437,levle1_397.jpg,fore,Unspecified,0.0,0,1267,2221,1413,2328,146,107
16438,levle1_397.jpg,fore,Unspecified,0.0,0,2631,1899,2815,2045,184,146
16439,levle1_397.jpg,fore,Unspecified,0.0,0,2493,2052,2654,2229,161,177
16440,levle1_397.jpg,fore,Unspecified,0.0,0,1543,1922,1727,2137,184,215
16441,levle1_397.jpg,fore,Unspecified,0.0,0,1306,658,1436,849,130,191
16442,levle1_397.jpg,fore,Unspecified,0.0,0,2079,734,2271,903,192,169
16443,levle0_184.jpg,fore,Unspecified,0.0,0,715,1723,892,1868,177,145
16444,levle0_184.jpg,fore,Unspecified,0.0,0,670,1983,823,2137,153,154
16445,levle1_383.jpg,fore,Unspecified,0.0,0,608,1271,723,1393,115,122
16446,levle1_383.jpg,fore,Unspecified,0.0,0,938,581,1022,681,84,100
16447,levle1_383.jpg,fore,Unspecified,0.0,0,1329,581,1436,688,107,107
16448,levle1_383.jpg,fore,Unspecified,0.0,0,1627,1225,1719,1340,92,115
16449,levle1_383.jpg,fore,Unspecified,0.0,0,2057,2198,2194,2366,137,168
16450,levle1_383.jpg,fore,Unspecified,0.0,0,1742,2811,1911,2941,169,130
16451,levle0_190.jpg,fore,Unspecified,0.0,0,792,420,938,558,146,138
16452,levle0_190.jpg,fore,Unspecified,0.0,0,524,2481,731,2711,207,230
16453,levle1_432.jpg,fore,Unspecified,0.0,0,2263,2405,2417,2581,154,176
16454,levle1_432.jpg,fore,Unspecified,0.0,0,2225,2550,2463,2819,238,269
16455,levle1_432.jpg,fore,Unspecified,0.0,0,1229,2926,1344,3033,115,107
16456,levle1_432.jpg,fore,Unspecified,0.0,0,1329,3248,1436,3347,107,99
16457,levle1_432.jpg,fore,Unspecified,0.0,0,1206,2014,1275,2129,69,115
16458,levle1_432.jpg,fore,Unspecified,0.0,0,945,1937,1129,2137,184,200
16459,levle3_15.jpg,fore,Unspecified,0.0,0,142,130,159,156,17,26
16460,levle3_15.jpg,fore,Unspecified,0.0,0,113,136,138,156,25,20
16461,levle3_15.jpg,fore,Unspecified,0.0,0,119,103,147,135,28,32
16462,levle3_15.jpg,fore,Unspecified,0.0,0,178,152,202,187,24,35
16463,levle3_15.jpg,fore,Unspecified,0.0,0,138,207,155,231,17,24
16464,levle3_15.jpg,fore,Unspecified,0.0,0,188,236,213,263,25,27
16465,levle3_15.jpg,fore,Unspecified,0.0,0,147,233,178,262,31,29
16466,levle3_15.jpg,fore,Unspecified,0.0,0,190,179,213,197,23,18
16467,levle3_15.jpg,fore,Unspecified,0.0,0,103,369,126,404,23,35
16468,levle3_15.jpg,fore,Unspecified,0.0,0,178,115,204,139,26,24
16469,levle3_15.jpg,fore,Unspecified,0.0,0,213,150,230,171,17,21
16470,levle3_15.jpg,fore,Unspecified,0.0,0,240,233,277,253,37,20
16471,levle3_15.jpg,fore,Unspecified,0.0,0,259,257,277,283,18,26
16472,levle3_15.jpg,fore,Unspecified,0.0,0,156,297,181,320,25,23
16473,levle3_15.jpg,fore,Unspecified,0.0,0,194,329,216,349,22,20
16474,levle3_15.jpg,fore,Unspecified,0.0,0,194,285,216,324,22,39
16475,levle3_15.jpg,fore,Unspecified,0.0,0,222,300,245,324,23,24
16476,levle3_15.jpg,fore,Unspecified,0.0,0,210,334,256,357,46,23
16477,levle3_15.jpg,fore,Unspecified,0.0,0,227,363,248,386,21,23
16478,levle3_15.jpg,fore,Unspecified,0.0,0,242,376,263,402,21,26
16479,levle3_15.jpg,fore,Unspecified,0.0,0,210,375,233,402,23,27
16480,levle3_15.jpg,fore,Unspecified,0.0,0,173,384,199,413,26,29
16481,levle3_15.jpg,fore,Unspecified,0.0,0,127,315,149,343,22,28
16482,levle3_15.jpg,fore,Unspecified,0.0,0,107,338,136,364,29,26
16483,levle3_15.jpg,fore,Unspecified,0.0,0,152,415,171,438,19,23
16484,levle3_15.jpg,fore,Unspecified,0.0,0,181,421,199,459,18,38
16485,levle3_15.jpg,fore,Unspecified,0.0,0,141,435,159,467,18,32
16486,levle3_15.jpg,fore,Unspecified,0.0,0,165,464,188,485,23,21
16487,levle3_15.jpg,fore,Unspecified,0.0,0,100,465,142,496,42,31
16488,levle3_15.jpg,fore,Unspecified,0.0,0,132,474,170,511,38,37
16489,levle3_15.jpg,fore,Unspecified,0.0,0,63,482,101,523,38,41
16490,levle1_354.jpg,fore,Unspecified,0.0,0,670,2267,830,2474,160,207
16491,levle1_354.jpg,fore,Unspecified,0.0,0,968,2412,1068,2642,100,230
16492,levle1_354.jpg,fore,Unspecified,0.0,0,1206,2420,1428,2581,222,161
16493,levle1_354.jpg,fore,Unspecified,0.0,0,1152,2573,1290,2742,138,169
16494,levle1_354.jpg,fore,Unspecified,0.0,0,386,2029,608,2267,222,238
16495,levle1_354.jpg,fore,Unspecified,0.0,0,294,819,509,1025,215,206
16496,levle0_147.jpg,fore,Unspecified,0.0,0,2325,880,2432,1010,107,130
16497,levle1_340.jpg,fore,Unspecified,0.0,0,1214,2274,1359,2451,145,177
16498,levle1_340.jpg,fore,Unspecified,0.0,0,1367,2144,1474,2267,107,123
16499,levle1_340.jpg,fore,Unspecified,0.0,0,1589,2274,1712,2481,123,207
16500,levle1_340.jpg,fore,Unspecified,0.0,0,1788,2259,1903,2420,115,161
16501,levle1_340.jpg,fore,Unspecified,0.0,0,1911,2052,2087,2236,176,184
16502,levle1_340.jpg,fore,Unspecified,0.0,0,1451,1983,1551,2129,100,146
16503,levle1_340.jpg,fore,Unspecified,0.0,0,1260,2474,1413,2665,153,191
16504,levle0_153.jpg,fore,Unspecified,0.0,0,961,2857,1076,2979,115,122
16505,levle0_153.jpg,fore,Unspecified,0.0,0,968,2297,1099,2389,131,92
16506,levle0_153.jpg,fore,Unspecified,0.0,0,1420,1999,1520,2160,100,161
16507,levle1_426.jpg,fore,Unspecified,0.0,0,1735,2320,1896,2527,161,207
16508,levle1_426.jpg,fore,Unspecified,0.0,0,1980,2229,2233,2382,253,153
16509,levle1_426.jpg,fore,Unspecified,0.0,0,2256,2091,2417,2229,161,138
16510,levle1_426.jpg,fore,Unspecified,0.0,0,2386,2359,2631,2543,245,184
16511,levle1_426.jpg,fore,Unspecified,0.0,0,2440,1976,2647,2198,207,222
16512,levle1_426.jpg,fore,Unspecified,0.0,0,2394,1493,2570,1654,176,161
16513,levle1_368.jpg,fore,Unspecified,0.0,0,731,2872,838,3071,107,199
16514,levle1_368.jpg,fore,Unspecified,0.0,0,1022,2995,1129,3140,107,145
16515,levle1_368.jpg,fore,Unspecified,0.0,0,899,3056,976,3194,77,138
16516,levle1_368.jpg,fore,Unspecified,0.0,0,1459,3110,1520,3217,61,107
16517,levle3_29.jpg,fore,,,0,140,19,149,32,9,13
16518,levle3_29.jpg,fore,,,0,145,39,155,49,10,10
16519,levle3_29.jpg,fore,,,0,89,71,97,79,8,8
16520,levle3_29.jpg,fore,,,0,77,48,87,61,10,13
16521,levle3_29.jpg,fore,,,0,27,170,49,185,22,15
16522,levle3_29.jpg,fore,,,0,53,194,65,209,12,15
16523,levle3_29.jpg,fore,,,0,120,141,144,150,24,9
16524,levle3_29.jpg,fore,,,0,91,157,102,170,11,13
16525,levle3_29.jpg,fore,,,0,130,169,144,182,14,13
16526,levle3_29.jpg,fore,,,0,123,155,133,165,10,10
16527,levle3_29.jpg,fore,,,0,147,177,163,189,16,12
16528,levle3_29.jpg,fore,,,0,131,180,139,196,8,16
16529,levle3_29.jpg,fore,,,0,115,196,125,211,10,15
16530,levle3_29.jpg,fore,,,0,92,179,104,189,12,10
16531,levle3_29.jpg,fore,,,0,118,217,134,229,16,12
16532,levle3_29.jpg,fore,,,0,136,216,145,232,9,16
16533,levle3_29.jpg,fore,,,0,123,232,136,240,13,8
16534,levle3_29.jpg,fore,,,0,112,228,124,242,12,14
16535,levle3_29.jpg,fore,,,0,90,211,100,224,10,13
16536,levle3_29.jpg,fore,,,0,85,242,101,257,16,15
16537,levle3_29.jpg,fore,,,0,127,239,137,253,10,14
16538,levle3_29.jpg,fore,,,0,150,246,162,263,12,17
16539,levle3_29.jpg,fore,,,0,120,258,133,270,13,12
16540,levle3_29.jpg,fore,,,0,121,273,131,285,10,12
16541,levle3_29.jpg,fore,,,0,40,115,60,132,20,17
16542,levle3_29.jpg,fore,,,0,46,151,61,166,15,15
16543,levle3_29.jpg,fore,,,0,75,179,92,195,17,16
16544,levle3_29.jpg,fore,,,0,73,205,88,220,15,15
16545,levle3_29.jpg,fore,,,0,90,193,103,206,13,13
16546,levle3_29.jpg,fore,,,0,105,163,120,177,15,14
16547,levle3_29.jpg,fore,,,0,111,177,127,191,16,14
16548,levle3_29.jpg,fore,,,0,133,196,157,211,24,15
16549,levle3_29.jpg,fore,,,0,98,214,111,234,13,20
16550,levle3_29.jpg,fore,,,0,137,246,158,256,21,10
16551,levle3_29.jpg,fore,,,0,144,268,157,281,13,13
16552,levle3_29.jpg,fore,,,0,70,254,82,278,12,24
16553,levle3_29.jpg,fore,,,0,183,145,199,163,16,18
16554,levle3_29.jpg,fore,,,0,165,123,178,134,13,11
16555,levle3_29.jpg,fore,,,0,66,232,77,242,11,10
16556,levle3_29.jpg,fore,,,0,59,237,71,254,12,17
16557,levle3_29.jpg,fore,,,0,64,215,75,228,11,13
16558,levle3_29.jpg,fore,,,0,83,222,94,234,11,12
16559,levle3_29.jpg,fore,,,0,102,245,110,255,8,10
16560,levle3_29.jpg,fore,,,0,106,258,113,266,7,8
16561,levle3_29.jpg,fore,,,0,110,264,118,271,8,7
16562,levle3_29.jpg,fore,,,0,37,184,58,195,21,11
16563,levle3_29.jpg,fore,,,0,56,166,69,180,13,14
16564,levle3_29.jpg,fore,,,0,102,135,114,145,12,10
16565,levle3_29.jpg,fore,,,0,103,152,113,164,10,12
16566,levle3_29.jpg,fore,,,0,142,152,157,165,15,13
16567,levle3_29.jpg,fore,,,0,158,235,171,245,13,10
16568,levle3_29.jpg,fore,,,0,144,233,156,246,12,13
16569,levle3_29.jpg,fore,,,0,157,215,170,228,13,13
16570,levle1_422.jpg,fore,Unspecified,0.0,0,624,1301,761,1447,137,146
16571,levle1_422.jpg,fore,Unspecified,0.0,0,731,1447,907,1524,176,77
16572,levle1_422.jpg,fore,Unspecified,0.0,0,624,1531,800,1669,176,138
16573,levle1_422.jpg,fore,Unspecified,0.0,0,876,1692,1045,1784,169,92
16574,levle1_422.jpg,fore,Unspecified,0.0,0,899,1945,1053,2068,154,123
16575,levle1_422.jpg,fore,Unspecified,0.0,0,769,2129,1030,2244,261,115
16576,levle1_422.jpg,fore,Unspecified,0.0,0,1007,2474,1145,2581,138,107
16577,levle1_422.jpg,fore,Unspecified,0.0,0,1375,366,1543,489,168,123
16578,levle1_344.jpg,fore,Unspecified,0.0,0,1344,2535,1443,2727,99,192
16579,levle1_344.jpg,fore,Unspecified,0.0,0,1191,2405,1306,2581,115,176
16580,levle1_344.jpg,fore,Unspecified,0.0,0,1198,2229,1329,2405,131,176
16581,levle1_344.jpg,fore,Unspecified,0.0,0,1382,2397,1505,2520,123,123
16582,levle0_157.jpg,fore,Unspecified,0.0,0,723,1102,830,1248,107,146
16583,levle0_157.jpg,fore,Unspecified,0.0,0,1972,2213,2079,2359,107,146
16584,levle1_350.jpg,fore,Unspecified,0.0,0,2118,2221,2248,2374,130,153
16585,levle1_350.jpg,fore,Unspecified,0.0,0,2286,2114,2409,2282,123,168
16586,levle1_350.jpg,fore,Unspecified,0.0,0,2156,2504,2294,2665,138,161
16587,levle1_350.jpg,fore,Unspecified,0.0,0,2271,2359,2424,2512,153,153
16588,levle1_350.jpg,fore,Unspecified,0.0,0,2516,2328,2670,2497,154,169
16589,levle1_350.jpg,fore,Unspecified,0.0,0,2279,2987,2470,3140,191,153
16590,levle0_143.jpg,fore,Unspecified,0.0,0,2463,420,2555,550,92,130
16591,levle0_143.jpg,fore,Unspecified,0.0,0,2286,389,2432,520,146,131
16592,levle3_11.jpg,fore,,,0,517,390,556,431,39,41
16593,levle3_11.jpg,fore,,,0,455,553,505,616,50,63
16594,levle3_11.jpg,fore,,,0,409,396,439,444,30,48
16595,levle3_11.jpg,fore,,,0,372,362,416,401,44,39
16596,levle3_11.jpg,fore,,,0,359,312,399,351,40,39
16597,levle3_11.jpg,fore,,,0,294,318,349,355,55,37
16598,levle3_11.jpg,fore,,,0,299,350,358,389,59,39
16599,levle3_11.jpg,fore,,,0,294,406,361,440,67,34
16600,levle3_11.jpg,fore,,,0,292,444,368,481,76,37
16601,levle3_11.jpg,fore,,,0,251,408,276,445,25,37
16602,levle3_11.jpg,fore,,,0,411,481,448,499,37,18
16603,levle3_11.jpg,fore,,,0,519,305,546,341,27,36
16604,levle3_11.jpg,fore,,,0,526,275,556,291,30,16
16605,levle3_11.jpg,fore,,,0,473,305,510,339,37,34
16606,levle3_11.jpg,fore,,,0,445,330,485,365,40,35
16607,levle3_11.jpg,fore,,,0,427,303,464,332,37,29
16608,levle3_11.jpg,fore,,,0,514,231,548,252,34,21
16609,levle3_11.jpg,fore,,,0,508,153,542,192,34,39
16610,levle3_11.jpg,fore,,,0,521,188,549,204,28,16
16611,levle3_11.jpg,fore,,,0,429,34,473,57,44,23
16612,levle3_11.jpg,fore,,,0,391,114,422,149,31,35
16613,levle3_11.jpg,fore,,,0,370,167,409,183,39,16
16614,levle3_11.jpg,fore,,,0,388,190,423,222,35,32
16615,levle3_11.jpg,fore,,,0,374,255,418,291,44,36
16616,levle3_11.jpg,fore,,,0,328,250,367,287,39,37
16617,levle3_11.jpg,fore,,,0,436,142,478,179,42,37
16618,levle3_11.jpg,fore,,,0,551,302,574,334,23,32
16619,levle3_11.jpg,fore,,,0,423,257,473,296,50,39
16620,levle3_11.jpg,fore,,,0,464,199,489,223,25,24
16621,levle3_11.jpg,fore,,,0,573,252,600,278,27,26
16622,levle3_11.jpg,fore,,,0,495,436,516,458,21,22
16623,levle3_11.jpg,fore,,,0,462,424,495,446,33,22
16624,levle3_11.jpg,fore,,,0,491,411,521,435,30,24
16625,levle3_11.jpg,fore,,,0,542,486,572,513,30,27
16626,levle3_11.jpg,fore,,,0,526,516,560,553,34,37
16627,levle3_11.jpg,fore,,,0,467,487,512,525,45,38
16628,levle3_11.jpg,fore,,,0,488,519,526,547,38,28
16629,levle3_11.jpg,fore,,,0,339,156,368,189,29,33
16630,levle3_11.jpg,fore,,,0,411,74,444,97,33,23
16631,levle3_11.jpg,fore,,,0,458,107,496,137,38,30
16632,levle3_11.jpg,fore,,,0,271,349,296,381,25,32
16633,levle3_11.jpg,fore,,,0,408,340,433,370,25,30
16634,levle3_11.jpg,fore,,,0,496,345,528,378,32,33
16635,levle3_11.jpg,fore,,,0,484,289,517,312,33,23
16636,levle3_11.jpg,fore,,,0,484,258,517,289,33,31
16637,levle3_11.jpg,fore,,,0,362,220,386,249,24,29
16638,levle3_11.jpg,fore,,,0,428,186,459,206,31,20
16639,levle3_11.jpg,fore,,,0,482,154,508,179,26,25
16640,levle3_11.jpg,fore,,,0,484,179,511,206,27,27
16641,levle3_11.jpg,fore,,,0,362,109,392,135,30,26
16642,levle3_11.jpg,fore,,,0,441,73,473,99,32,26
16643,levle3_11.jpg,fore,,,0,392,226,432,255,40,29
16644,levle3_11.jpg,fore,,,0,310,295,340,319,30,24
16645,levle3_11.jpg,fore,,,0,403,290,433,316,30,26
16646,levle3_11.jpg,fore,,,0,388,487,413,511,25,24
16647,levle3_11.jpg,fore,,,0,399,511,420,530,21,19
16648,levle3_11.jpg,fore,,,0,549,551,574,578,25,27
16649,levle1_436.jpg,fore,Unspecified,0.0,0,294,2489,417,2581,123,92
16650,levle1_436.jpg,fore,Unspecified,0.0,0,378,2642,524,2757,146,115
16651,levle1_436.jpg,fore,Unspecified,0.0,0,876,2765,961,2865,85,100
16652,levle1_436.jpg,fore,Unspecified,0.0,0,715,2895,823,3025,108,130
16653,levle1_436.jpg,fore,Unspecified,0.0,0,892,2972,984,3133,92,161
16654,levle1_436.jpg,fore,Unspecified,0.0,0,1443,3194,1543,3309,100,115
16655,levle1_436.jpg,fore,Unspecified,0.0,0,371,2842,509,2987,138,145
16656,levle1_378.jpg,fore,Unspecified,0.0,0,2133,1171,2256,1309,123,138
16657,levle1_378.jpg,fore,Unspecified,0.0,0,1957,1225,2125,1416,168,191
16658,levle1_378.jpg,fore,Unspecified,0.0,0,2325,1301,2478,1493,153,192
16659,levle1_378.jpg,fore,Unspecified,0.0,0,1574,619,1696,803,122,184
16660,levle1_378.jpg,fore,Unspecified,0.0,0,2148,2336,2302,2497,154,161
16661,levle1_378.jpg,fore,Unspecified,0.0,0,1942,2221,2072,2420,130,199
16662,levle3_39.jpg,fore,Unspecified,0.0,0,319,39,351,82,32,43
16663,levle3_39.jpg,fore,Unspecified,0.0,0,220,204,264,257,44,53
16664,levle3_39.jpg,fore,Unspecified,0.0,0,316,308,359,344,43,36
16665,levle3_39.jpg,fore,Unspecified,0.0,0,324,459,359,507,35,48
16666,levle3_39.jpg,fore,Unspecified,0.0,0,313,526,327,551,14,25
16667,levle3_39.jpg,fore,Unspecified,0.0,0,303,504,342,535,39,31
16668,levle3_39.jpg,fore,Unspecified,0.0,0,191,455,233,495,42,40
16669,levle3_39.jpg,fore,Unspecified,0.0,0,434,500,457,535,23,35
16670,levle3_39.jpg,fore,Unspecified,0.0,0,492,595,513,619,21,24
16671,levle3_39.jpg,fore,Unspecified,0.0,0,477,628,510,669,33,41
16672,levle3_39.jpg,fore,Unspecified,0.0,0,427,231,457,279,30,48
16673,levle3_39.jpg,fore,Unspecified,0.0,0,389,301,427,335,38,34
16674,levle3_39.jpg,fore,Unspecified,0.0,0,357,323,393,382,36,59
16675,levle3_39.jpg,fore,Unspecified,0.0,0,407,367,443,405,36,38
16676,levle3_39.jpg,fore,Unspecified,0.0,0,458,382,480,426,22,44
16677,levle3_39.jpg,fore,Unspecified,0.0,0,415,405,440,438,25,33
16678,levle3_39.jpg,fore,Unspecified,0.0,0,400,427,454,476,54,49
16679,levle3_39.jpg,fore,Unspecified,0.0,0,315,417,372,446,57,29
16680,levle3_39.jpg,fore,Unspecified,0.0,0,261,355,306,427,45,72
16681,levle3_39.jpg,fore,Unspecified,0.0,0,197,275,239,334,42,59
16682,levle3_39.jpg,fore,Unspecified,0.0,0,135,320,197,382,62,62
16683,levle3_39.jpg,fore,Unspecified,0.0,0,247,435,298,477,51,42
16684,levle3_39.jpg,fore,Unspecified,0.0,0,298,517,307,529,9,12
16685,levle3_39.jpg,fore,Unspecified,0.0,0,350,560,375,600,25,40
16686,levle3_39.jpg,fore,Unspecified,0.0,0,418,557,466,594,48,37
16687,levle3_39.jpg,fore,Unspecified,0.0,0,463,240,496,289,33,49
16688,levle1_387.jpg,fore,Unspecified,0.0,0,1198,1700,1321,1845,123,145
16689,levle1_387.jpg,fore,Unspecified,0.0,0,1673,1133,1850,1332,177,199
16690,levle1_387.jpg,fore,Unspecified,0.0,0,1896,566,1972,727,76,161
16691,levle1_387.jpg,fore,Unspecified,0.0,0,961,2512,1129,2665,168,153
16692,levle1_387.jpg,fore,Unspecified,0.0,0,1099,2711,1214,2819,115,108
16693,levle1_387.jpg,fore,Unspecified,0.0,0,1673,2244,1819,2343,146,99
16694,levle0_194.jpg,fore,Unspecified,0.0,0,409,2512,547,2727,138,215
16695,levle0_194.jpg,fore,Unspecified,0.0,0,823,2757,922,2956,99,199
16696,levle0_194.jpg,fore,Unspecified,0.0,0,708,2098,846,2305,138,207
16697,levle0_194.jpg,fore,Unspecified,0.0,0,1643,2857,1811,2964,168,107
16698,levle1_393.jpg,fore,Unspecified,0.0,0,463,2428,601,2512,138,84
16699,levle1_393.jpg,fore,Unspecified,0.0,0,401,2221,524,2343,123,122
16700,levle1_393.jpg,fore,Unspecified,0.0,0,409,1930,524,2060,115,130
16701,levle1_393.jpg,fore,Unspecified,0.0,0,769,2849,884,3041,115,192
16702,levle1_393.jpg,fore,Unspecified,0.0,0,1083,2719,1198,2842,115,123
16703,levle1_393.jpg,fore,Unspecified,0.0,0,991,3194,1129,3355,138,161
16704,levle1_393.jpg,fore,Unspecified,0.0,0,1505,3217,1604,3347,99,130
16705,levle0_180.jpg,fore,Unspecified,0.0,0,578,1554,723,1700,145,146
16706,levle0_355.jpg,fore,Unspecified,0.0,0,2378,2819,2539,2972,161,153
16707,levle0_355.jpg,fore,Unspecified,0.0,0,2049,3079,2171,3271,122,192
16708,levle0_355.jpg,fore,Unspecified,0.0,0,1865,3133,2049,3317,184,184
16709,levle1_146.jpg,fore,,,0,1237,1363,1329,1547,92,184
16710,levle1_146.jpg,fore,,,0,2263,2290,2401,2420,138,130
16711,levle1_146.jpg,fore,,,0,1788,2175,1965,2320,177,145
16712,levle1_146.jpg,fore,,,0,1781,2512,1903,2635,122,123
16713,levle1_146.jpg,fore,,,0,1965,2880,2057,2995,92,115
16714,levle1_146.jpg,fore,,,0,2436,2139,2557,2257,121,118
16715,levle0_68.jpg,fore,Unspecified,0.0,0,2475,1460,2650,1668,175,208
16716,levle0_68.jpg,fore,Unspecified,0.0,0,3414,2707,3564,2973,150,266
16717,levle0_68.jpg,fore,Unspecified,0.0,0,2774,47,3007,247,233,200
16718,levle1_620.jpg,fore,Unspecified,0.0,0,325,2175,493,2297,168,122
16719,levle1_620.jpg,fore,Unspecified,0.0,0,715,2773,846,2964,131,191
16720,levle1_620.jpg,fore,Unspecified,0.0,0,892,2765,999,2926,107,161
16721,levle1_620.jpg,fore,Unspecified,0.0,0,792,3156,922,3286,130,130
16722,levle1_620.jpg,fore,Unspecified,0.0,0,1091,3094,1183,3209,92,115
16723,levle1_620.jpg,fore,Unspecified,0.0,0,1221,2865,1352,3025,131,160
16724,levle1_620.jpg,fore,Unspecified,0.0,0,1489,2949,1612,3056,123,107
16725,levle1_634.jpg,fore,Unspecified,0.0,0,670,1002,777,1125,107,123
16726,levle1_634.jpg,fore,Unspecified,0.0,0,378,1501,547,1638,169,137
16727,levle1_634.jpg,fore,Unspecified,0.0,0,547,1455,616,1600,69,145
16728,levle1_634.jpg,fore,Unspecified,0.0,0,769,1432,861,1562,92,130
16729,levle1_634.jpg,fore,Unspecified,0.0,0,539,2320,662,2573,123,253
16730,levle1_634.jpg,fore,Unspecified,0.0,0,731,2382,953,2550,222,168
16731,levle1_634.jpg,fore,Unspecified,0.0,0,792,2826,968,2949,176,123
16732,levle1_634.jpg,fore,Unspecified,0.0,0,830,2941,961,3071,131,130
16733,levle0_427.jpg,fore,Unspecified,0.0,0,1451,757,1581,819,130,62
16734,levle0_341.jpg,fore,Unspecified,0.0,0,2225,1340,2348,1493,123,153
16735,levle1_152.jpg,fore,Unspecified,0.0,0,2003,328,2164,504,161,176
16736,levle1_152.jpg,fore,Unspecified,0.0,0,539,1516,700,1677,161,161
16737,levle1_152.jpg,fore,Unspecified,0.0,0,532,1294,677,1470,145,176
16738,levle1_152.jpg,fore,Unspecified,0.0,0,562,1715,708,1884,146,169
16739,levle1_152.jpg,fore,Unspecified,0.0,0,769,1769,938,1914,169,145
16740,levle1_152.jpg,fore,Unspecified,0.0,0,532,2229,685,2336,153,107
16741,levle1_152.jpg,fore,Unspecified,0.0,0,516,2359,677,2527,161,168
16742,levle1_152.jpg,fore,Unspecified,0.0,0,1191,2520,1344,2673,153,153
16743,levle1_152.jpg,fore,Unspecified,0.0,0,141,2175,294,2351,153,176
16744,levle1_152.jpg,fore,Unspecified,0.0,0,309,2458,417,2596,108,138
16745,levle0_54.jpg,fore,Unspecified,0.0,0,1129,2627,1283,2788,154,161
16746,levle0_54.jpg,fore,Unspecified,0.0,0,1451,2642,1589,2780,138,138
16747,levle0_54.jpg,fore,Unspecified,0.0,0,1129,2466,1275,2619,146,153
16748,levle0_54.jpg,fore,Unspecified,0.0,0,302,2320,424,2458,122,138
16749,levle0_54.jpg,fore,Unspecified,0.0,0,509,2512,654,2704,145,192
16750,levle0_40.jpg,fore,Unspecified,0.0,0,2555,2106,2754,2244,199,138
16751,levle1_608.jpg,fore,Unspecified,0.0,0,1857,2160,1988,2259,131,99
16752,levle1_608.jpg,fore,Unspecified,0.0,0,1995,2037,2110,2175,115,138
16753,levle1_608.jpg,fore,Unspecified,0.0,0,1942,2435,2034,2558,92,123
16754,levle1_608.jpg,fore,Unspecified,0.0,0,1627,2458,1773,2581,146,123
16755,levle1_608.jpg,fore,Unspecified,0.0,0,1037,2972,1206,3117,169,145
16756,levle1_608.jpg,fore,Unspecified,0.0,0,1244,3148,1397,3232,153,84
16757,levle1_608.jpg,fore,Unspecified,0.0,0,1198,2987,1306,3079,108,92
16758,levle1_608.jpg,fore,Unspecified,0.0,0,738,1830,899,1953,161,123
16759,levle0_396.jpg,fore,Unspecified,0.0,0,1681,3309,1765,3439,84,130
16760,levle0_396.jpg,fore,Unspecified,0.0,0,2018,3263,2148,3416,130,153
16761,levle1_185.jpg,fore,Unspecified,0.0,0,945,604,1114,688,169,84
16762,levle1_185.jpg,fore,Unspecified,0.0,0,677,320,815,443,138,123
16763,levle1_185.jpg,fore,Unspecified,0.0,0,861,236,984,336,123,100
16764,levle1_185.jpg,fore,Unspecified,0.0,0,194,2688,294,2780,100,92
16765,levle1_185.jpg,fore,Unspecified,0.0,0,248,2788,409,2880,161,92
16766,levle1_185.jpg,fore,Unspecified,0.0,0,248,2895,386,3002,138,107
16767,levle1_185.jpg,fore,Unspecified,0.0,0,417,3156,501,3271,84,115
16768,levle1_185.jpg,fore,Unspecified,0.0,0,501,3179,578,3271,77,92
16769,levle0_382.jpg,fore,Unspecified,0.0,0,332,918,463,1025,131,107
16770,levle0_382.jpg,fore,Unspecified,0.0,0,1037,152,1206,336,169,184
16771,levle0_382.jpg,fore,Unspecified,0.0,0,72,2520,187,2658,115,138
16772,levle0_382.jpg,fore,Unspecified,0.0,0,1765,2144,1896,2274,131,130
16773,levle1_191.jpg,fore,Unspecified,0.0,0,1183,305,1397,489,214,184
16774,levle1_191.jpg,fore,Unspecified,0.0,0,1260,550,1420,704,160,154
16775,levle1_191.jpg,fore,Unspecified,0.0,0,1252,2045,1397,2190,145,145
16776,levle1_191.jpg,fore,Unspecified,0.0,0,2064,2872,2194,3025,130,153
16777,levle1_191.jpg,fore,Unspecified,0.0,0,2011,3079,2171,3278,160,199
16778,levle1_191.jpg,fore,Unspecified,0.0,0,2309,2083,2417,2251,108,168
16779,levle1_191.jpg,fore,Unspecified,0.0,0,1175,1554,1290,1692,115,138
16780,levle0_97.jpg,fore,Unspecified,0.0,0,2846,780,2968,972,122,192
16781,levle0_97.jpg,fore,Unspecified,0.0,0,2631,543,2769,757,138,214
16782,levle0_83.jpg,fore,Unspecified,0.0,0,2791,2765,2991,2873,200,108
16783,levle0_221.jpg,fore,Unspecified,0.0,0,861,3110,961,3248,100,138
16784,levle0_221.jpg,fore,Unspecified,0.0,0,899,3033,1045,3133,146,100
16785,levle2_79.jpg,fore,,,0,2355,1110,2463,1255,108,145
16786,levle2_79.jpg,fore,,,0,2424,1102,2608,1317,184,215
16787,levle2_79.jpg,fore,,,0,2547,1209,2716,1386,169,177
16788,levle2_79.jpg,fore,,,0,2700,1324,2807,1470,107,146
16789,levle2_79.jpg,fore,,,0,2555,1462,2693,1623,138,161
16790,levle2_79.jpg,fore,,,0,2662,1585,2739,1746,77,161
16791,levle2_79.jpg,fore,,,0,2838,1646,2953,1884,115,238
16792,levle2_79.jpg,fore,,,0,2631,1746,2777,1914,146,168
16793,levle2_79.jpg,fore,,,0,2555,2420,2762,2573,207,153
16794,levle2_79.jpg,fore,,,0,2731,2535,2846,2688,115,153
16795,levle2_79.jpg,fore,,,0,2156,2627,2332,2734,176,107
16796,levle2_79.jpg,fore,,,0,2041,2405,2217,2589,176,184
16797,levle2_79.jpg,fore,,,0,2057,1010,2179,1179,122,169
16798,levle2_79.jpg,fore,,,0,2792,1930,2984,2160,192,230
16799,levle2_79.jpg,fore,,,0,1564,2588,1691,2688,127,100
16800,levle2_79.jpg,fore,,,0,1760,3229,1877,3315,117,86
16801,levle2_79.jpg,fore,,,0,1702,3298,1822,3405,120,107
16802,levle2_79.jpg,fore,,,0,1991,2632,2077,2736,86,104
16803,levle2_79.jpg,fore,,,0,2671,2122,2795,2257,124,135
16804,levle2_79.jpg,fore,,,0,1602,3284,1695,3398,93,114
16805,levle2_79.jpg,fore,,,0,2443,2643,2591,2777,148,134
16806,levle0_235.jpg,fore,Unspecified,0.0,0,2371,1677,2486,1815,115,138
16807,levle0_235.jpg,fore,Unspecified,0.0,0,2432,2328,2547,2520,115,192
16808,levle2_51.jpg,fore,Unspecified,0.0,0,2924,612,3132,779,208,167
16809,levle2_51.jpg,fore,Unspecified,0.0,0,3157,446,3406,629,249,183
16810,levle2_51.jpg,fore,Unspecified,0.0,0,3365,296,3572,521,207,225
16811,levle2_51.jpg,fore,Unspecified,0.0,0,3240,629,3539,837,299,208
16812,levle2_51.jpg,fore,Unspecified,0.0,0,2234,1418,2467,1684,233,266
16813,levle2_51.jpg,fore,Unspecified,0.0,0,2417,1626,2550,1784,133,158
16814,levle2_51.jpg,fore,Unspecified,0.0,0,2259,1834,2409,2034,150,200
16815,levle2_51.jpg,fore,Unspecified,0.0,0,2409,1876,2583,2042,174,166
16816,levle2_51.jpg,fore,Unspecified,0.0,0,2608,1568,2733,1726,125,158
16817,levle2_51.jpg,fore,Unspecified,0.0,0,2018,2150,2168,2358,150,208
16818,levle2_51.jpg,fore,Unspecified,0.0,0,2284,2291,2434,2482,150,191
16819,levle2_51.jpg,fore,Unspecified,0.0,0,2209,2416,2459,2615,250,199
16820,levle2_51.jpg,fore,Unspecified,0.0,0,1918,2541,2110,2715,192,174
16821,levle2_51.jpg,fore,Unspecified,0.0,0,2226,2615,2525,2748,299,133
16822,levle2_51.jpg,fore,Unspecified,0.0,0,2467,2491,2700,2649,233,158
16823,levle2_51.jpg,fore,Unspecified,0.0,0,2650,2574,2866,2782,216,208
16824,levle2_51.jpg,fore,Unspecified,0.0,0,2508,2707,2766,2865,258,158
16825,levle2_51.jpg,fore,Unspecified,0.0,0,2267,2757,2567,2881,300,124
16826,levle2_51.jpg,fore,Unspecified,0.0,0,2093,2881,2226,3072,133,191
16827,levle2_51.jpg,fore,Unspecified,0.0,0,2351,2856,2533,2956,182,100
16828,levle2_51.jpg,fore,Unspecified,0.0,0,2417,2956,2641,3106,224,150
16829,levle2_51.jpg,fore,Unspecified,0.0,0,2600,1967,2766,2133,166,166
16830,levle2_51.jpg,fore,Unspecified,0.0,0,2666,1809,2899,1942,233,133
16831,levle2_51.jpg,fore,Unspecified,0.0,0,2641,2283,2858,2499,217,216
16832,levle2_51.jpg,fore,Unspecified,0.0,0,2666,1269,2916,1402,250,133
16833,levle2_51.jpg,fore,Unspecified,0.0,0,2841,1402,3074,1643,233,241
16834,levle2_51.jpg,fore,Unspecified,0.0,0,2982,1227,3173,1369,191,142
16835,levle2_51.jpg,fore,Unspecified,0.0,0,3057,1477,3182,1626,125,149
16836,levle2_51.jpg,fore,Unspecified,0.0,0,3157,1826,3373,2142,216,316
16837,levle2_51.jpg,fore,Unspecified,0.0,0,3232,1194,3381,1360,149,166
16838,levle2_51.jpg,fore,Unspecified,0.0,0,3414,1119,3647,1310,233,191
16839,levle2_51.jpg,fore,Unspecified,0.0,0,2858,188,2991,330,133,142
16840,levle2_51.jpg,fore,Unspecified,0.0,0,2974,238,3132,413,158,175
16841,levle2_51.jpg,fore,Unspecified,0.0,0,3132,222,3323,438,191,216
16842,levle2_51.jpg,fore,Unspecified,0.0,0,3065,6,3331,263,266,257
16843,levle0_209.jpg,fore,Unspecified,0.0,0,2049,2596,2233,2765,184,169
16844,levle0_209.jpg,fore,Unspecified,0.0,0,2079,2068,2187,2282,108,214
16845,levle2_45.jpg,fore,Unspecified,0.0,0,3331,837,3497,1003,166,166
16846,levle2_45.jpg,fore,Unspecified,0.0,0,2808,712,3107,812,299,100
16847,levle2_45.jpg,fore,Unspecified,0.0,0,2741,845,2924,1078,183,233
16848,levle2_45.jpg,fore,Unspecified,0.0,0,2525,961,2683,1177,158,216
16849,levle2_45.jpg,fore,Unspecified,0.0,0,2251,1003,2525,1219,274,216
16850,levle2_45.jpg,fore,Unspecified,0.0,0,2666,1053,2849,1236,183,183
16851,levle2_45.jpg,fore,Unspecified,0.0,0,2575,1327,2824,1485,249,158
16852,levle2_45.jpg,fore,Unspecified,0.0,0,2409,1377,2558,1560,149,183
16853,levle2_45.jpg,fore,Unspecified,0.0,0,2309,1443,2459,1585,150,142
16854,levle2_45.jpg,fore,Unspecified,0.0,0,2143,1194,2326,1369,183,175
16855,levle2_45.jpg,fore,Unspecified,0.0,0,2018,1344,2193,1568,175,224
16856,levle2_45.jpg,fore,Unspecified,0.0,0,2043,1601,2209,1718,166,117
16857,levle2_45.jpg,fore,Unspecified,0.0,0,2134,1668,2309,1851,175,183
16858,levle2_45.jpg,fore,Unspecified,0.0,0,2309,1693,2484,1909,175,216
16859,levle2_45.jpg,fore,Unspecified,0.0,0,2392,1585,2658,1834,266,249
16860,levle2_45.jpg,fore,Unspecified,0.0,0,2625,1468,2791,1651,166,183
16861,levle2_45.jpg,fore,Unspecified,0.0,0,2641,1676,2816,1809,175,133
16862,levle2_45.jpg,fore,Unspecified,0.0,0,2824,1443,2999,1676,175,233
16863,levle2_45.jpg,fore,Unspecified,0.0,0,3015,1294,3190,1510,175,216
16864,levle2_45.jpg,fore,Unspecified,0.0,0,3173,1310,3431,1468,258,158
16865,levle2_45.jpg,fore,Unspecified,0.0,0,2716,2009,2966,2225,250,216
16866,levle2_45.jpg,fore,Unspecified,0.0,0,2342,1842,2650,2025,308,183
16867,levle2_45.jpg,fore,Unspecified,0.0,0,2641,2316,2833,2541,192,225
16868,levle2_45.jpg,fore,Unspecified,0.0,0,2891,2225,2991,2341,100,116
16869,levle2_45.jpg,fore,Unspecified,0.0,0,2932,2482,3049,2640,117,158
16870,levle2_45.jpg,fore,Unspecified,0.0,0,3655,2117,3822,2233,167,116
16871,levle2_45.jpg,fore,Unspecified,0.0,0,3938,2175,4063,2291,125,116
16872,levle2_45.jpg,fore,Unspecified,0.0,0,3497,2516,3556,2599,59,83
16873,levle2_45.jpg,fore,Unspecified,0.0,0,3481,2582,3664,2823,183,241
16874,levle2_45.jpg,fore,Unspecified,0.0,0,3348,2649,3456,2806,108,157
16875,levle2_45.jpg,fore,Unspecified,0.0,0,3381,2374,3581,2516,200,142
16876,levle2_45.jpg,fore,Unspecified,0.0,0,3639,2266,3888,2516,249,250
16877,levle2_132.jpg,fore,Unspecified,0.0,0,493,1455,631,1585,138,130
16878,levle2_132.jpg,fore,Unspecified,0.0,0,509,1102,601,1202,92,100
16879,levle2_132.jpg,fore,Unspecified,0.0,0,1804,642,1919,796,115,154
16880,levle2_132.jpg,fore,Unspecified,0.0,0,463,1815,585,1899,122,84
16881,levle2_132.jpg,fore,Unspecified,0.0,0,440,1891,555,1983,115,92
16882,levle2_132.jpg,fore,Unspecified,0.0,0,401,1968,509,2129,108,161
16883,levle2_132.jpg,fore,Unspecified,0.0,0,363,2106,493,2167,130,61
16884,levle2_132.jpg,fore,Unspecified,0.0,0,463,2175,616,2282,153,107
16885,levle2_132.jpg,fore,Unspecified,0.0,0,570,2014,662,2098,92,84
16886,levle2_132.jpg,fore,Unspecified,0.0,0,639,2183,754,2259,115,76
16887,levle2_132.jpg,fore,Unspecified,0.0,0,493,2405,585,2550,92,145
16888,levle2_132.jpg,fore,Unspecified,0.0,0,601,2497,723,2627,122,130
16889,levle2_132.jpg,fore,Unspecified,0.0,0,731,2343,869,2451,138,108
16890,levle2_132.jpg,fore,Unspecified,0.0,0,1244,2052,1382,2175,138,123
16891,levle2_132.jpg,fore,Unspecified,0.0,0,869,2481,991,2612,122,131
16892,levle2_132.jpg,fore,Unspecified,0.0,0,838,2635,961,2750,123,115
16893,levle2_132.jpg,fore,Unspecified,0.0,0,938,2727,1030,2880,92,153
16894,levle2_132.jpg,fore,Unspecified,0.0,0,1060,2719,1175,2857,115,138
16895,levle2_132.jpg,fore,Unspecified,0.0,0,991,2857,1076,2964,85,107
16896,levle2_132.jpg,fore,Unspecified,0.0,0,930,2987,1091,3064,161,77
16897,levle2_132.jpg,fore,Unspecified,0.0,0,1574,3232,1727,3347,153,115
16898,levle2_132.jpg,fore,Unspecified,0.0,0,1842,3209,1919,3301,77,92
16899,levle2_132.jpg,fore,Unspecified,0.0,0,1099,2504,1244,2635,145,131
16900,levle2_132.jpg,fore,Unspecified,0.0,0,1658,3087,1804,3240,146,153
16901,levle2_126.jpg,fore,Unspecified,0.0,0,2332,941,2455,1033,123,92
16902,levle2_126.jpg,fore,Unspecified,0.0,0,2378,1018,2486,1117,108,99
16903,levle2_126.jpg,fore,Unspecified,0.0,0,2455,995,2562,1079,107,84
16904,levle2_126.jpg,fore,Unspecified,0.0,0,1382,612,1497,742,115,130
16905,levle2_126.jpg,fore,Unspecified,0.0,0,1091,880,1252,1033,161,153
16906,levle2_126.jpg,fore,Unspecified,0.0,0,892,2152,991,2274,99,122
16907,levle2_126.jpg,fore,Unspecified,0.0,0,1566,3079,1666,3240,100,161
16908,levle2_126.jpg,fore,Unspecified,0.0,0,1313,3087,1405,3232,92,145
16909,levle2_126.jpg,fore,Unspecified,0.0,0,1842,2911,1965,3071,123,160
16910,levle2_126.jpg,fore,Unspecified,0.0,0,2095,2750,2225,2903,130,153
16911,levle2_126.jpg,fore,Unspecified,0.0,0,2240,2711,2340,2819,100,108
16912,levle2_126.jpg,fore,Unspecified,0.0,0,2409,2727,2532,2811,123,84
16913,levle2_126.jpg,fore,Unspecified,0.0,0,2493,2734,2593,2849,100,115
16914,levle2_126.jpg,fore,Unspecified,0.0,0,2355,2558,2478,2704,123,146
16915,levle2_126.jpg,fore,Unspecified,0.0,0,2309,2351,2409,2458,100,107
16916,levle2_126.jpg,fore,Unspecified,0.0,0,2087,2596,2256,2704,169,108
16917,levle2_126.jpg,fore,Unspecified,0.0,0,1896,2550,2049,2642,153,92
16918,levle2_126.jpg,fore,Unspecified,0.0,0,1850,2673,1995,2742,145,69
16919,levle2_126.jpg,fore,Unspecified,0.0,0,2164,1117,2355,1393,191,276
16920,levle2_126.jpg,fore,Unspecified,0.0,0,2417,1868,2662,2083,245,215
16921,levle2_126.jpg,fore,Unspecified,0.0,0,2256,2060,2424,2259,168,199
16922,levle2_126.jpg,fore,Unspecified,0.0,0,2102,2274,2248,2466,146,192
16923,levle2_126.jpg,fore,Unspecified,0.0,0,2631,2949,2746,3002,115,53
16924,levle2_92.jpg,fore,Unspecified,0.0,0,135,82,140,89,5,7
16925,levle2_92.jpg,fore,Unspecified,0.0,0,135,91,143,100,8,9
16926,levle2_92.jpg,fore,Unspecified,0.0,0,126,80,134,89,8,9
16927,levle2_92.jpg,fore,Unspecified,0.0,0,113,80,127,88,14,8
16928,levle2_92.jpg,fore,Unspecified,0.0,0,121,69,128,76,7,7
16929,levle2_92.jpg,fore,Unspecified,0.0,0,121,95,130,104,9,9
16930,levle2_92.jpg,fore,Unspecified,0.0,0,128,106,134,114,6,8
16931,levle2_92.jpg,fore,Unspecified,0.0,0,118,116,125,123,7,7
16932,levle2_92.jpg,fore,Unspecified,0.0,0,125,120,134,129,9,9
16933,levle2_92.jpg,fore,Unspecified,0.0,0,107,101,115,109,8,8
16934,levle2_92.jpg,fore,Unspecified,0.0,0,102,99,110,111,8,12
16935,levle2_92.jpg,fore,Unspecified,0.0,0,123,131,131,140,8,9
16936,levle2_92.jpg,fore,Unspecified,0.0,0,113,132,121,140,8,8
16937,levle2_92.jpg,fore,Unspecified,0.0,0,113,140,120,147,7,7
16938,levle2_92.jpg,fore,Unspecified,0.0,0,119,145,128,152,9,7
16939,levle2_92.jpg,fore,Unspecified,0.0,0,145,152,157,167,12,15
16940,levle2_92.jpg,fore,Unspecified,0.0,0,158,137,165,143,7,6
16941,levle2_92.jpg,fore,Unspecified,0.0,0,107,125,117,134,10,9
16942,levle2_92.jpg,fore,Unspecified,0.0,0,99,129,110,141,11,12
16943,levle2_92.jpg,fore,Unspecified,0.0,0,87,137,96,142,9,5
16944,levle2_92.jpg,fore,Unspecified,0.0,0,83,117,92,125,9,8
16945,levle2_92.jpg,fore,Unspecified,0.0,0,77,106,88,116,11,10
16946,levle2_92.jpg,fore,Unspecified,0.0,0,72,93,83,105,11,12
16947,levle2_92.jpg,fore,Unspecified,0.0,0,72,48,81,56,9,8
16948,levle2_92.jpg,fore,Unspecified,0.0,0,75,39,80,47,5,8
16949,levle2_92.jpg,fore,Unspecified,0.0,0,81,36,87,45,6,9
16950,levle2_92.jpg,fore,Unspecified,0.0,0,87,72,98,84,11,12
16951,levle2_86.jpg,fore,Unspecified,0.0,0,2401,1899,2532,2022,131,123
16952,levle2_86.jpg,fore,Unspecified,0.0,0,1980,1945,2102,2052,122,107
16953,levle2_86.jpg,fore,Unspecified,0.0,0,1528,2144,1643,2259,115,115
16954,levle2_86.jpg,fore,Unspecified,0.0,0,1543,2366,1658,2466,115,100
16955,levle2_86.jpg,fore,Unspecified,0.0,0,1696,2834,1842,2956,146,122
16956,levle2_86.jpg,fore,Unspecified,0.0,0,1942,2405,2026,2520,84,115
16957,levle2_86.jpg,fore,Unspecified,0.0,0,2110,2504,2210,2619,100,115
16958,levle2_86.jpg,fore,Unspecified,0.0,0,2087,2343,2187,2466,100,123
16959,levle2_86.jpg,fore,Unspecified,0.0,0,1014,3048,1114,3248,100,200
16960,levle2_86.jpg,fore,Unspecified,0.0,0,1298,681,1428,834,130,153
16961,levle2_86.jpg,fore,Unspecified,0.0,0,2386,2190,2463,2290,77,100
16962,levle1_556.jpg,fore,Unspecified,0.0,0,2470,1730,2562,1845,92,115
16963,levle1_556.jpg,fore,Unspecified,0.0,0,2455,1845,2578,1999,123,154
16964,levle1_556.jpg,fore,Unspecified,0.0,0,2332,1976,2455,2160,123,184
16965,levle1_556.jpg,fore,Unspecified,0.0,0,2187,2098,2294,2229,107,131
16966,levle1_556.jpg,fore,Unspecified,0.0,0,1865,2144,2011,2297,146,153
16967,levle1_556.jpg,fore,Unspecified,0.0,0,1681,2389,1719,2520,38,131
16968,levle1_556.jpg,fore,Unspecified,0.0,0,1888,2474,2057,2604,169,130
16969,levle1_556.jpg,fore,Unspecified,0.0,0,1980,2619,2133,2765,153,146
16970,levle1_556.jpg,fore,Unspecified,0.0,0,2194,2405,2263,2543,69,138
16971,levle1_556.jpg,fore,Unspecified,0.0,0,2631,2443,2769,2604,138,161
16972,levle1_556.jpg,fore,Unspecified,0.0,0,2263,2819,2378,2987,115,168
16973,levle1_556.jpg,fore,Unspecified,0.0,0,2057,2803,2102,2888,45,85
16974,levle1_556.jpg,fore,Unspecified,0.0,0,1911,2811,2026,2934,115,123
16975,levle1_556.jpg,fore,Unspecified,0.0,0,1934,2941,2034,3094,100,153
16976,levle1_230.jpg,fore,Unspecified,0.0,0,578,2006,708,2098,130,92
16977,levle1_230.jpg,fore,Unspecified,0.0,0,601,2144,746,2251,145,107
16978,levle1_230.jpg,fore,Unspecified,0.0,0,555,2259,692,2351,137,92
16979,levle1_230.jpg,fore,Unspecified,0.0,0,723,2259,838,2328,115,69
16980,levle1_230.jpg,fore,Unspecified,0.0,0,647,2405,769,2558,122,153
16981,levle1_230.jpg,fore,Unspecified,0.0,0,892,2527,1014,2658,122,131
16982,levle1_230.jpg,fore,Unspecified,0.0,0,869,2665,1022,2780,153,115
16983,levle1_230.jpg,fore,Unspecified,0.0,0,784,2527,861,2642,77,115
16984,levle1_230.jpg,fore,Unspecified,0.0,0,815,2811,953,2956,138,145
16985,levle1_224.jpg,fore,Unspecified,0.0,0,562,2397,677,2558,115,161
16986,levle1_224.jpg,fore,Unspecified,0.0,0,233,2167,355,2251,122,84
16987,levle1_224.jpg,fore,Unspecified,0.0,0,853,2842,991,2995,138,153
16988,levle1_224.jpg,fore,Unspecified,0.0,0,233,2773,394,2926,161,153
16989,levle1_224.jpg,fore,Unspecified,0.0,0,976,3094,1091,3232,115,138
16990,levle1_224.jpg,fore,Unspecified,0.0,0,1367,3033,1482,3194,115,161
16991,levle1_224.jpg,fore,Unspecified,0.0,0,1727,3087,1850,3171,123,84
16992,levle1_14.jpg,fore,Unspecified,0.0,0,219,110,257,144,38,34
16993,levle1_14.jpg,fore,Unspecified,0.0,0,347,141,365,166,18,25
16994,levle1_14.jpg,fore,Unspecified,0.0,0,373,195,391,224,18,29
16995,levle1_14.jpg,fore,Unspecified,0.0,0,418,264,437,285,19,21
16996,levle1_14.jpg,fore,Unspecified,0.0,0,442,289,461,311,19,22
16997,levle1_14.jpg,fore,Unspecified,0.0,0,454,270,476,290,22,20
16998,levle1_14.jpg,fore,Unspecified,0.0,0,418,234,444,256,26,22
16999,levle1_14.jpg,fore,Unspecified,0.0,0,481,150,501,173,20,23
17000,levle1_14.jpg,fore,Unspecified,0.0,0,456,187,482,200,26,13
17001,levle1_14.jpg,fore,Unspecified,0.0,0,466,203,489,222,23,19
17002,levle1_542.jpg,fore,Unspecified,0.0,0,2233,1094,2340,1240,107,146
17003,levle1_542.jpg,fore,Unspecified,0.0,0,1988,1071,2110,1202,122,131
17004,levle1_542.jpg,fore,Unspecified,0.0,0,1252,2236,1375,2351,123,115
17005,levle1_542.jpg,fore,Unspecified,0.0,0,1206,2550,1336,2673,130,123
17006,levle1_542.jpg,fore,Unspecified,0.0,0,1673,2834,1804,2941,131,107
17007,levle1_542.jpg,fore,Unspecified,0.0,0,976,2236,1068,2351,92,115
17008,levle1_218.jpg,fore,Unspecified,0.0,0,1252,589,1405,711,153,122
17009,levle1_218.jpg,fore,Unspecified,0.0,0,1091,734,1191,819,100,85
17010,levle1_218.jpg,fore,Unspecified,0.0,0,102,1723,217,1838,115,115
17011,levle1_218.jpg,fore,Unspecified,0.0,0,340,2091,463,2167,123,76
17012,levle1_218.jpg,fore,Unspecified,0.0,0,861,2566,1022,2665,161,99
17013,levle1_218.jpg,fore,Unspecified,0.0,0,876,2673,1014,2803,138,130
17014,levle1_218.jpg,fore,Unspecified,0.0,0,578,2382,685,2535,107,153
17015,levle1_218.jpg,fore,Unspecified,0.0,0,708,865,869,1033,161,168
17016,levle1_28.jpg,fore,Unspecified,0.0,0,115,95,158,129,43,34
17017,levle1_28.jpg,fore,Unspecified,0.0,0,126,66,172,91,46,25
17018,levle1_28.jpg,fore,Unspecified,0.0,0,172,2,219,40,47,38
17019,levle1_28.jpg,fore,Unspecified,0.0,0,146,279,184,334,38,55
17020,levle1_28.jpg,fore,Unspecified,0.0,0,274,329,296,365,22,36
17021,levle1_28.jpg,fore,Unspecified,0.0,0,260,250,291,281,31,31
17022,levle1_28.jpg,fore,Unspecified,0.0,0,138,407,176,427,38,20
17023,levle1_28.jpg,fore,Unspecified,0.0,0,227,438,253,482,26,44
17024,levle1_28.jpg,fore,Unspecified,0.0,0,260,407,282,441,22,34
17025,levle1_28.jpg,fore,Unspecified,0.0,0,291,398,331,436,40,38
17026,levle1_28.jpg,fore,Unspecified,0.0,0,303,362,332,395,29,33
17027,levle1_28.jpg,fore,Unspecified,0.0,0,310,315,341,346,31,31
17028,levle1_28.jpg,fore,Unspecified,0.0,0,246,326,274,360,28,34
17029,levle1_28.jpg,fore,Unspecified,0.0,0,210,296,243,324,33,28
17030,levle1_28.jpg,fore,Unspecified,0.0,0,213,331,236,362,23,31
17031,levle1_28.jpg,fore,Unspecified,0.0,0,222,255,248,291,26,36
17032,levle1_28.jpg,fore,Unspecified,0.0,0,120,300,139,329,19,29
17033,levle1_28.jpg,fore,Unspecified,0.0,0,103,229,138,264,35,35
17034,levle1_28.jpg,fore,Unspecified,0.0,0,138,372,176,403,38,31
17035,levle1_595.jpg,fore,Unspecified,0.0,0,1696,2405,1842,2550,146,145
17036,levle1_595.jpg,fore,Unspecified,0.0,0,1313,3209,1459,3332,146,123
17037,levle1_595.jpg,fore,Unspecified,0.0,0,2263,2374,2394,2504,131,130
17038,levle1_595.jpg,fore,Unspecified,0.0,0,2532,2183,2608,2259,76,76
17039,levle1_595.jpg,fore,Unspecified,0.0,0,2624,2152,2762,2290,138,138
17040,levle1_595.jpg,fore,Unspecified,0.0,0,1551,3163,1635,3271,84,108
17041,levle1_595.jpg,fore,Unspecified,0.0,0,1298,3048,1428,3179,130,131
17042,levle3_123.jpg,fore,,,0,105,143,117,152,12,9
17043,levle3_123.jpg,fore,,,0,87,134,100,144,13,10
17044,levle3_123.jpg,fore,,,0,86,144,92,156,6,12
17045,levle3_123.jpg,fore,,,0,81,164,94,173,13,9
17046,levle3_123.jpg,fore,,,0,81,174,91,184,10,10
17047,levle3_123.jpg,fore,,,0,85,184,94,193,9,9
17048,levle3_123.jpg,fore,,,0,112,187,122,199,10,12
17049,levle3_123.jpg,fore,,,0,98,189,110,199,12,10
17050,levle3_123.jpg,fore,,,0,72,187,82,195,10,8
17051,levle3_123.jpg,fore,,,0,99,164,105,171,6,7
17052,levle3_123.jpg,fore,,,0,106,159,113,168,7,9
17053,levle3_123.jpg,fore,,,0,158,104,168,117,10,13
17054,levle3_123.jpg,fore,,,0,149,110,158,120,9,10
17055,levle3_123.jpg,fore,,,0,159,124,169,137,10,13
17056,levle3_123.jpg,fore,,,0,173,111,181,119,8,8
17057,levle3_123.jpg,fore,,,0,161,148,174,158,13,10
17058,levle3_123.jpg,fore,,,0,163,139,171,147,8,8
17059,levle3_123.jpg,fore,,,0,130,138,142,155,12,17
17060,levle3_123.jpg,fore,,,0,113,148,125,159,12,11
17061,levle3_123.jpg,fore,,,0,108,170,121,178,13,8
17062,levle3_123.jpg,fore,,,0,104,179,118,189,14,10
17063,levle3_123.jpg,fore,,,0,73,175,80,182,7,7
17064,levle3_123.jpg,fore,,,0,66,156,78,170,12,14
17065,levle3_123.jpg,fore,,,0,52,136,66,146,14,10
17066,levle3_123.jpg,fore,,,0,63,140,74,150,11,10
17067,levle3_123.jpg,fore,,,0,50,83,64,98,14,15
17068,levle3_123.jpg,fore,,,0,55,36,66,46,11,10
17069,levle3_123.jpg,fore,,,0,176,19,191,34,15,15
17070,levle3_123.jpg,fore,,,0,90,33,101,43,11,10
17071,levle3_123.jpg,fore,,,0,116,10,127,19,11,9
17072,levle3_123.jpg,fore,,,0,137,24,148,33,11,9
17073,levle3_123.jpg,fore,,,0,154,23,163,35,9,12
17074,levle3_123.jpg,fore,,,0,64,58,74,69,10,11
17075,levle3_123.jpg,fore,,,0,38,122,48,131,10,9
17076,levle3_123.jpg,fore,,,0,34,109,44,118,10,9
17077,levle3_123.jpg,fore,,,0,63,77,72,86,9,9
17078,levle3_123.jpg,fore,,,0,72,78,80,86,8,8
17079,levle3_123.jpg,fore,,,0,59,70,68,78,9,8
17080,levle3_123.jpg,fore,,,0,71,36,82,45,11,9
17081,levle3_123.jpg,fore,,,0,50,115,60,125,10,10
17082,levle3_123.jpg,fore,,,0,42,168,51,178,9,10
17083,levle3_123.jpg,fore,,,0,50,175,59,183,9,8
17084,levle3_123.jpg,fore,,,0,58,186,66,193,8,7
17085,levle3_123.jpg,fore,,,0,64,191,70,198,6,7
17086,levle3_123.jpg,fore,,,0,81,199,87,205,6,6
17087,levle3_123.jpg,fore,,,0,56,192,65,200,9,8
17088,levle3_123.jpg,fore,,,0,62,169,69,177,7,8
17089,levle3_123.jpg,fore,,,0,66,173,74,181,8,8
17090,levle3_123.jpg,fore,,,0,101,150,108,157,7,7
17091,levle3_123.jpg,fore,,,0,93,151,102,161,9,10
17092,levle3_123.jpg,fore,,,0,76,143,86,154,10,11
17093,levle3_123.jpg,fore,,,0,55,158,65,168,10,10
17094,levle3_123.jpg,fore,,,0,43,88,52,97,9,9
17095,levle3_123.jpg,fore,,,0,37,93,45,102,8,9
17096,levle3_123.jpg,fore,,,0,73,72,81,79,8,7
17097,levle3_137.jpg,fore,Unspecified,0.0,0,185,29,192,37,7,8
17098,levle3_137.jpg,fore,Unspecified,0.0,0,189,39,200,47,11,8
17099,levle3_137.jpg,fore,Unspecified,0.0,0,106,16,117,27,11,11
17100,levle3_137.jpg,fore,Unspecified,0.0,0,121,24,132,34,11,10
17101,levle3_137.jpg,fore,Unspecified,0.0,0,131,40,142,50,11,10
17102,levle3_137.jpg,fore,Unspecified,0.0,0,140,46,151,58,11,12
17103,levle3_137.jpg,fore,Unspecified,0.0,0,110,60,119,73,9,13
17104,levle3_137.jpg,fore,Unspecified,0.0,0,150,71,163,79,13,8
17105,levle3_137.jpg,fore,Unspecified,0.0,0,137,79,146,90,9,11
17106,levle3_137.jpg,fore,Unspecified,0.0,0,190,106,200,118,10,12
17107,levle3_137.jpg,fore,Unspecified,0.0,0,189,89,197,101,8,12
17108,levle3_137.jpg,fore,Unspecified,0.0,0,201,73,212,85,11,12
17109,levle3_137.jpg,fore,Unspecified,0.0,0,184,128,194,138,10,10
17110,levle3_137.jpg,fore,Unspecified,0.0,0,100,102,109,114,9,12
17111,levle3_137.jpg,fore,Unspecified,0.0,0,102,114,109,126,7,12
17112,levle3_137.jpg,fore,Unspecified,0.0,0,78,123,98,133,20,10
17113,levle3_137.jpg,fore,Unspecified,0.0,0,36,104,45,116,9,12
17114,levle3_137.jpg,fore,Unspecified,0.0,0,31,117,42,126,11,9
17115,levle3_137.jpg,fore,Unspecified,0.0,0,31,129,43,138,12,9
17116,levle3_137.jpg,fore,Unspecified,0.0,0,30,139,40,151,10,12
17117,levle3_137.jpg,fore,Unspecified,0.0,0,41,139,54,153,13,14
17118,levle3_137.jpg,fore,Unspecified,0.0,0,100,30,113,42,13,12
17119,levle3_137.jpg,fore,Unspecified,0.0,0,101,42,111,50,10,8
17120,levle3_137.jpg,fore,Unspecified,0.0,0,94,49,109,61,15,12
17121,levle3_137.jpg,fore,Unspecified,0.0,0,72,26,83,41,11,15
17122,levle3_137.jpg,fore,Unspecified,0.0,0,86,18,95,30,9,12
17123,levle3_137.jpg,fore,Unspecified,0.0,0,95,7,107,20,12,13
17124,levle3_137.jpg,fore,Unspecified,0.0,0,76,48,93,62,17,14
17125,levle3_137.jpg,fore,Unspecified,0.0,0,57,45,70,60,13,15
17126,levle3_137.jpg,fore,Unspecified,0.0,0,66,62,79,72,13,10
17127,levle3_137.jpg,fore,Unspecified,0.0,0,68,74,85,92,17,18
17128,levle3_137.jpg,fore,Unspecified,0.0,0,73,90,85,104,12,14
17129,levle3_137.jpg,fore,Unspecified,0.0,0,84,87,97,100,13,13
17130,levle3_137.jpg,fore,Unspecified,0.0,0,89,98,98,108,9,10
17131,levle3_137.jpg,fore,Unspecified,0.0,0,85,111,94,122,9,11
17132,levle3_137.jpg,fore,Unspecified,0.0,0,132,64,143,75,11,11
17133,levle3_137.jpg,fore,Unspecified,0.0,0,116,94,133,105,17,11
17134,levle3_137.jpg,fore,Unspecified,0.0,0,128,105,134,115,6,10
17135,levle3_137.jpg,fore,Unspecified,0.0,0,134,108,147,117,13,9
17136,levle3_137.jpg,fore,Unspecified,0.0,0,142,118,159,126,17,8
17137,levle3_137.jpg,fore,Unspecified,0.0,0,147,128,162,138,15,10
17138,levle3_137.jpg,fore,Unspecified,0.0,0,165,115,178,126,13,11
17139,levle3_137.jpg,fore,Unspecified,0.0,0,175,108,188,121,13,13
17140,levle3_137.jpg,fore,Unspecified,0.0,0,154,98,168,112,14,14
17141,levle3_137.jpg,fore,Unspecified,0.0,0,166,92,175,100,9,8
17142,levle3_137.jpg,fore,Unspecified,0.0,0,175,97,186,107,11,10
17143,levle3_137.jpg,fore,Unspecified,0.0,0,182,73,196,86,14,13
17144,levle3_137.jpg,fore,Unspecified,0.0,0,198,55,208,66,10,11
17145,levle3_137.jpg,fore,Unspecified,0.0,0,170,62,181,71,11,9
17146,levle3_137.jpg,fore,Unspecified,0.0,0,156,39,167,54,11,15
17147,levle3_137.jpg,fore,Unspecified,0.0,0,168,27,180,38,12,11
17148,levle3_137.jpg,fore,Unspecified,0.0,0,174,42,183,52,9,10
17149,levle3_137.jpg,fore,Unspecified,0.0,0,152,27,159,33,7,6
17150,levle3_137.jpg,fore,Unspecified,0.0,0,138,17,145,23,7,6
17151,levle3_137.jpg,fore,Unspecified,0.0,0,141,32,150,43,9,11
17152,levle3_137.jpg,fore,Unspecified,0.0,0,69,109,80,117,11,8
17153,levle3_137.jpg,fore,Unspecified,0.0,0,51,111,58,119,7,8
17154,levle3_137.jpg,fore,Unspecified,0.0,0,59,115,69,124,10,9
17155,levle1_581.jpg,fore,Unspecified,0.0,0,125,2160,279,2313,154,153
17156,levle1_581.jpg,fore,Unspecified,0.0,0,378,2727,486,2895,108,168
17157,levle1_581.jpg,fore,Unspecified,0.0,0,478,2596,624,2796,146,200
17158,levle1_581.jpg,fore,Unspecified,0.0,0,616,2711,800,2911,184,200
17159,levle1_581.jpg,fore,Unspecified,0.0,0,846,2175,999,2328,153,153
17160,levle1_581.jpg,fore,Unspecified,0.0,0,1283,1294,1390,1409,107,115
17161,levle3_9.jpg,fore,,,0,409,190,436,228,27,38
17162,levle3_9.jpg,fore,,,0,377,204,411,249,34,45
17163,levle3_9.jpg,fore,,,0,373,235,415,277,42,42
17164,levle3_9.jpg,fore,,,0,385,257,419,302,34,45
17165,levle3_9.jpg,fore,,,0,330,298,354,326,24,28
17166,levle3_9.jpg,fore,,,0,309,308,334,337,25,29
17167,levle3_9.jpg,fore,,,0,379,310,434,343,55,33
17168,levle3_9.jpg,fore,,,0,377,335,421,361,44,26
17169,levle3_9.jpg,fore,,,0,364,343,387,367,23,24
17170,levle3_9.jpg,fore,,,0,350,363,387,394,37,31
17171,levle3_9.jpg,fore,,,0,354,400,377,428,23,28
17172,levle3_9.jpg,fore,,,0,377,390,417,428,40,38
17173,levle3_9.jpg,fore,,,0,309,402,340,432,31,30
17174,levle3_9.jpg,fore,,,0,309,441,336,471,27,30
17175,levle3_9.jpg,fore,,,0,340,426,366,453,26,27
17176,levle3_9.jpg,fore,,,0,340,467,368,490,28,23
17177,levle3_9.jpg,fore,,,0,330,485,366,514,36,29
17178,levle3_9.jpg,fore,,,0,411,404,446,437,35,33
17179,levle3_9.jpg,fore,,,0,442,422,468,455,26,33
17180,levle3_9.jpg,fore,,,0,466,441,503,477,37,36
17181,levle3_9.jpg,fore,,,0,548,506,585,547,37,41
17182,levle3_9.jpg,fore,,,0,521,516,546,551,25,35
17183,levle3_9.jpg,fore,,,0,497,518,519,541,22,23
17184,levle3_9.jpg,fore,,,0,477,506,505,539,28,33
17185,levle3_9.jpg,fore,,,0,483,565,530,600,47,35
17186,levle3_9.jpg,fore,,,0,440,534,472,565,32,31
17187,levle3_9.jpg,fore,,,0,440,514,468,541,28,27
17188,levle3_9.jpg,fore,,,0,409,485,444,524,35,39
17189,levle3_9.jpg,fore,,,0,407,610,460,651,53,41
17190,levle3_9.jpg,fore,,,0,460,594,497,626,37,32
17191,levle3_9.jpg,fore,,,0,487,634,530,669,43,35
17192,levle3_9.jpg,fore,,,0,491,677,519,706,28,29
17193,levle3_9.jpg,fore,,,0,393,518,454,555,61,37
17194,levle3_9.jpg,fore,,,0,489,194,518,220,29,26
17195,levle3_9.jpg,fore,,,0,560,651,584,683,24,32
17196,levle3_9.jpg,fore,,,0,585,661,608,686,23,25
17197,levle3_9.jpg,fore,,,0,348,527,380,562,32,35
17198,levle3_9.jpg,fore,,,0,362,501,391,532,29,31
17199,levle3_9.jpg,fore,,,0,371,462,401,495,30,33
17200,levle3_9.jpg,fore,,,0,365,428,396,450,31,22
17201,levle3_9.jpg,fore,,,0,498,434,525,467,27,33
17202,levle3_9.jpg,fore,,,0,388,563,425,587,37,24
17203,levle3_9.jpg,fore,,,0,324,346,350,376,26,30
17204,levle3_9.jpg,fore,,,0,356,320,382,342,26,22
17205,levle3_9.jpg,fore,,,0,326,248,361,278,35,30
17206,levle3_9.jpg,fore,,,0,357,205,378,230,21,25
17207,levle3_9.jpg,fore,,,0,441,252,480,284,39,32
17208,levle3_9.jpg,fore,,,0,449,229,482,255,33,26
17209,levle3_9.jpg,fore,,,0,465,199,492,224,27,25
17210,levle3_9.jpg,fore,,,0,617,121,652,146,35,25
17211,levle3_9.jpg,fore,,,0,531,644,559,677,28,33
17212,levle3_8.jpg,fore,,,0,338,402,364,441,26,39
17213,levle3_8.jpg,fore,,,0,370,265,430,300,60,35
17214,levle3_8.jpg,fore,,,0,452,239,485,261,33,22
17215,levle3_8.jpg,fore,,,0,328,177,373,216,45,39
17216,levle3_8.jpg,fore,,,0,332,549,358,592,26,43
17217,levle3_8.jpg,fore,,,0,248,587,285,602,37,15
17218,levle3_8.jpg,fore,,,0,232,549,260,577,28,28
17219,levle3_8.jpg,fore,,,0,142,153,183,186,41,33
17220,levle3_8.jpg,fore,,,0,228,96,277,139,49,43
17221,levle3_8.jpg,fore,,,0,244,73,279,92,35,19
17222,levle3_8.jpg,fore,,,0,322,212,375,239,53,27
17223,levle3_8.jpg,fore,,,0,340,239,362,265,22,26
17224,levle3_8.jpg,fore,,,0,375,194,415,212,40,18
17225,levle3_8.jpg,fore,,,0,415,290,466,324,51,34
17226,levle3_8.jpg,fore,,,0,417,324,458,371,41,47
17227,levle3_8.jpg,fore,,,0,415,369,460,402,45,33
17228,levle3_8.jpg,fore,,,0,426,400,462,432,36,32
17229,levle3_8.jpg,fore,,,0,464,410,501,437,37,27
17230,levle3_8.jpg,fore,,,0,452,432,485,463,33,31
17231,levle3_8.jpg,fore,,,0,377,422,421,459,44,37
17232,levle3_8.jpg,fore,,,0,336,463,377,479,41,16
17233,levle3_8.jpg,fore,,,0,338,477,368,510,30,33
17234,levle3_8.jpg,fore,,,0,377,481,395,504,18,23
17235,levle3_8.jpg,fore,,,0,397,485,428,514,31,29
17236,levle3_8.jpg,fore,,,0,360,508,399,534,39,26
17237,levle3_8.jpg,fore,,,0,391,514,424,543,33,29
17238,levle3_8.jpg,fore,,,0,360,524,401,561,41,37
17239,levle3_8.jpg,fore,,,0,317,506,352,532,35,26
17240,levle3_8.jpg,fore,,,0,248,469,295,500,47,31
17241,levle3_8.jpg,fore,,,0,268,520,295,545,27,25
17242,levle3_8.jpg,fore,,,0,295,508,340,549,45,41
17243,levle3_8.jpg,fore,,,0,264,543,305,575,41,32
17244,levle3_8.jpg,fore,,,0,293,590,317,618,24,28
17245,levle3_8.jpg,fore,,,0,281,626,309,671,28,45
17246,levle3_8.jpg,fore,,,0,309,616,342,655,33,39
17247,levle3_8.jpg,fore,,,0,232,638,283,679,51,41
17248,levle3_8.jpg,fore,,,0,213,618,238,661,25,43
17249,levle3_8.jpg,fore,,,0,207,671,250,710,43,39
17250,levle3_8.jpg,fore,,,0,278,176,312,201,34,25
17251,levle3_8.jpg,fore,,,0,257,211,302,239,45,28
17252,levle3_8.jpg,fore,,,0,224,237,264,265,40,28
17253,levle3_8.jpg,fore,,,0,329,68,373,97,44,29
17254,levle3_8.jpg,fore,,,0,362,340,389,365,27,25
17255,levle3_8.jpg,fore,,,0,281,397,306,429,25,32
17256,levle3_8.jpg,fore,,,0,143,606,164,625,21,19
17257,levle3_8.jpg,fore,,,0,160,688,191,720,31,32
17258,levle3_8.jpg,fore,,,0,175,636,198,662,23,26
17259,levle3_8.jpg,fore,,,0,356,604,384,637,28,33
17260,levle3_8.jpg,fore,,,0,402,545,432,574,30,29
17261,levle3_8.jpg,fore,,,0,237,518,268,549,31,31
17262,levle3_8.jpg,fore,,,0,196,532,229,562,33,30
17263,levle3_8.jpg,fore,,,0,209,560,234,587,25,27
17264,levle3_8.jpg,fore,,,0,188,577,215,605,27,28
17265,levle3_8.jpg,fore,,,0,374,218,407,247,33,29
17266,levle3_136.jpg,fore,,,0,419,148,435,164,16,16
17267,levle3_136.jpg,fore,,,0,429,181,458,211,29,30
17268,levle3_136.jpg,fore,,,0,345,189,367,232,22,43
17269,levle3_136.jpg,fore,,,0,439,255,478,294,39,39
17270,levle3_136.jpg,fore,,,0,470,310,501,347,31,37
17271,levle3_136.jpg,fore,,,0,456,341,486,378,30,37
17272,levle3_136.jpg,fore,,,0,431,347,458,380,27,33
17273,levle3_136.jpg,fore,,,0,369,331,415,363,46,32
17274,levle3_136.jpg,fore,,,0,386,372,415,404,29,32
17275,levle3_136.jpg,fore,,,0,464,390,505,431,41,41
17276,levle3_136.jpg,fore,,,0,402,443,452,476,50,33
17277,levle3_136.jpg,fore,,,0,396,489,445,532,49,43
17278,levle3_136.jpg,fore,,,0,353,470,363,513,10,43
17279,levle3_136.jpg,fore,,,0,298,509,341,554,43,45
17280,levle3_136.jpg,fore,,,0,238,542,265,579,27,37
17281,levle3_136.jpg,fore,,,0,271,550,302,612,31,62
17282,levle3_136.jpg,fore,,,0,378,534,419,579,41,45
17283,levle3_136.jpg,fore,,,0,433,532,466,579,33,47
17284,levle3_136.jpg,fore,,,0,353,577,396,614,43,37
17285,levle3_136.jpg,fore,,,0,328,600,367,636,39,36
17286,levle3_136.jpg,fore,,,0,402,634,435,669,33,35
17287,levle3_136.jpg,fore,,,0,332,702,376,745,44,43
17288,levle3_136.jpg,fore,,,0,279,770,332,790,53,20
17289,levle3_136.jpg,fore,,,0,300,651,330,694,30,43
17290,levle3_136.jpg,fore,,,0,341,751,369,786,28,35
17291,levle3_136.jpg,fore,,,0,314,790,339,827,25,37
17292,levle3_136.jpg,fore,,,0,429,803,468,832,39,29
17293,levle3_136.jpg,fore,,,0,435,848,482,891,47,43
17294,levle3_136.jpg,fore,,,0,495,799,523,821,28,22
17295,levle3_136.jpg,fore,,,0,478,838,538,871,60,33
17296,levle3_136.jpg,fore,,,0,569,741,593,780,24,39
17297,levle3_136.jpg,fore,,,0,575,780,603,807,28,27
17298,levle3_136.jpg,fore,,,0,585,682,634,715,49,33
17299,levle3_136.jpg,fore,,,0,550,671,583,712,33,41
17300,levle3_136.jpg,fore,,,0,513,678,534,719,21,41
17301,levle3_136.jpg,fore,,,0,456,686,491,729,35,43
17302,levle3_136.jpg,fore,,,0,406,696,452,741,46,45
17303,levle3_136.jpg,fore,,,0,554,536,593,569,39,33
17304,levle3_136.jpg,fore,,,0,577,575,608,614,31,39
17305,levle3_136.jpg,fore,,,0,569,626,599,659,30,33
17306,levle3_136.jpg,fore,,,0,638,595,682,651,44,56
17307,levle3_136.jpg,fore,,,0,493,565,546,608,53,43
17308,levle3_136.jpg,fore,,,0,511,614,550,645,39,31
17309,levle3_136.jpg,fore,,,0,441,591,491,636,50,45
17310,levle3_136.jpg,fore,,,0,384,766,431,813,47,47
17311,levle3_136.jpg,fore,,,0,275,727,320,764,45,37
17312,levle3_136.jpg,fore,,,0,254,643,296,688,42,45
17313,levle3_136.jpg,fore,,,0,351,651,394,696,43,45
17314,levle3_136.jpg,fore,,,0,455,494,489,529,34,35
17315,levle3_136.jpg,fore,,,0,263,459,288,496,25,37
17316,levle3_136.jpg,fore,,,0,239,748,276,791,37,43
17317,levle1_580.jpg,fore,Unspecified,0.0,0,1129,2328,1275,2474,146,146
17318,levle1_580.jpg,fore,Unspecified,0.0,0,876,2834,1045,3041,169,207
17319,levle1_580.jpg,fore,Unspecified,0.0,0,570,2719,708,2865,138,146
17320,levle1_580.jpg,fore,Unspecified,0.0,0,79,2320,263,2527,184,207
17321,levle1_580.jpg,fore,Unspecified,0.0,0,286,1907,386,2045,100,138
17322,levle1_580.jpg,fore,Unspecified,0.0,0,1352,3041,1474,3179,122,138
17323,levle1_580.jpg,fore,Unspecified,0.0,0,1643,3010,1765,3156,122,146
17324,levle1_580.jpg,fore,Unspecified,0.0,0,1543,1478,1643,1615,100,137
17325,levle1_580.jpg,fore,Unspecified,0.0,0,1650,1194,1811,1409,161,215
17326,levle1_580.jpg,fore,Unspecified,0.0,0,1589,941,1750,1133,161,192
17327,levle1_594.jpg,fore,Unspecified,0.0,0,945,2290,1137,2412,192,122
17328,levle1_594.jpg,fore,Unspecified,0.0,0,1122,2428,1252,2527,130,99
17329,levle1_594.jpg,fore,Unspecified,0.0,0,823,2941,968,3071,145,130
17330,levle1_594.jpg,fore,Unspecified,0.0,0,1068,2995,1122,3087,54,92
17331,levle1_594.jpg,fore,Unspecified,0.0,0,1152,2956,1214,3110,62,154
17332,levle1_594.jpg,fore,Unspecified,0.0,0,1183,3079,1290,3209,107,130
17333,levle1_594.jpg,fore,Unspecified,0.0,0,1635,3148,1796,3263,161,115
17334,levle1_594.jpg,fore,Unspecified,0.0,0,1689,2987,1796,3110,107,123
17335,levle1_594.jpg,fore,Unspecified,0.0,0,302,2267,440,2397,138,130
17336,levle1_594.jpg,fore,Unspecified,0.0,0,486,2167,654,2374,168,207
17337,levle1_594.jpg,fore,Unspecified,0.0,0,1306,711,1413,872,107,161
17338,levle3_122.jpg,fore,,,0,475,238,524,295,49,57
17339,levle3_122.jpg,fore,,,0,522,261,568,324,46,63
17340,levle3_122.jpg,fore,,,0,561,254,592,310,31,56
17341,levle3_122.jpg,fore,,,0,228,24,274,68,46,44
17342,levle3_122.jpg,fore,,,0,289,230,316,283,27,53
17343,levle3_122.jpg,fore,,,0,357,342,378,375,21,33
17344,levle3_122.jpg,fore,,,0,345,390,376,438,31,48
17345,levle3_122.jpg,fore,,,0,442,467,485,513,43,46
17346,levle3_122.jpg,fore,,,0,393,264,418,303,25,39
17347,levle3_122.jpg,fore,,,0,255,375,308,438,53,63
17348,levle3_122.jpg,fore,,,0,238,347,258,380,20,33
17349,levle3_122.jpg,fore,,,0,224,392,260,438,36,46
17350,levle3_122.jpg,fore,,,0,195,317,233,361,38,44
17351,levle3_122.jpg,fore,,,0,151,257,194,312,43,55
17352,levle3_122.jpg,fore,,,0,126,290,151,334,25,44
17353,levle3_122.jpg,fore,,,0,126,337,160,371,34,34
17354,levle3_122.jpg,fore,,,0,88,317,120,359,32,42
17355,levle3_122.jpg,fore,,,0,25,414,52,458,27,44
17356,levle3_122.jpg,fore,,,0,90,458,127,499,37,41
17357,levle3_122.jpg,fore,,,0,154,436,189,467,35,31
17358,levle3_122.jpg,fore,,,0,173,473,207,511,34,38
17359,levle3_122.jpg,fore,,,0,216,472,257,511,41,39
17360,levle3_122.jpg,fore,,,0,263,467,301,496,38,29
17361,levle3_122.jpg,fore,,,0,335,455,381,482,46,27
17362,levle3_122.jpg,fore,,,0,325,479,372,518,47,39
17363,levle3_122.jpg,fore,,,0,284,555,335,596,51,41
17364,levle3_122.jpg,fore,,,0,253,535,282,565,29,30
17365,levle3_122.jpg,fore,,,0,303,625,361,686,58,61
17366,levle3_122.jpg,fore,,,0,359,564,389,596,30,32
17367,levle3_122.jpg,fore,,,0,408,567,464,589,56,22
17368,levle3_122.jpg,fore,,,0,500,644,558,695,58,51
17369,levle3_122.jpg,fore,,,0,473,593,526,639,53,46
17370,levle3_122.jpg,fore,,,0,386,427,425,470,39,43
17371,levle3_122.jpg,fore,,,0,434,414,483,463,49,49
17372,levle3_122.jpg,fore,,,0,493,373,561,446,68,73
17373,levle3_122.jpg,fore,,,0,204,545,240,586,36,41
17374,levle3_122.jpg,fore,,,0,102,518,114,533,12,15
17375,levle3_122.jpg,fore,,,0,88,380,129,429,41,49
17376,levle3_122.jpg,fore,,,0,37,371,76,419,39,48
17377,levle3_122.jpg,fore,,,0,362,138,407,184,45,46
17378,levle3_122.jpg,fore,,,0,384,175,422,230,38,55
17379,levle3_122.jpg,fore,,,0,321,284,369,318,48,34
17380,levle3_122.jpg,fore,,,0,196,119,230,148,34,29
17381,levle3_122.jpg,fore,,,0,173,139,206,166,33,27
17382,levle3_122.jpg,fore,,,0,574,667,600,700,26,33
17383,levle3_122.jpg,fore,,,0,455,146,499,178,44,32
17384,levle3_122.jpg,fore,,,0,459,181,506,219,47,38
17385,levle3_122.jpg,fore,,,0,447,214,496,258,49,44
17386,levle3_122.jpg,fore,,,0,447,332,486,365,39,33
17387,levle3_122.jpg,fore,,,0,420,288,458,323,38,35
17388,levle3_122.jpg,fore,,,0,384,317,424,352,40,35
17389,levle3_122.jpg,fore,,,0,545,589,593,636,48,47
17390,levle3_122.jpg,fore,,,0,386,606,411,632,25,26
17391,levle3_122.jpg,fore,,,0,333,64,368,99,35,35
17392,levle3_122.jpg,fore,,,0,274,194,323,226,49,32
17393,levle3_122.jpg,fore,,,0,292,518,331,549,39,31
17394,levle3_122.jpg,fore,,,0,257,497,296,537,39,40
17395,levle3_122.jpg,fore,,,0,121,107,170,152,49,45
17396,levle3_122.jpg,fore,,,0,254,614,285,652,31,38
17397,levle3_122.jpg,fore,,,0,419,493,458,525,39,32
17398,levle3_122.jpg,fore,,,0,459,665,490,704,31,39
17399,levle1_219.jpg,fore,Unspecified,0.0,0,1137,2995,1229,3102,92,107
17400,levle1_219.jpg,fore,Unspecified,0.0,0,1505,3278,1658,3363,153,85
17401,levle1_219.jpg,fore,Unspecified,0.0,0,1689,3056,1781,3171,92,115
17402,levle1_219.jpg,fore,Unspecified,0.0,0,1857,2911,1957,3025,100,114
17403,levle1_219.jpg,fore,Unspecified,0.0,0,2455,2014,2555,2137,100,123
17404,levle1_219.jpg,fore,Unspecified,0.0,0,1390,1010,1482,1079,92,69
17405,levle1_219.jpg,fore,Unspecified,0.0,0,1804,3148,1949,3248,145,100
17406,levle1_29.jpg,fore,Unspecified,0.0,0,461,173,487,196,26,23
17407,levle1_29.jpg,fore,Unspecified,0.0,0,348,184,368,201,20,17
17408,levle1_29.jpg,fore,Unspecified,0.0,0,350,152,363,175,13,23
17409,levle1_29.jpg,fore,Unspecified,0.0,0,331,153,342,174,11,21
17410,levle1_29.jpg,fore,Unspecified,0.0,0,287,153,308,181,21,28
17411,levle1_29.jpg,fore,Unspecified,0.0,0,301,131,330,158,29,27
17412,levle1_29.jpg,fore,Unspecified,0.0,0,249,126,271,157,22,31
17413,levle1_29.jpg,fore,Unspecified,0.0,0,273,189,286,211,13,22
17414,levle1_29.jpg,fore,Unspecified,0.0,0,288,189,308,223,20,34
17415,levle1_29.jpg,fore,Unspecified,0.0,0,316,182,334,210,18,28
17416,levle1_29.jpg,fore,Unspecified,0.0,0,327,240,348,264,21,24
17417,levle1_29.jpg,fore,Unspecified,0.0,0,341,207,364,229,23,22
17418,levle1_29.jpg,fore,Unspecified,0.0,0,285,276,305,299,20,23
17419,levle1_29.jpg,fore,Unspecified,0.0,0,382,181,401,198,19,17
17420,levle1_29.jpg,fore,Unspecified,0.0,0,233,189,250,212,17,23
17421,levle1_29.jpg,fore,Unspecified,0.0,0,199,189,220,203,21,14
17422,levle1_29.jpg,fore,Unspecified,0.0,0,275,245,293,266,18,21
17423,levle1_29.jpg,fore,Unspecified,0.0,0,257,272,276,292,19,20
17424,levle1_29.jpg,fore,Unspecified,0.0,0,225,139,240,150,15,11
17425,levle1_225.jpg,fore,Unspecified,0.0,0,2041,1232,2187,1378,146,146
17426,levle1_225.jpg,fore,Unspecified,0.0,0,2087,2474,2202,2665,115,191
17427,levle1_225.jpg,fore,Unspecified,0.0,0,2240,2558,2371,2681,131,123
17428,levle1_225.jpg,fore,Unspecified,0.0,0,1804,2719,1880,2857,76,138
17429,levle1_225.jpg,fore,Unspecified,0.0,0,1903,2658,2034,2750,131,92
17430,levle1_225.jpg,fore,Unspecified,0.0,0,2202,2826,2340,2949,138,123
17431,levle1_225.jpg,fore,Unspecified,0.0,0,1658,2803,1842,2941,184,138
17432,levle1_225.jpg,fore,Unspecified,0.0,0,2501,1278,2647,1416,146,138
17433,levle1_543.jpg,fore,Unspecified,0.0,0,1681,1025,1781,1148,100,123
17434,levle1_543.jpg,fore,Unspecified,0.0,0,1857,1133,1980,1248,123,115
17435,levle1_543.jpg,fore,Unspecified,0.0,0,984,2274,1122,2389,138,115
17436,levle1_543.jpg,fore,Unspecified,0.0,0,953,2374,1076,2527,123,153
17437,levle1_543.jpg,fore,Unspecified,0.0,0,838,2665,953,2788,115,123
17438,levle1_543.jpg,fore,Unspecified,0.0,0,631,2681,754,2788,123,107
17439,levle1_543.jpg,fore,Unspecified,0.0,0,670,2842,807,3002,137,160
17440,levle1_543.jpg,fore,Unspecified,0.0,0,769,2949,892,3071,123,122
17441,levle1_543.jpg,fore,Unspecified,0.0,0,1214,3010,1329,3133,115,123
17442,levle1_543.jpg,fore,Unspecified,0.0,0,509,2405,616,2543,107,138
17443,levle1_543.jpg,fore,Unspecified,0.0,0,455,2206,608,2351,153,145
17444,levle1_543.jpg,fore,Unspecified,0.0,0,677,2313,823,2481,146,168
17445,levle1_15.jpg,fore,Unspecified,0.0,0,446,258,477,310,31,52
17446,levle1_15.jpg,fore,Unspecified,0.0,0,467,206,500,248,33,42
17447,levle1_15.jpg,fore,Unspecified,0.0,0,510,213,545,253,35,40
17448,levle1_15.jpg,fore,Unspecified,0.0,0,515,445,550,464,35,19
17449,levle1_15.jpg,fore,Unspecified,0.0,0,545,459,569,485,24,26
17450,levle1_15.jpg,fore,Unspecified,0.0,0,548,485,583,520,35,35
17451,levle1_15.jpg,fore,Unspecified,0.0,0,605,527,638,577,33,50
17452,levle1_15.jpg,fore,Unspecified,0.0,0,510,525,567,575,57,50
17453,levle1_15.jpg,fore,Unspecified,0.0,0,510,591,541,622,31,31
17454,levle1_15.jpg,fore,Unspecified,0.0,0,446,535,477,575,31,40
17455,levle1_15.jpg,fore,Unspecified,0.0,0,491,691,555,755,64,64
17456,levle1_15.jpg,fore,Unspecified,0.0,0,413,648,463,700,50,52
17457,levle1_15.jpg,fore,Unspecified,0.0,0,399,698,448,733,49,35
17458,levle1_15.jpg,fore,Unspecified,0.0,0,470,570,503,606,33,36
17459,levle1_15.jpg,fore,Unspecified,0.0,0,399,504,425,546,26,42
17460,levle1_557.jpg,fore,Unspecified,0.0,0,202,1807,332,1930,130,123
17461,levle1_557.jpg,fore,Unspecified,0.0,0,133,1600,248,1753,115,153
17462,levle1_557.jpg,fore,Unspecified,0.0,0,348,2083,478,2267,130,184
17463,levle1_557.jpg,fore,Unspecified,0.0,0,279,2320,455,2466,176,146
17464,levle1_557.jpg,fore,Unspecified,0.0,0,578,2366,685,2581,107,215
17465,levle1_557.jpg,fore,Unspecified,0.0,0,715,2573,853,2734,138,161
17466,levle1_557.jpg,fore,Unspecified,0.0,0,486,2696,654,2888,168,192
17467,levle1_557.jpg,fore,Unspecified,0.0,0,938,3094,1068,3225,130,131
17468,levle1_231.jpg,fore,Unspecified,0.0,0,1083,2466,1175,2543,92,77
17469,levle1_231.jpg,fore,Unspecified,0.0,0,1336,2435,1466,2550,130,115
17470,levle1_231.jpg,fore,Unspecified,0.0,0,1781,2604,1911,2719,130,115
17471,levle1_231.jpg,fore,Unspecified,0.0,0,1627,3033,1773,3163,146,130
17472,levle1_231.jpg,fore,Unspecified,0.0,0,1796,3117,1942,3271,146,154
17473,levle1_231.jpg,fore,Unspecified,0.0,0,1512,2573,1597,2727,85,154
17474,levle2_87.jpg,fore,,,0,1811,1930,1942,2022,131,92
17475,levle2_87.jpg,fore,,,0,2087,2121,2309,2282,222,161
17476,levle2_87.jpg,fore,,,0,1988,2229,2102,2343,114,114
17477,levle2_87.jpg,fore,,,0,1811,2091,2026,2221,215,130
17478,levle2_87.jpg,fore,,,0,1604,2006,1735,2060,131,54
17479,levle2_87.jpg,fore,,,0,1558,2114,1704,2267,146,153
17480,levle2_87.jpg,fore,,,0,1420,2152,1512,2259,92,107
17481,levle2_87.jpg,fore,,,0,1129,2229,1290,2405,161,176
17482,levle2_87.jpg,fore,,,0,1359,2527,1397,2573,38,46
17483,levle2_87.jpg,fore,,,0,1528,2343,1681,2520,153,177
17484,levle2_87.jpg,fore,,,0,1689,2313,1842,2435,153,122
17485,levle2_87.jpg,fore,,,0,1750,2497,1842,2627,92,130
17486,levle2_87.jpg,fore,,,0,1604,1317,1650,1378,46,61
17487,levle2_87.jpg,fore,,,0,1689,1110,1880,1263,191,153
17488,levle2_87.jpg,fore,,,0,1543,1881,1688,2005,145,124
17489,levle2_87.jpg,fore,,,0,1391,3150,1546,3267,155,117
17490,levle2_87.jpg,fore,,,0,1498,2912,1691,3060,193,148
17491,levle2_87.jpg,fore,,,0,1798,1781,1957,1905,159,124
17492,levle2_87.jpg,fore,,,0,1919,1374,2050,1474,131,100
17493,levle2_87.jpg,fore,,,0,1967,1453,2105,1567,138,114
17494,levle2_87.jpg,fore,,,0,1688,2094,1808,2243,120,149
17495,levle2_93.jpg,fore,Unspecified,0.0,0,74,12,89,25,15,13
17496,levle2_93.jpg,fore,Unspecified,0.0,0,95,35,103,46,8,11
17497,levle2_93.jpg,fore,Unspecified,0.0,0,105,44,118,59,13,15
17498,levle2_93.jpg,fore,Unspecified,0.0,0,121,54,131,64,10,10
17499,levle2_93.jpg,fore,Unspecified,0.0,0,124,64,135,71,11,7
17500,levle2_93.jpg,fore,Unspecified,0.0,0,120,75,133,86,13,11
17501,levle2_93.jpg,fore,Unspecified,0.0,0,107,74,114,86,7,12
17502,levle2_93.jpg,fore,Unspecified,0.0,0,96,74,106,84,10,10
17503,levle2_93.jpg,fore,Unspecified,0.0,0,81,71,89,80,8,9
17504,levle2_93.jpg,fore,Unspecified,0.0,0,74,68,80,76,6,8
17505,levle2_93.jpg,fore,Unspecified,0.0,0,73,30,91,44,18,14
17506,levle2_93.jpg,fore,Unspecified,0.0,0,13,49,22,57,9,8
17507,levle2_93.jpg,fore,Unspecified,0.0,0,34,86,43,95,9,9
17508,levle2_93.jpg,fore,Unspecified,0.0,0,13,92,25,103,12,11
17509,levle2_93.jpg,fore,Unspecified,0.0,0,19,108,26,120,7,12
17510,levle2_93.jpg,fore,Unspecified,0.0,0,57,116,74,130,17,14
17511,levle2_93.jpg,fore,Unspecified,0.0,0,83,111,94,124,11,13
17512,levle2_93.jpg,fore,Unspecified,0.0,0,92,111,104,124,12,13
17513,levle2_93.jpg,fore,Unspecified,0.0,0,101,114,113,127,12,13
17514,levle2_93.jpg,fore,Unspecified,0.0,0,116,107,126,118,10,11
17515,levle2_93.jpg,fore,Unspecified,0.0,0,122,99,137,109,15,10
17516,levle2_93.jpg,fore,Unspecified,0.0,0,129,111,137,121,8,10
17517,levle2_93.jpg,fore,Unspecified,0.0,0,85,145,96,154,11,9
17518,levle2_93.jpg,fore,Unspecified,0.0,0,76,150,86,159,10,9
17519,levle2_93.jpg,fore,Unspecified,0.0,0,39,141,51,152,12,11
17520,levle2_93.jpg,fore,Unspecified,0.0,0,35,130,46,141,11,11
17521,levle2_93.jpg,fore,Unspecified,0.0,0,37,154,50,166,13,12
17522,levle2_93.jpg,fore,Unspecified,0.0,0,59,54,69,64,10,10
17523,levle2_93.jpg,fore,Unspecified,0.0,0,49,80,63,94,14,14
17524,levle2_93.jpg,fore,Unspecified,0.0,0,77,86,87,97,10,11
17525,levle2_93.jpg,fore,Unspecified,0.0,0,85,83,95,92,10,9
17526,levle2_93.jpg,fore,Unspecified,0.0,0,95,86,105,97,10,11
17527,levle2_127.jpg,fore,Unspecified,0.0,0,59,140,75,154,16,14
17528,levle2_127.jpg,fore,Unspecified,0.0,0,38,130,51,147,13,17
17529,levle2_127.jpg,fore,Unspecified,0.0,0,108,241,125,257,17,16
17530,levle2_127.jpg,fore,Unspecified,0.0,0,203,222,219,237,16,15
17531,levle2_127.jpg,fore,Unspecified,0.0,0,175,214,193,228,18,14
17532,levle2_127.jpg,fore,Unspecified,0.0,0,167,249,188,266,21,17
17533,levle2_127.jpg,fore,Unspecified,0.0,0,116,55,130,73,14,18
17534,levle2_127.jpg,fore,Unspecified,0.0,0,44,28,68,54,24,26
17535,levle2_127.jpg,fore,Unspecified,0.0,0,106,31,127,49,21,18
17536,levle2_127.jpg,fore,Unspecified,0.0,0,152,62,175,79,23,17
17537,levle2_127.jpg,fore,Unspecified,0.0,0,122,83,143,103,21,20
17538,levle2_127.jpg,fore,Unspecified,0.0,0,148,88,170,111,22,23
17539,levle2_127.jpg,fore,Unspecified,0.0,0,177,102,191,117,14,15
17540,levle2_127.jpg,fore,Unspecified,0.0,0,194,120,210,142,16,22
17541,levle2_127.jpg,fore,Unspecified,0.0,0,67,92,89,115,22,23
17542,levle2_127.jpg,fore,Unspecified,0.0,0,87,104,105,125,18,21
17543,levle2_127.jpg,fore,Unspecified,0.0,0,104,101,119,117,15,16
17544,levle2_127.jpg,fore,Unspecified,0.0,0,123,113,139,129,16,16
17545,levle2_127.jpg,fore,Unspecified,0.0,0,135,135,150,146,15,11
17546,levle2_127.jpg,fore,Unspecified,0.0,0,133,145,152,165,19,20
17547,levle2_127.jpg,fore,Unspecified,0.0,0,137,173,150,189,13,16
17548,levle2_127.jpg,fore,Unspecified,0.0,0,153,174,162,187,9,13
17549,levle2_127.jpg,fore,Unspecified,0.0,0,186,167,197,184,11,17
17550,levle2_127.jpg,fore,Unspecified,0.0,0,188,195,205,207,17,12
17551,levle2_127.jpg,fore,Unspecified,0.0,0,118,212,147,238,29,26
17552,levle2_127.jpg,fore,Unspecified,0.0,0,143,196,158,208,15,12
17553,levle2_127.jpg,fore,Unspecified,0.0,0,100,198,119,215,19,17
17554,levle2_127.jpg,fore,Unspecified,0.0,0,74,189,86,199,12,10
17555,levle2_127.jpg,fore,Unspecified,0.0,0,45,157,63,174,18,17
17556,levle2_127.jpg,fore,Unspecified,0.0,0,81,165,103,179,22,14
17557,levle2_127.jpg,fore,Unspecified,0.0,0,102,162,115,174,13,12
17558,levle2_127.jpg,fore,Unspecified,0.0,0,106,176,123,192,17,16
17559,levle2_44.jpg,fore,Unspecified,0.0,0,1658,773,1811,857,153,84
17560,levle2_44.jpg,fore,Unspecified,0.0,0,585,1784,654,1899,69,115
17561,levle2_44.jpg,fore,Unspecified,0.0,0,624,1861,723,2014,99,153
17562,levle2_44.jpg,fore,Unspecified,0.0,0,585,1999,715,2075,130,76
17563,levle2_44.jpg,fore,Unspecified,0.0,0,578,2068,677,2206,99,138
17564,levle2_44.jpg,fore,Unspecified,0.0,0,838,2068,968,2221,130,153
17565,levle2_44.jpg,fore,Unspecified,0.0,0,692,2129,769,2236,77,107
17566,levle2_44.jpg,fore,Unspecified,0.0,0,823,2328,907,2428,84,100
17567,levle2_44.jpg,fore,Unspecified,0.0,0,631,2405,784,2520,153,115
17568,levle2_44.jpg,fore,Unspecified,0.0,0,746,2489,838,2589,92,100
17569,levle2_44.jpg,fore,Unspecified,0.0,0,869,2535,945,2681,76,146
17570,levle2_44.jpg,fore,Unspecified,0.0,0,961,2320,1037,2458,76,138
17571,levle2_44.jpg,fore,Unspecified,0.0,0,1014,2236,1145,2389,131,153
17572,levle2_44.jpg,fore,Unspecified,0.0,0,1053,2397,1183,2543,130,146
17573,levle2_44.jpg,fore,Unspecified,0.0,0,746,2650,830,2780,84,130
17574,levle2_44.jpg,fore,Unspecified,0.0,0,938,2627,1053,2750,115,123
17575,levle2_44.jpg,fore,Unspecified,0.0,0,991,2719,1099,2826,108,107
17576,levle2_44.jpg,fore,Unspecified,0.0,0,892,2956,999,3048,107,92
17577,levle2_44.jpg,fore,Unspecified,0.0,0,1275,2619,1352,2742,77,123
17578,levle2_44.jpg,fore,Unspecified,0.0,0,1099,2596,1221,2704,122,108
17579,levle2_44.jpg,fore,Unspecified,0.0,0,1175,2428,1321,2581,146,153
17580,levle2_44.jpg,fore,Unspecified,0.0,0,1229,2351,1405,2428,176,77
17581,levle2_44.jpg,fore,Unspecified,0.0,0,1375,2313,1505,2374,130,61
17582,levle2_44.jpg,fore,Unspecified,0.0,0,1321,2091,1451,2229,130,138
17583,levle2_44.jpg,fore,Unspecified,0.0,0,1145,2060,1290,2144,145,84
17584,levle2_44.jpg,fore,Unspecified,0.0,0,1420,2941,1627,3079,207,138
17585,levle2_44.jpg,fore,Unspecified,0.0,0,1152,2137,1283,2290,131,153
17586,levle2_50.jpg,fore,Unspecified,0.0,0,2110,787,2276,911,166,124
17587,levle2_50.jpg,fore,Unspecified,0.0,0,1760,1069,1885,1236,125,167
17588,levle2_50.jpg,fore,Unspecified,0.0,0,1810,1252,1968,1385,158,133
17589,levle2_50.jpg,fore,Unspecified,0.0,0,1636,1286,1802,1485,166,199
17590,levle2_50.jpg,fore,Unspecified,0.0,0,2533,1535,2708,1759,175,224
17591,levle2_50.jpg,fore,Unspecified,0.0,0,2317,1626,2533,1834,216,208
17592,levle2_50.jpg,fore,Unspecified,0.0,0,2126,1626,2259,1776,133,150
17593,levle2_50.jpg,fore,Unspecified,0.0,0,2035,1709,2176,1859,141,150
17594,levle2_50.jpg,fore,Unspecified,0.0,0,2134,1817,2267,1967,133,150
17595,levle2_50.jpg,fore,Unspecified,0.0,0,2309,1784,2484,1967,175,183
17596,levle2_50.jpg,fore,Unspecified,0.0,0,2392,1901,2608,2050,216,149
17597,levle2_50.jpg,fore,Unspecified,0.0,0,2384,2025,2525,2158,141,133
17598,levle2_50.jpg,fore,Unspecified,0.0,0,2625,1967,2783,2117,158,150
17599,levle2_50.jpg,fore,Unspecified,0.0,0,2101,2025,2276,2167,175,142
17600,levle2_50.jpg,fore,Unspecified,0.0,0,1885,2108,2093,2258,208,150
17601,levle2_50.jpg,fore,Unspecified,0.0,0,2060,2216,2176,2341,116,125
17602,levle2_50.jpg,fore,Unspecified,0.0,0,2026,2324,2151,2432,125,108
17603,levle2_50.jpg,fore,Unspecified,0.0,0,2168,2266,2292,2391,124,125
17604,levle2_50.jpg,fore,Unspecified,0.0,0,2218,2133,2359,2266,141,133
17605,levle2_50.jpg,fore,Unspecified,0.0,0,2351,2216,2492,2349,141,133
17606,levle2_50.jpg,fore,Unspecified,0.0,0,2392,2341,2442,2482,50,141
17607,levle2_50.jpg,fore,Unspecified,0.0,0,2417,2366,2567,2499,150,133
17608,levle2_50.jpg,fore,Unspecified,0.0,0,2367,2457,2533,2615,166,158
17609,levle2_50.jpg,fore,Unspecified,0.0,0,2184,2391,2367,2549,183,158
17610,levle2_50.jpg,fore,Unspecified,0.0,0,2143,2457,2242,2632,99,175
17611,levle2_50.jpg,fore,Unspecified,0.0,0,2592,2408,2708,2599,116,191
17612,levle2_50.jpg,fore,Unspecified,0.0,0,2741,2333,2882,2474,141,141
17613,levle2_50.jpg,fore,Unspecified,0.0,0,2533,2582,2650,2715,117,133
17614,levle2_50.jpg,fore,Unspecified,0.0,0,2450,2607,2592,2748,142,141
17615,levle2_50.jpg,fore,Unspecified,0.0,0,2384,2715,2525,2865,141,150
17616,levle2_50.jpg,fore,Unspecified,0.0,0,2550,2657,2749,2890,199,233
17617,levle2_50.jpg,fore,Unspecified,0.0,0,2650,2615,2758,2723,108,108
17618,levle2_50.jpg,fore,Unspecified,0.0,0,2841,2657,2957,2782,116,125
17619,levle2_50.jpg,fore,Unspecified,0.0,0,2741,2773,2841,2939,100,166
17620,levle0_234.jpg,fore,Unspecified,0.0,0,1352,3271,1436,3347,84,76
17621,levle2_78.jpg,fore,,,0,440,1669,624,1815,184,146
17622,levle2_78.jpg,fore,,,0,194,1700,332,1830,138,130
17623,levle2_78.jpg,fore,,,0,616,2144,754,2374,138,230
17624,levle2_78.jpg,fore,,,0,386,2389,555,2520,169,131
17625,levle2_78.jpg,fore,,,0,601,2366,861,2596,260,230
17626,levle2_78.jpg,fore,,,0,1022,2052,1137,2229,115,177
17627,levle2_78.jpg,fore,,,0,815,2282,976,2443,161,161
17628,levle2_78.jpg,fore,,,0,1076,2374,1397,2558,321,184
17629,levle2_78.jpg,fore,,,0,1053,2934,1313,3140,260,206
17630,levle2_78.jpg,fore,,,0,1520,757,1604,933,84,176
17631,levle2_78.jpg,fore,,,0,846,780,1037,1018,191,238
17632,levle2_78.jpg,fore,,,0,1390,543,1604,773,214,230
17633,levle2_78.jpg,fore,,,0,1620,451,1712,566,92,115
17634,levle2_78.jpg,fore,,,0,1988,619,2118,750,130,131
17635,levle2_78.jpg,fore,,,0,2079,704,2217,849,138,145
17636,levle2_78.jpg,fore,,,0,2187,941,2325,1102,138,161
17637,levle2_78.jpg,fore,,,0,1896,796,2102,1025,206,229
17638,levle2_78.jpg,fore,,,0,1765,642,1903,803,138,161
17639,levle2_78.jpg,fore,,,0,750,2915,908,3011,158,96
17640,levle2_78.jpg,fore,,,0,1326,298,1460,432,134,134
17641,levle2_78.jpg,fore,,,0,936,2529,1164,2691,228,162
17642,levle0_220.jpg,fore,Unspecified,0.0,0,1007,2359,1191,2550,184,191
17643,levle0_220.jpg,fore,Unspecified,0.0,0,1352,3148,1551,3340,199,192
17644,levle0_220.jpg,fore,Unspecified,0.0,0,907,3002,1053,3225,146,223
17645,levle0_82.jpg,fore,Unspecified,0.0,0,2558,2383,2700,2557,142,174
17646,levle0_96.jpg,fore,Unspecified,0.0,0,1911,2060,2003,2175,92,115
17647,levle1_190.jpg,fore,Unspecified,0.0,0,1788,2451,1911,2566,123,115
17648,levle1_190.jpg,fore,Unspecified,0.0,0,1528,2635,1681,2765,153,130
17649,levle1_190.jpg,fore,Unspecified,0.0,0,1742,3271,1926,3447,184,176
17650,levle1_190.jpg,fore,Unspecified,0.0,0,2072,3186,2148,3286,76,100
17651,levle1_190.jpg,fore,Unspecified,0.0,0,2179,3248,2325,3432,146,184
17652,levle1_190.jpg,fore,Unspecified,0.0,0,1896,3064,2041,3179,145,115
17653,levle1_190.jpg,fore,Unspecified,0.0,0,562,1999,708,2137,146,138
17654,levle0_383.jpg,fore,Unspecified,0.0,0,547,2681,677,2819,130,138
17655,levle0_383.jpg,fore,Unspecified,0.0,0,309,2297,455,2489,146,192
17656,levle0_383.jpg,fore,Unspecified,0.0,0,578,2251,692,2443,114,192
17657,levle1_184.jpg,fore,Unspecified,0.0,0,486,2451,616,2596,130,145
17658,levle1_184.jpg,fore,Unspecified,0.0,0,271,2144,409,2267,138,123
17659,levle1_184.jpg,fore,Unspecified,0.0,0,194,2665,332,2765,138,100
17660,levle1_184.jpg,fore,Unspecified,0.0,0,240,2788,409,2895,169,107
17661,levle1_184.jpg,fore,Unspecified,0.0,0,26,2834,156,3033,130,199
17662,levle1_184.jpg,fore,Unspecified,0.0,0,984,2987,1106,3117,122,130
17663,levle1_184.jpg,fore,Unspecified,0.0,0,585,466,692,596,107,130
17664,levle1_184.jpg,fore,Unspecified,0.0,0,378,305,524,451,146,146
17665,levle1_184.jpg,fore,Unspecified,0.0,0,1252,864,1367,987,115,123
17666,levle1_184.jpg,fore,Unspecified,0.0,0,1152,773,1260,880,108,107
17667,levle1_184.jpg,fore,Unspecified,0.0,0,1198,412,1313,612,115,200
17668,levle0_397.jpg,fore,Unspecified,0.0,0,2317,1592,2493,1753,176,161
17669,levle1_609.jpg,fore,Unspecified,0.0,0,1252,926,1352,1041,100,115
17670,levle1_609.jpg,fore,Unspecified,0.0,0,493,1953,624,2045,131,92
17671,levle1_609.jpg,fore,Unspecified,0.0,0,455,2037,562,2160,107,123
17672,levle1_609.jpg,fore,Unspecified,0.0,0,715,2068,853,2167,138,99
17673,levle1_609.jpg,fore,Unspecified,0.0,0,692,2190,807,2328,115,138
17674,levle1_609.jpg,fore,Unspecified,0.0,0,899,2259,1037,2435,138,176
17675,levle1_609.jpg,fore,Unspecified,0.0,0,953,2474,1152,2604,199,130
17676,levle1_609.jpg,fore,Unspecified,0.0,0,846,2589,984,2711,138,122
17677,levle1_609.jpg,fore,Unspecified,0.0,0,1191,2979,1367,3163,176,184
17678,levle1_609.jpg,fore,Unspecified,0.0,0,1367,2888,1512,2995,145,107
17679,levle1_609.jpg,fore,Unspecified,0.0,0,1627,2865,1750,2956,123,91
17680,levle0_41.jpg,fore,Unspecified,0.0,0,647,1769,784,1884,137,115
17681,levle0_41.jpg,fore,Unspecified,0.0,0,639,1937,815,2121,176,184
17682,levle0_368.jpg,fore,Unspecified,0.0,0,1076,596,1252,704,176,108
17683,levle0_368.jpg,fore,Unspecified,0.0,0,1260,3117,1443,3278,183,161
17684,levle0_55.jpg,fore,Unspecified,0.0,0,417,2428,585,2604,168,176
17685,levle0_55.jpg,fore,Unspecified,0.0,0,148,2688,271,2857,123,169
17686,levle0_55.jpg,fore,Unspecified,0.0,0,1428,2619,1566,2734,138,115
17687,levle0_55.jpg,fore,Unspecified,0.0,0,1758,2412,1857,2581,99,169
17688,levle0_426.jpg,fore,Unspecified,0.0,0,1627,2987,1750,3094,123,107
17689,levle0_426.jpg,fore,Unspecified,0.0,0,1283,3194,1505,3324,222,130
17690,levle1_635.jpg,fore,Unspecified,0.0,0,1612,1914,1796,2106,184,192
17691,levle1_635.jpg,fore,Unspecified,0.0,0,2616,1707,2739,1807,123,100
17692,levle1_635.jpg,fore,Unspecified,0.0,0,1712,2405,1965,2543,253,138
17693,levle1_635.jpg,fore,Unspecified,0.0,0,2110,2673,2271,2803,161,130
17694,levle1_635.jpg,fore,Unspecified,0.0,0,2271,2635,2409,2765,138,130
17695,levle1_635.jpg,fore,Unspecified,0.0,0,2401,2535,2532,2765,131,230
17696,levle1_635.jpg,fore,Unspecified,0.0,0,2532,2550,2754,2635,222,85
17697,levle1_153.jpg,fore,Unspecified,0.0,0,1160,2366,1298,2489,138,123
17698,levle1_153.jpg,fore,Unspecified,0.0,0,1237,2612,1321,2711,84,99
17699,levle1_153.jpg,fore,Unspecified,0.0,0,1221,2543,1329,2612,108,69
17700,levle1_153.jpg,fore,Unspecified,0.0,0,1489,2903,1620,3018,131,115
17701,levle1_153.jpg,fore,Unspecified,0.0,0,1336,2711,1459,2834,123,123
17702,levle1_153.jpg,fore,Unspecified,0.0,0,1306,1332,1390,1447,84,115
17703,levle0_340.jpg,fore,Unspecified,0.0,0,1022,2780,1137,2880,115,100
17704,levle0_340.jpg,fore,Unspecified,0.0,0,141,1485,271,1600,130,115
17705,levle1_147.jpg,fore,Unspecified,0.0,0,1497,1761,1650,1891,153,130
17706,levle1_147.jpg,fore,Unspecified,0.0,0,2562,1661,2716,1838,154,177
17707,levle1_147.jpg,fore,Unspecified,0.0,0,2524,1822,2616,1953,92,131
17708,levle1_147.jpg,fore,Unspecified,0.0,0,2248,1953,2371,2091,123,138
17709,levle1_147.jpg,fore,Unspecified,0.0,0,2417,2160,2524,2267,107,107
17710,levle1_147.jpg,fore,Unspecified,0.0,0,1850,2428,1934,2573,84,145
17711,levle1_147.jpg,fore,Unspecified,0.0,0,1742,2681,1880,2819,138,138
17712,levle1_147.jpg,fore,Unspecified,0.0,0,1988,2389,2102,2527,114,138
17713,levle0_354.jpg,fore,Unspecified,0.0,0,2064,2466,2210,2650,146,184
17714,levle0_432.jpg,fore,Unspecified,0.0,0,1804,2895,1919,3010,115,115
17715,levle0_432.jpg,fore,Unspecified,0.0,0,1214,3232,1397,3301,183,69
17716,levle1_621.jpg,fore,Unspecified,0.0,0,984,796,1160,918,176,122
17717,levle1_621.jpg,fore,Unspecified,0.0,0,1551,1094,1658,1186,107,92
17718,levle1_621.jpg,fore,Unspecified,0.0,0,1397,1953,1551,2114,154,161
17719,levle1_621.jpg,fore,Unspecified,0.0,0,1321,2604,1436,2727,115,123
17720,levle1_621.jpg,fore,Unspecified,0.0,0,1566,2926,1681,3071,115,145
17721,levle1_621.jpg,fore,Unspecified,0.0,0,1681,2941,1819,3071,138,130
17722,levle1_621.jpg,fore,Unspecified,0.0,0,1842,2903,1972,3087,130,184
17723,levle1_621.jpg,fore,Unspecified,0.0,0,1995,2926,2125,3087,130,161
17724,levle0_69.jpg,fore,Unspecified,0.0,0,1661,629,1810,812,149,183
17725,levle0_69.jpg,fore,Unspecified,0.0,0,2907,1560,3132,1801,225,241
17726,levle0_181.jpg,fore,Unspecified,0.0,0,861,2175,999,2297,138,122
17727,levle1_392.jpg,fore,Unspecified,0.0,0,2202,2711,2332,2880,130,169
17728,levle1_392.jpg,fore,Unspecified,0.0,0,2041,2627,2202,2734,161,107
17729,levle1_392.jpg,fore,Unspecified,0.0,0,1873,2696,2041,2826,168,130
17730,levle1_392.jpg,fore,Unspecified,0.0,0,2340,2995,2463,3125,123,130
17731,levle1_392.jpg,fore,Unspecified,0.0,0,2279,3048,2317,3140,38,92
17732,levle1_392.jpg,fore,Unspecified,0.0,0,1873,2987,2011,3140,138,153
17733,levle0_195.jpg,fore,Unspecified,0.0,0,1375,1914,1566,2060,191,146
17734,levle1_386.jpg,fore,Unspecified,0.0,0,1512,558,1704,673,192,115
17735,levle1_386.jpg,fore,Unspecified,0.0,0,1873,382,2049,527,176,145
17736,levle1_386.jpg,fore,Unspecified,0.0,0,1995,251,2095,313,100,62
17737,levle1_386.jpg,fore,Unspecified,0.0,0,2102,198,2187,320,85,122
17738,levle1_386.jpg,fore,Unspecified,0.0,0,2294,198,2386,320,92,122
17739,levle1_386.jpg,fore,Unspecified,0.0,0,2409,1286,2547,1485,138,199
17740,levle1_386.jpg,fore,Unspecified,0.0,0,1221,267,1329,443,108,176
17741,levle1_386.jpg,fore,Unspecified,0.0,0,1497,366,1589,481,92,115
17742,levle3_38.jpg,fore,Unspecified,0.0,0,561,570,599,592,38,22
17743,levle3_38.jpg,fore,Unspecified,0.0,0,542,626,576,673,34,47
17744,levle3_38.jpg,fore,Unspecified,0.0,0,487,626,519,664,32,38
17745,levle3_38.jpg,fore,Unspecified,0.0,0,457,645,474,673,17,28
17746,levle3_38.jpg,fore,Unspecified,0.0,0,484,690,514,717,30,27
17747,levle3_38.jpg,fore,Unspecified,0.0,0,540,670,578,692,38,22
17748,levle3_38.jpg,fore,Unspecified,0.0,0,421,634,455,673,34,39
17749,levle3_38.jpg,fore,Unspecified,0.0,0,397,668,427,698,30,30
17750,levle3_38.jpg,fore,Unspecified,0.0,0,359,660,384,692,25,32
17751,levle3_38.jpg,fore,Unspecified,0.0,0,340,609,365,649,25,40
17752,levle3_38.jpg,fore,Unspecified,0.0,0,372,587,406,624,34,37
17753,levle3_38.jpg,fore,Unspecified,0.0,0,419,504,444,536,25,32
17754,levle3_38.jpg,fore,Unspecified,0.0,0,463,509,506,560,43,51
17755,levle3_38.jpg,fore,Unspecified,0.0,0,361,451,384,479,23,28
17756,levle3_38.jpg,fore,Unspecified,0.0,0,367,534,399,564,32,30
17757,levle3_38.jpg,fore,Unspecified,0.0,0,361,334,380,375,19,41
17758,levle3_38.jpg,fore,Unspecified,0.0,0,333,281,367,326,34,45
17759,levle3_38.jpg,fore,Unspecified,0.0,0,327,428,350,462,23,34
17760,levle3_38.jpg,fore,Unspecified,0.0,0,291,462,327,498,36,36
17761,levle3_38.jpg,fore,Unspecified,0.0,0,295,490,314,526,19,36
17762,levle3_38.jpg,fore,Unspecified,0.0,0,280,521,327,543,47,22
17763,levle3_38.jpg,fore,Unspecified,0.0,0,325,528,346,577,21,49
17764,levle3_38.jpg,fore,Unspecified,0.0,0,287,539,312,575,25,36
17765,levle3_38.jpg,fore,Unspecified,0.0,0,329,502,363,539,34,37
17766,levle3_38.jpg,fore,Unspecified,0.0,0,306,575,329,611,23,36
17767,levle3_38.jpg,fore,Unspecified,0.0,0,421,556,453,590,32,34
17768,levle1_379.jpg,fore,Unspecified,0.0,0,1007,2297,1122,2451,115,154
17769,levle1_379.jpg,fore,Unspecified,0.0,0,1627,2512,1765,2642,138,130
17770,levle1_379.jpg,fore,Unspecified,0.0,0,1321,3002,1466,3163,145,161
17771,levle3_10.jpg,fore,,,0,313,255,385,286,72,31
17772,levle3_10.jpg,fore,,,0,419,335,442,379,23,44
17773,levle3_10.jpg,fore,,,0,389,398,426,422,37,24
17774,levle3_10.jpg,fore,,,0,415,461,442,483,27,22
17775,levle3_10.jpg,fore,,,0,442,471,472,481,30,10
17776,levle3_10.jpg,fore,,,0,299,443,346,477,47,34
17777,levle3_10.jpg,fore,,,0,297,383,334,420,37,37
17778,levle3_10.jpg,fore,,,0,209,420,264,453,55,33
17779,levle3_10.jpg,fore,,,0,162,534,220,563,58,29
17780,levle3_10.jpg,fore,,,0,109,569,164,604,55,35
17781,levle3_10.jpg,fore,,,0,352,471,385,504,33,33
17782,levle3_10.jpg,fore,,,0,387,477,421,494,34,17
17783,levle3_10.jpg,fore,,,0,430,500,460,543,30,43
17784,levle3_10.jpg,fore,,,0,415,534,448,563,33,29
17785,levle3_10.jpg,fore,,,0,248,524,287,534,39,10
17786,levle3_10.jpg,fore,,,0,283,543,319,577,36,34
17787,levle3_10.jpg,fore,,,0,173,581,207,647,34,66
17788,levle3_10.jpg,fore,,,0,199,585,248,630,49,45
17789,levle3_10.jpg,fore,,,0,242,641,275,671,33,30
17790,levle3_10.jpg,fore,,,0,228,710,260,740,32,30
17791,levle3_10.jpg,fore,,,0,334,659,375,694,41,35
17792,levle3_10.jpg,fore,,,0,289,653,356,702,67,49
17793,levle3_10.jpg,fore,,,0,311,585,346,634,35,49
17794,levle3_10.jpg,fore,,,0,366,547,397,587,31,40
17795,levle3_10.jpg,fore,,,0,326,516,379,565,53,49
17796,levle3_10.jpg,fore,,,0,377,502,407,532,30,30
17797,levle3_10.jpg,fore,,,0,411,645,450,669,39,24
17798,levle3_10.jpg,fore,,,0,426,673,468,710,42,37
17799,levle3_10.jpg,fore,,,0,368,800,395,828,27,28
17800,levle3_10.jpg,fore,,,0,360,341,395,367,35,26
17801,levle3_10.jpg,fore,,,0,334,377,373,410,39,33
17802,levle3_10.jpg,fore,,,0,381,624,405,651,24,27
17803,levle3_10.jpg,fore,,,0,348,587,391,624,43,37
17804,levle3_10.jpg,fore,,,0,230,547,260,569,30,22
17805,levle3_10.jpg,fore,,,0,409,706,428,736,19,30
17806,levle3_10.jpg,fore,,,0,417,722,452,751,35,29
17807,levle3_10.jpg,fore,,,0,462,722,489,769,27,47
17808,levle3_10.jpg,fore,,,0,256,740,295,779,39,39
17809,levle3_10.jpg,fore,,,0,191,771,232,814,41,43
17810,levle3_10.jpg,fore,,,0,366,840,419,902,53,62
17811,levle3_10.jpg,fore,,,0,435,789,466,815,31,26
17812,levle3_10.jpg,fore,,,0,458,574,489,606,31,32
17813,levle3_10.jpg,fore,,,0,325,344,361,369,36,25
17814,levle3_10.jpg,fore,,,0,355,306,385,341,30,35
17815,levle3_10.jpg,fore,,,0,264,255,296,282,32,27
17816,levle3_10.jpg,fore,,,0,272,286,310,312,38,26
17817,levle3_10.jpg,fore,,,0,180,438,203,465,23,27
17818,levle3_10.jpg,fore,,,0,252,367,295,394,43,27
17819,levle3_10.jpg,fore,,,0,329,298,362,329,33,31
17820,levle3_10.jpg,fore,,,0,417,847,461,879,44,32
17821,levle3_10.jpg,fore,,,0,471,837,494,867,23,30
17822,levle3_10.jpg,fore,,,0,489,810,514,829,25,19
17823,levle3_10.jpg,fore,,,0,377,762,409,788,32,26
17824,levle3_10.jpg,fore,,,0,342,759,375,792,33,33
17825,levle3_10.jpg,fore,,,0,263,781,301,815,38,34
17826,levle3_10.jpg,fore,,,0,246,611,279,638,33,27
17827,levle3_10.jpg,fore,,,0,286,615,312,648,26,33
17828,levle3_10.jpg,fore,,,0,345,616,386,651,41,35
17829,levle3_10.jpg,fore,,,0,395,326,431,355,36,29
17830,levle3_10.jpg,fore,,,0,384,588,415,625,31,37
17831,levle3_10.jpg,fore,,,0,268,714,303,742,35,28
17832,levle3_10.jpg,fore,,,0,342,816,374,847,32,31
17833,levle3_10.jpg,fore,,,0,190,714,227,741,37,27
17834,levle3_10.jpg,fore,,,0,318,481,353,512,35,31
17835,levle3_10.jpg,fore,,,0,489,536,514,561,25,25
17836,levle0_142.jpg,fore,Unspecified,0.0,0,2148,1991,2286,2167,138,176
17837,levle1_351.jpg,fore,Unspecified,0.0,0,1221,972,1367,1156,146,184
17838,levle1_351.jpg,fore,Unspecified,0.0,0,2639,1884,2830,2106,191,222
17839,levle1_351.jpg,fore,Unspecified,0.0,0,2279,2297,2432,2489,153,192
17840,levle1_351.jpg,fore,Unspecified,0.0,0,1650,2320,1735,2497,85,177
17841,levle1_351.jpg,fore,Unspecified,0.0,0,1796,2374,1919,2543,123,169
17842,levle1_351.jpg,fore,Unspecified,0.0,0,1903,2206,2079,2351,176,145
17843,levle1_437.jpg,fore,,,0,486,2535,593,2665,107,130
17844,levle1_437.jpg,fore,,,0,516,2788,601,2865,85,77
17845,levle1_437.jpg,fore,,,0,838,2995,938,3117,100,122
17846,levle1_437.jpg,fore,,,0,976,2842,1091,2956,115,114
17847,levle1_437.jpg,fore,,,0,1566,3263,1727,3363,161,100
17848,levle1_437.jpg,fore,,,0,1040,3098,1167,3205,127,107
17849,levle1_423.jpg,fore,Unspecified,0.0,0,830,757,953,895,123,138
17850,levle1_423.jpg,fore,Unspecified,0.0,0,2440,1562,2639,1715,199,153
17851,levle1_423.jpg,fore,Unspecified,0.0,0,1842,2665,1934,2773,92,108
17852,levle1_423.jpg,fore,Unspecified,0.0,0,2194,2842,2332,3018,138,176
17853,levle1_423.jpg,fore,Unspecified,0.0,0,2011,2757,2164,2926,153,169
17854,levle1_423.jpg,fore,Unspecified,0.0,0,1942,2313,2102,2474,160,161
17855,levle1_423.jpg,fore,Unspecified,0.0,0,2286,2251,2401,2366,115,115
17856,levle1_423.jpg,fore,Unspecified,0.0,0,2532,2305,2739,2497,207,192
17857,levle0_156.jpg,fore,Unspecified,0.0,0,807,1830,945,1976,138,146
17858,levle0_156.jpg,fore,Unspecified,0.0,0,677,2091,784,2244,107,153
17859,levle1_345.jpg,fore,Unspecified,0.0,0,838,1968,984,2137,146,169
17860,levle1_345.jpg,fore,Unspecified,0.0,0,945,2137,1068,2282,123,145
17861,levle1_345.jpg,fore,Unspecified,0.0,0,830,2297,968,2474,138,177
17862,levle1_345.jpg,fore,Unspecified,0.0,0,1114,2183,1252,2351,138,168
17863,levle1_345.jpg,fore,Unspecified,0.0,0,1129,2374,1290,2550,161,176
17864,levle1_345.jpg,fore,Unspecified,0.0,0,1535,2129,1727,2305,192,176
17865,levle1_345.jpg,fore,Unspecified,0.0,0,1558,2382,1758,2489,200,107
17866,levle1_345.jpg,fore,Unspecified,0.0,0,1428,2420,1543,2535,115,115
17867,levle1_345.jpg,fore,Unspecified,0.0,0,1528,2504,1658,2658,130,154
17868,levle1_345.jpg,fore,Unspecified,0.0,0,1428,2765,1620,2956,192,191
17869,levle1_435.jpg,fore,Unspecified,0.0,0,486,2650,631,2773,145,123
17870,levle1_435.jpg,fore,Unspecified,0.0,0,608,2788,700,2888,92,100
17871,levle1_435.jpg,fore,Unspecified,0.0,0,601,2995,708,3140,107,145
17872,levle1_435.jpg,fore,Unspecified,0.0,0,1014,2711,1145,2872,131,161
17873,levle1_435.jpg,fore,Unspecified,0.0,0,1106,2964,1198,3064,92,100
17874,levle1_435.jpg,fore,Unspecified,0.0,0,892,3033,1037,3186,145,153
17875,levle1_435.jpg,fore,Unspecified,0.0,0,1106,3125,1290,3278,184,153
17876,levle1_435.jpg,fore,Unspecified,0.0,0,1819,3041,1980,3102,161,61
17877,levle1_435.jpg,fore,Unspecified,0.0,0,1742,3179,1926,3309,184,130
17878,levle1_435.jpg,fore,Unspecified,0.0,0,1589,3286,1827,3432,238,146
17879,levle1_353.jpg,fore,Unspecified,0.0,0,309,796,493,987,184,191
17880,levle1_353.jpg,fore,Unspecified,0.0,0,256,1002,493,1179,237,177
17881,levle1_353.jpg,fore,Unspecified,0.0,0,1581,964,1773,1048,192,84
17882,levle1_353.jpg,fore,Unspecified,0.0,0,1750,642,1926,826,176,184
17883,levle1_353.jpg,fore,Unspecified,0.0,0,2156,926,2325,1156,169,230
17884,levle1_353.jpg,fore,Unspecified,0.0,0,639,2251,807,2481,168,230
17885,levle1_353.jpg,fore,Unspecified,0.0,0,1083,2374,1214,2543,131,169
17886,levle1_353.jpg,fore,Unspecified,0.0,0,1198,2382,1321,2535,123,153
17887,levle1_353.jpg,fore,Unspecified,0.0,0,1283,2558,1497,2757,214,199
17888,levle1_353.jpg,fore,Unspecified,0.0,0,1359,3286,1520,3424,161,138
17889,levle1_353.jpg,fore,Unspecified,0.0,0,1321,2290,1459,2451,138,161
17890,levle0_140.jpg,fore,Unspecified,0.0,0,1122,2152,1229,2259,107,107
17891,levle3_12.jpg,fore,,,0,230,105,267,147,37,42
17892,levle3_12.jpg,fore,,,0,207,48,242,89,35,41
17893,levle3_12.jpg,fore,,,0,191,2,223,44,32,42
17894,levle3_12.jpg,fore,,,0,102,32,155,78,53,46
17895,levle3_12.jpg,fore,,,0,143,55,191,92,48,37
17896,levle3_12.jpg,fore,,,0,163,78,202,121,39,43
17897,levle3_12.jpg,fore,,,0,186,106,230,144,44,38
17898,levle3_12.jpg,fore,,,0,210,142,234,172,24,30
17899,levle3_12.jpg,fore,,,0,186,163,230,211,44,48
17900,levle3_12.jpg,fore,,,0,150,146,184,179,34,33
17901,levle3_12.jpg,fore,,,0,111,96,145,133,34,37
17902,levle3_12.jpg,fore,,,0,108,142,154,185,46,43
17903,levle3_12.jpg,fore,,,0,154,254,195,275,41,21
17904,levle3_12.jpg,fore,,,0,180,342,207,373,27,31
17905,levle3_12.jpg,fore,,,0,33,350,54,378,21,28
17906,levle3_12.jpg,fore,,,0,170,284,202,312,32,28
17907,levle3_12.jpg,fore,,,0,207,295,242,328,35,33
17908,levle3_12.jpg,fore,,,0,223,318,260,358,37,40
17909,levle3_12.jpg,fore,,,0,257,296,290,332,33,36
17910,levle3_12.jpg,fore,,,0,86,275,127,326,41,51
17911,levle3_12.jpg,fore,,,0,124,270,154,298,30,28
17912,levle3_12.jpg,fore,,,0,44,234,77,270,33,36
17913,levle3_12.jpg,fore,,,0,72,227,108,268,36,41
17914,levle3_12.jpg,fore,,,0,46,163,74,208,28,45
17915,levle3_12.jpg,fore,,,0,74,167,109,206,35,39
17916,levle3_12.jpg,fore,,,0,104,190,147,236,43,46
17917,levle3_12.jpg,fore,,,0,26,124,70,165,44,41
17918,levle3_12.jpg,fore,,,0,58,131,102,156,44,25
17919,levle3_12.jpg,fore,,,0,69,83,102,119,33,36
17920,levle3_12.jpg,fore,,,0,99,403,118,423,19,20
17921,levle3_12.jpg,fore,,,0,120,379,143,392,23,13
17922,levle3_12.jpg,fore,,,0,150,332,166,351,16,19
17923,levle3_12.jpg,fore,,,0,127,303,151,327,24,24
17924,levle3_12.jpg,fore,,,0,34,290,57,312,23,22
17925,levle3_12.jpg,fore,,,0,218,251,237,270,19,19
17926,levle3_12.jpg,fore,,,0,183,224,215,255,32,31
17927,levle3_12.jpg,fore,,,0,272,266,290,282,18,16
17928,levle3_12.jpg,fore,,,0,303,333,328,357,25,24
17929,levle3_12.jpg,fore,,,0,102,452,122,470,20,18
17930,levle3_12.jpg,fore,,,0,80,479,105,499,25,20
17931,levle3_12.jpg,fore,,,0,55,458,80,480,25,22
17932,levle3_12.jpg,fore,,,0,174,421,190,443,16,22
17933,levle3_12.jpg,fore,,,0,143,419,175,450,32,31
17934,levle3_12.jpg,fore,,,0,153,401,173,417,20,16
17935,levle3_12.jpg,fore,,,0,189,391,212,412,23,21
17936,levle3_12.jpg,fore,,,0,89,335,112,358,23,23
17937,levle3_12.jpg,fore,,,0,120,331,148,357,28,26
17938,levle3_12.jpg,fore,,,0,65,284,89,304,24,20
17939,levle3_12.jpg,fore,,,0,19,75,41,95,22,20
17940,levle3_12.jpg,fore,,,0,22,42,49,65,27,23
17941,levle3_12.jpg,fore,,,0,9,208,37,238,28,30
17942,levle3_12.jpg,fore,,,0,264,209,286,242,22,33
17943,levle3_12.jpg,fore,,,0,166,312,187,336,21,24
17944,levle3_12.jpg,fore,,,0,187,323,211,344,24,21
17945,levle3_12.jpg,fore,,,0,54,356,75,379,21,23
17946,levle3_12.jpg,fore,,,0,44,423,68,440,24,17
17947,levle3_12.jpg,fore,,,0,70,440,94,459,24,19
17948,levle3_12.jpg,fore,,,0,97,430,125,450,28,20
17949,levle3_12.jpg,fore,,,0,94,379,119,395,25,16
17950,levle1_347.jpg,fore,Unspecified,0.0,0,1612,2489,1719,2642,107,153
17951,levle1_347.jpg,fore,Unspecified,0.0,0,1735,2382,1850,2604,115,222
17952,levle1_347.jpg,fore,Unspecified,0.0,0,1834,2343,1934,2543,100,200
17953,levle1_347.jpg,fore,Unspecified,0.0,0,1934,2290,2018,2443,84,153
17954,levle1_347.jpg,fore,Unspecified,0.0,0,1765,2167,1880,2282,115,115
17955,levle1_347.jpg,fore,Unspecified,0.0,0,1972,2474,2072,2573,100,99
17956,levle1_347.jpg,fore,Unspecified,0.0,0,2194,2382,2363,2504,169,122
17957,levle1_347.jpg,fore,Unspecified,0.0,0,1980,2979,2118,3125,138,146
17958,levle1_347.jpg,fore,Unspecified,0.0,0,2302,2895,2447,3041,145,146
17959,levle0_154.jpg,fore,Unspecified,0.0,0,1558,489,1696,650,138,161
17960,levle1_421.jpg,fore,Unspecified,0.0,0,815,535,976,719,161,184
17961,levle1_421.jpg,fore,Unspecified,0.0,0,1850,1163,2003,1286,153,123
17962,levle1_421.jpg,fore,Unspecified,0.0,0,1827,1294,2003,1470,176,176
17963,levle1_421.jpg,fore,Unspecified,0.0,0,2225,1133,2401,1317,176,184
17964,levle1_421.jpg,fore,Unspecified,0.0,0,2164,1623,2302,1776,138,153
17965,levle1_421.jpg,fore,Unspecified,0.0,0,455,2037,731,2244,276,207
17966,levle1_421.jpg,fore,Unspecified,0.0,0,1980,1976,2095,2152,115,176
17967,levle1_409.jpg,fore,Unspecified,0.0,0,1666,865,1857,995,191,130
17968,levle1_409.jpg,fore,Unspecified,0.0,0,700,1340,869,1485,169,145
17969,levle1_409.jpg,fore,Unspecified,0.0,0,953,2412,1122,2512,169,100
17970,levle1_409.jpg,fore,Unspecified,0.0,0,899,2581,991,2742,92,161
17971,levle1_409.jpg,fore,Unspecified,0.0,0,961,2880,1091,3025,130,145
17972,levle1_409.jpg,fore,Unspecified,0.0,0,1083,2796,1260,2934,177,138
17973,levle1_409.jpg,fore,Unspecified,0.0,0,792,2880,961,3002,169,122
17974,levle0_168.jpg,fore,Unspecified,0.0,0,1443,2788,1581,2926,138,138
17975,levle1_390.jpg,fore,Unspecified,0.0,0,562,2106,647,2221,85,115
17976,levle1_390.jpg,fore,Unspecified,0.0,0,593,2328,746,2474,153,146
17977,levle1_390.jpg,fore,Unspecified,0.0,0,578,2803,708,2972,130,169
17978,levle1_390.jpg,fore,Unspecified,0.0,0,731,2788,830,2872,99,84
17979,levle1_390.jpg,fore,Unspecified,0.0,0,769,2880,853,2964,84,84
17980,levle1_390.jpg,fore,Unspecified,0.0,0,800,3018,976,3148,176,130
17981,levle0_183.jpg,fore,Unspecified,0.0,0,1359,2351,1497,2489,138,138
17982,levle1_384.jpg,fore,Unspecified,0.0,0,1175,1278,1344,1416,169,138
17983,levle1_384.jpg,fore,Unspecified,0.0,0,700,466,945,604,245,138
17984,levle1_384.jpg,fore,Unspecified,0.0,0,1834,2727,1957,2880,123,153
17985,levle1_384.jpg,fore,Unspecified,0.0,0,1558,2842,1673,2979,115,137
17986,levle1_384.jpg,fore,Unspecified,0.0,0,2248,2366,2363,2489,115,123
17987,levle1_384.jpg,fore,Unspecified,0.0,0,1942,2573,2057,2711,115,138
17988,levle0_197.jpg,fore,Unspecified,0.0,0,1505,2987,1627,3148,122,161
17989,levle0_197.jpg,fore,Unspecified,0.0,0,1528,259,1658,458,130,199
17990,levle0_197.jpg,fore,Unspecified,0.0,0,1673,137,1980,382,307,245
17991,levle0_342.jpg,fore,Unspecified,0.0,0,2317,2290,2424,2382,107,92
17992,levle1_151.jpg,fore,Unspecified,0.0,0,1635,2727,1712,2849,77,122
17993,levle1_151.jpg,fore,Unspecified,0.0,0,1712,2267,1865,2359,153,92
17994,levle1_151.jpg,fore,Unspecified,0.0,0,2156,2259,2317,2374,161,115
17995,levle1_151.jpg,fore,Unspecified,0.0,0,1758,2351,1926,2435,168,84
17996,levle1_637.jpg,fore,Unspecified,0.0,0,1306,1738,1512,1983,206,245
17997,levle1_637.jpg,fore,Unspecified,0.0,0,670,2121,777,2274,107,153
17998,levle1_637.jpg,fore,Unspecified,0.0,0,1275,2221,1459,2443,184,222
17999,levle1_637.jpg,fore,Unspecified,0.0,0,1873,2198,2003,2313,130,115
18000,levle1_637.jpg,fore,Unspecified,0.0,0,1489,2527,1712,2727,223,200
18001,levle1_637.jpg,fore,Unspecified,0.0,0,1122,2711,1283,2803,161,92
18002,levle1_637.jpg,fore,Unspecified,0.0,0,1352,2757,1505,2888,153,131
18003,levle1_637.jpg,fore,Unspecified,0.0,0,608,2635,846,2773,238,138
18004,levle0_424.jpg,fore,Unspecified,0.0,0,1466,2880,1551,2979,85,99
18005,levle0_424.jpg,fore,Unspecified,0.0,0,1260,3117,1344,3255,84,138
18006,levle1_623.jpg,fore,Unspecified,0.0,0,2202,872,2317,995,115,123
18007,levle1_623.jpg,fore,Unspecified,0.0,0,1191,1117,1352,1248,161,131
18008,levle1_623.jpg,fore,Unspecified,0.0,0,1880,2397,2026,2573,146,176
18009,levle1_623.jpg,fore,Unspecified,0.0,0,1589,2443,1727,2612,138,169
18010,levle1_623.jpg,fore,Unspecified,0.0,0,1773,2543,1949,2688,176,145
18011,levle1_623.jpg,fore,Unspecified,0.0,0,1719,2704,1857,2803,138,99
18012,levle1_623.jpg,fore,Unspecified,0.0,0,1283,2972,1428,3071,145,99
18013,levle1_623.jpg,fore,Unspecified,0.0,0,1137,2972,1283,3064,146,92
18014,levle1_623.jpg,fore,Unspecified,0.0,0,1888,3186,2057,3324,169,138
18015,levle1_623.jpg,fore,Unspecified,0.0,0,1451,3079,1704,3271,253,192
18016,levle0_430.jpg,fore,Unspecified,0.0,0,1712,3186,1850,3294,138,108
18017,levle0_356.jpg,fore,Unspecified,0.0,0,1336,2022,1512,2251,176,229
18018,levle1_145.jpg,fore,Unspecified,0.0,0,1313,2313,1413,2351,100,38
18019,levle1_145.jpg,fore,Unspecified,0.0,0,1329,2351,1405,2435,76,84
18020,levle1_145.jpg,fore,Unspecified,0.0,0,1275,2397,1344,2497,69,100
18021,levle1_145.jpg,fore,Unspecified,0.0,0,1581,2481,1696,2558,115,77
18022,levle1_145.jpg,fore,Unspecified,0.0,0,1949,2880,2072,3002,123,122
18023,levle1_145.jpg,fore,Unspecified,0.0,0,1344,2987,1436,3048,92,61
18024,levle1_145.jpg,fore,Unspecified,0.0,0,1413,3071,1474,3148,61,77
18025,levle0_43.jpg,fore,Unspecified,0.0,0,1191,3018,1336,3133,145,115
18026,levle0_43.jpg,fore,Unspecified,0.0,0,930,2842,1099,2987,169,145
18027,levle0_418.jpg,fore,Unspecified,0.0,0,1650,979,1788,1125,138,146
18028,levle0_418.jpg,fore,Unspecified,0.0,0,2133,2719,2248,2834,115,115
18029,levle0_418.jpg,fore,Unspecified,0.0,0,2286,3056,2478,3194,192,138
18030,levle0_418.jpg,fore,Unspecified,0.0,0,1260,3225,1382,3370,122,145
18031,levle0_57.jpg,fore,Unspecified,0.0,0,2168,745,2558,1086,390,341
18032,levle0_57.jpg,fore,Unspecified,0.0,0,3082,1859,3373,2216,291,357
18033,levle0_57.jpg,fore,Unspecified,0.0,0,2533,1161,2882,1402,349,241
18034,levle0_57.jpg,fore,Unspecified,0.0,0,2592,504,2924,803,332,299
18035,levle0_57.jpg,fore,Unspecified,0.0,0,1170,1792,1661,2283,491,491
18036,levle1_179.jpg,fore,Unspecified,0.0,0,463,2520,578,2619,115,99
18037,levle1_179.jpg,fore,Unspecified,0.0,0,447,2313,578,2466,131,153
18038,levle1_179.jpg,fore,Unspecified,0.0,0,317,2305,440,2435,123,130
18039,levle1_179.jpg,fore,Unspecified,0.0,0,340,2489,455,2650,115,161
18040,levle1_179.jpg,fore,Unspecified,0.0,0,922,3094,1053,3209,131,115
18041,levle1_179.jpg,fore,Unspecified,0.0,0,156,1922,340,2083,184,161
18042,levle1_179.jpg,fore,Unspecified,0.0,0,784,1087,892,1232,108,145
18043,levle1_179.jpg,fore,Unspecified,0.0,0,1359,1048,1497,1194,138,146
18044,levle1_179.jpg,fore,Unspecified,0.0,0,1076,887,1229,1048,153,161
18045,levle1_179.jpg,fore,Unspecified,0.0,0,317,1853,470,1976,153,123
18046,levle1_179.jpg,fore,Unspecified,0.0,0,263,1638,371,1792,108,154
18047,levle0_381.jpg,fore,Unspecified,0.0,0,1850,351,1988,497,138,146
18048,levle0_381.jpg,fore,Unspecified,0.0,0,1827,160,1949,274,122,114
18049,levle0_381.jpg,fore,Unspecified,0.0,0,2800,2343,2892,2497,92,154
18050,levle0_381.jpg,fore,Unspecified,0.0,0,1129,2114,1275,2267,146,153
18051,levle1_192.jpg,fore,Unspecified,0.0,0,1428,359,1558,497,130,138
18052,levle1_192.jpg,fore,Unspecified,0.0,0,2271,826,2455,1025,184,199
18053,levle1_192.jpg,fore,Unspecified,0.0,0,1566,2979,1727,3156,161,177
18054,levle1_192.jpg,fore,Unspecified,0.0,0,1451,3002,1551,3140,100,138
18055,levle1_192.jpg,fore,Unspecified,0.0,0,2225,2213,2371,2374,146,161
18056,levle1_192.jpg,fore,Unspecified,0.0,0,1229,1861,1336,1983,107,122
18057,levle1_192.jpg,fore,Unspecified,0.0,0,1405,1838,1551,2006,146,168
18058,levle1_192.jpg,fore,Unspecified,0.0,0,1244,1592,1359,1730,115,138
18059,levle0_395.jpg,fore,Unspecified,0.0,0,1206,3278,1344,3432,138,154
18060,levle0_395.jpg,fore,Unspecified,0.0,0,1750,3278,1880,3370,130,92
18061,levle1_186.jpg,fore,Unspecified,0.0,0,1275,872,1413,979,138,107
18062,levle1_186.jpg,fore,Unspecified,0.0,0,1160,780,1267,895,107,115
18063,levle1_186.jpg,fore,Unspecified,0.0,0,1175,512,1306,604,131,92
18064,levle1_186.jpg,fore,Unspecified,0.0,0,1336,489,1466,550,130,61
18065,levle1_186.jpg,fore,Unspecified,0.0,0,1574,573,1704,665,130,92
18066,levle1_186.jpg,fore,Unspecified,0.0,0,1620,451,1758,543,138,92
18067,levle1_186.jpg,fore,Unspecified,0.0,0,2125,2014,2225,2114,100,100
18068,levle1_186.jpg,fore,Unspecified,0.0,0,2624,2129,2723,2336,99,207
18069,levle1_186.jpg,fore,Unspecified,0.0,0,2784,1355,2892,1554,108,199
18070,levle1_186.jpg,fore,Unspecified,0.0,0,2095,2481,2217,2612,122,131
18071,levle1_186.jpg,fore,Unspecified,0.0,0,1949,2765,2034,2903,85,138
18072,levle1_186.jpg,fore,Unspecified,0.0,0,1558,3025,1689,3194,131,169
18073,levle1_186.jpg,fore,Unspecified,0.0,0,2125,2704,2194,2903,69,199
18074,levle0_80.jpg,fore,Unspecified,0.0,0,1769,887,1902,1028,133,141
18075,levle0_80.jpg,fore,Unspecified,0.0,0,1711,1044,1935,1236,224,192
18076,levle0_94.jpg,fore,Unspecified,0.0,0,1459,3125,1635,3278,176,153
18077,levle0_236.jpg,fore,Unspecified,0.0,0,984,1286,1106,1393,122,107
18078,levle0_222.jpg,fore,Unspecified,0.0,0,2217,2458,2386,2650,169,192
18079,levle2_46.jpg,fore,Unspecified,0.0,0,2475,1693,2691,1876,216,183
18080,levle2_46.jpg,fore,Unspecified,0.0,0,1727,1743,1927,1892,200,149
18081,levle2_46.jpg,fore,Unspecified,0.0,0,1893,1925,2043,2092,150,167
18082,levle2_46.jpg,fore,Unspecified,0.0,0,1952,2075,2151,2283,199,208
18083,levle2_46.jpg,fore,Unspecified,0.0,0,1586,1917,1810,2125,224,208
18084,levle2_46.jpg,fore,Unspecified,0.0,0,2317,2167,2500,2358,183,191
18085,levle2_46.jpg,fore,Unspecified,0.0,0,2001,2424,2159,2632,158,208
18086,levle2_46.jpg,fore,Unspecified,0.0,0,2758,2308,2891,2416,133,108
18087,levle2_46.jpg,fore,Unspecified,0.0,0,2766,2324,2982,2582,216,258
18088,levle2_46.jpg,fore,Unspecified,0.0,0,2575,1975,2716,2125,141,150
18089,levle2_46.jpg,fore,Unspecified,0.0,0,2741,2017,3074,2241,333,224
18090,levle2_46.jpg,fore,Unspecified,0.0,0,1686,1144,1918,1443,232,299
18091,levle2_46.jpg,fore,Unspecified,0.0,0,1810,978,2026,1194,216,216
18092,levle2_46.jpg,fore,Unspecified,0.0,0,1860,1194,2076,1427,216,233
18093,levle2_46.jpg,fore,Unspecified,0.0,0,2749,1684,3015,1792,266,108
18094,levle2_46.jpg,fore,Unspecified,0.0,0,2583,770,2824,1044,241,274
18095,levle2_46.jpg,fore,Unspecified,0.0,0,2866,521,3074,779,208,258
18096,levle2_46.jpg,fore,Unspecified,0.0,0,2725,995,2924,1236,199,241
18097,levle2_46.jpg,fore,Unspecified,0.0,0,3099,471,3273,745,174,274
18098,levle2_46.jpg,fore,Unspecified,0.0,0,3223,637,3423,845,200,208
18099,levle2_46.jpg,fore,Unspecified,0.0,0,3539,745,3739,903,200,158
18100,levle2_46.jpg,fore,Unspecified,0.0,0,3497,837,3647,1044,150,207
18101,levle2_46.jpg,fore,Unspecified,0.0,0,3539,1020,3655,1219,116,199
18102,levle2_46.jpg,fore,Unspecified,0.0,0,2949,1244,3207,1468,258,224
18103,levle2_46.jpg,fore,Unspecified,0.0,0,3024,1485,3290,1734,266,249
18104,levle2_46.jpg,fore,Unspecified,0.0,0,3198,1502,3481,1734,283,232
18105,levle2_46.jpg,fore,Unspecified,0.0,0,3398,1635,3714,1901,316,266
18106,levle2_46.jpg,fore,Unspecified,0.0,0,3132,1792,3348,1984,216,192
18107,levle2_46.jpg,fore,Unspecified,0.0,0,3356,1892,3506,2025,150,133
18108,levle2_46.jpg,fore,Unspecified,0.0,0,3398,2017,3680,2258,282,241
18109,levle2_52.jpg,fore,,,0,2076,1643,2234,1801,158,158
18110,levle2_52.jpg,fore,,,0,2251,1792,2434,1892,183,100
18111,levle2_52.jpg,fore,,,0,2284,1909,2484,2100,200,191
18112,levle2_52.jpg,fore,,,0,2134,1884,2301,2058,167,174
18113,levle2_52.jpg,fore,,,0,1719,2250,1935,2457,216,207
18114,levle2_52.jpg,fore,,,0,1868,2358,2060,2491,192,133
18115,levle2_52.jpg,fore,,,0,2151,2441,2301,2657,150,216
18116,levle2_52.jpg,fore,,,0,2550,1319,2616,1443,66,124
18117,levle2_52.jpg,fore,,,0,2625,587,2783,704,158,117
18118,levle2_52.jpg,fore,,,0,3173,870,3315,986,142,116
18119,levle2_52.jpg,fore,,,0,3182,637,3306,803,124,166
18120,levle2_52.jpg,fore,,,0,2467,862,2600,1003,133,141
18121,levle2_52.jpg,fore,,,0,2899,2258,3074,2482,175,224
18122,levle2_52.jpg,fore,,,0,2708,2316,2849,2516,141,200
18123,levle2_52.jpg,fore,,,0,2949,2615,3090,2790,141,175
18124,levle2_52.jpg,fore,,,0,2824,2806,2999,2956,175,150
18125,levle2_52.jpg,fore,,,0,2467,1061,2558,1261,91,200
18126,levle2_52.jpg,fore,,,0,2342,1153,2492,1327,150,174
18127,levle2_52.jpg,fore,,,0,2292,2142,2425,2291,133,149
18128,levle2_52.jpg,fore,,,0,1654,2778,1770,2870,116,92
18129,levle2_52.jpg,fore,,,0,2626,1982,2758,2102,132,120
18130,levle2_125.jpg,fore,,,0,1658,2259,1773,2374,115,115
18131,levle2_125.jpg,fore,,,0,1558,2374,1742,2543,184,169
18132,levle2_125.jpg,fore,,,0,2233,1723,2340,1822,107,99
18133,levle2_125.jpg,fore,,,0,2309,1799,2424,1930,115,131
18134,levle2_125.jpg,fore,,,0,2049,1899,2248,2037,199,138
18135,levle2_125.jpg,fore,,,0,2079,2083,2202,2198,123,115
18136,levle2_125.jpg,fore,,,0,2148,2221,2302,2343,154,122
18137,levle2_125.jpg,fore,,,0,2210,2412,2248,2451,38,39
18138,levle2_125.jpg,fore,,,0,1704,2106,1880,2251,176,145
18139,levle2_125.jpg,fore,,,0,1543,2481,1612,2558,69,77
18140,levle2_125.jpg,fore,,,0,1696,2550,1842,2688,146,138
18141,levle2_125.jpg,fore,,,0,1919,2757,1934,2780,15,23
18142,levle2_125.jpg,fore,,,0,1788,2658,1903,2811,115,153
18143,levle2_125.jpg,fore,,,0,1827,2343,1957,2451,130,108
18144,levle2_125.jpg,fore,,,0,1367,3117,1543,3232,176,115
18145,levle2_125.jpg,fore,,,0,1497,2412,1597,2497,100,85
18146,levle2_125.jpg,fore,,,0,2240,1914,2386,2075,146,161
18147,levle2_125.jpg,fore,,,0,1612,2665,1689,2765,77,100
18148,levle2_125.jpg,fore,,,0,2008,2536,2084,2622,76,86
18149,levle2_125.jpg,fore,,,0,1522,2122,1653,2219,131,97
18150,levle2_125.jpg,fore,,,0,1795,2894,1881,2991,86,97
18151,levle2_131.jpg,fore,Unspecified,0.0,0,1053,910,1244,1033,191,123
18152,levle2_131.jpg,fore,Unspecified,0.0,0,1397,290,1566,420,169,130
18153,levle2_131.jpg,fore,Unspecified,0.0,0,562,1707,715,1868,153,161
18154,levle2_131.jpg,fore,Unspecified,0.0,0,478,1899,647,2106,169,207
18155,levle2_131.jpg,fore,Unspecified,0.0,0,524,2175,624,2221,100,46
18156,levle2_131.jpg,fore,Unspecified,0.0,0,578,2282,700,2359,122,77
18157,levle2_131.jpg,fore,Unspecified,0.0,0,593,2336,700,2451,107,115
18158,levle2_131.jpg,fore,Unspecified,0.0,0,708,2382,800,2550,92,168
18159,levle2_131.jpg,fore,Unspecified,0.0,0,777,2320,876,2443,99,123
18160,levle2_131.jpg,fore,Unspecified,0.0,0,869,2229,999,2366,130,137
18161,levle2_131.jpg,fore,Unspecified,0.0,0,777,2068,907,2213,130,145
18162,levle2_131.jpg,fore,Unspecified,0.0,0,892,1784,1030,1891,138,107
18163,levle2_131.jpg,fore,Unspecified,0.0,0,1329,1945,1474,2060,145,115
18164,levle2_131.jpg,fore,Unspecified,0.0,0,953,2374,1122,2466,169,92
18165,levle2_131.jpg,fore,Unspecified,0.0,0,945,2527,1068,2627,123,100
18166,levle2_131.jpg,fore,Unspecified,0.0,0,1030,2688,1160,2819,130,131
18167,levle2_131.jpg,fore,Unspecified,0.0,0,1122,2612,1298,2757,176,145
18168,levle2_131.jpg,fore,Unspecified,0.0,0,1221,2412,1306,2535,85,123
18169,levle2_131.jpg,fore,Unspecified,0.0,0,1306,2236,1413,2397,107,161
18170,levle2_131.jpg,fore,Unspecified,0.0,0,1781,2297,1903,2382,122,85
18171,levle2_131.jpg,fore,Unspecified,0.0,0,1589,3048,1727,3140,138,92
18172,levle2_131.jpg,fore,Unspecified,0.0,0,1604,3163,1704,3301,100,138
18173,levle2_131.jpg,fore,Unspecified,0.0,0,1719,3094,1850,3271,131,177
18174,levle2_85.jpg,fore,Unspecified,0.0,0,2026,1294,2194,1409,168,115
18175,levle2_85.jpg,fore,Unspecified,0.0,0,1183,757,1359,910,176,153
18176,levle2_85.jpg,fore,Unspecified,0.0,0,2095,1133,2248,1232,153,99
18177,levle2_85.jpg,fore,Unspecified,0.0,0,2371,1723,2486,1884,115,161
18178,levle2_85.jpg,fore,Unspecified,0.0,0,2210,1562,2302,1700,92,138
18179,levle2_85.jpg,fore,Unspecified,0.0,0,2210,1776,2355,1930,145,154
18180,levle2_85.jpg,fore,Unspecified,0.0,0,1972,1868,2133,2029,161,161
18181,levle2_85.jpg,fore,Unspecified,0.0,0,2156,1953,2271,2052,115,99
18182,levle2_85.jpg,fore,Unspecified,0.0,0,2263,2006,2378,2083,115,77
18183,levle2_85.jpg,fore,Unspecified,0.0,0,2263,2052,2386,2198,123,146
18184,levle2_85.jpg,fore,Unspecified,0.0,0,2378,2052,2509,2190,131,138
18185,levle2_85.jpg,fore,Unspecified,0.0,0,1965,1976,2118,2114,153,138
18186,levle2_85.jpg,fore,Unspecified,0.0,0,2110,2045,2225,2137,115,92
18187,levle2_85.jpg,fore,Unspecified,0.0,0,1942,2129,2102,2282,160,153
18188,levle2_85.jpg,fore,Unspecified,0.0,0,2087,2451,2217,2589,130,138
18189,levle2_85.jpg,fore,Unspecified,0.0,0,2087,2297,2256,2435,169,138
18190,levle2_85.jpg,fore,Unspecified,0.0,0,1811,2336,1949,2489,138,153
18191,levle2_85.jpg,fore,Unspecified,0.0,0,1919,2435,2026,2566,107,131
18192,levle2_85.jpg,fore,Unspecified,0.0,0,1566,2213,1650,2328,84,115
18193,levle2_85.jpg,fore,Unspecified,0.0,0,1505,2274,1597,2420,92,146
18194,levle2_85.jpg,fore,Unspecified,0.0,0,1597,2451,1742,2566,145,115
18195,levle2_85.jpg,fore,Unspecified,0.0,0,1528,2520,1681,2673,153,153
18196,levle2_85.jpg,fore,Unspecified,0.0,0,1727,2612,1880,2765,153,153
18197,levle2_85.jpg,fore,Unspecified,0.0,0,1650,2711,1773,2857,123,146
18198,levle2_85.jpg,fore,Unspecified,0.0,0,1804,2811,1942,2956,138,145
18199,levle2_85.jpg,fore,Unspecified,0.0,0,1344,3194,1505,3324,161,130
18200,levle2_119.jpg,fore,Unspecified,0.0,0,1099,1071,1237,1156,138,85
18201,levle2_119.jpg,fore,Unspecified,0.0,0,1252,941,1367,1094,115,153
18202,levle2_119.jpg,fore,Unspecified,0.0,0,1267,788,1382,895,115,107
18203,levle2_119.jpg,fore,Unspecified,0.0,0,1735,696,1842,811,107,115
18204,levle2_119.jpg,fore,Unspecified,0.0,0,1091,857,1206,987,115,130
18205,levle2_119.jpg,fore,Unspecified,0.0,0,2432,2229,2578,2382,146,153
18206,levle2_119.jpg,fore,Unspecified,0.0,0,2478,2075,2601,2206,123,131
18207,levle2_119.jpg,fore,Unspecified,0.0,0,2240,2458,2371,2589,131,131
18208,levle2_119.jpg,fore,Unspecified,0.0,0,2049,2160,2156,2267,107,107
18209,levle2_119.jpg,fore,Unspecified,0.0,0,1160,2911,1267,2995,107,84
18210,levle2_119.jpg,fore,Unspecified,0.0,0,1329,3041,1420,3156,91,115
18211,levle2_119.jpg,fore,Unspecified,0.0,0,1796,2229,1911,2359,115,130
18212,levle2_119.jpg,fore,Unspecified,0.0,0,2011,2297,2110,2443,99,146
18213,levle2_119.jpg,fore,Unspecified,0.0,0,1643,2405,1712,2550,69,145
18214,levle2_119.jpg,fore,Unspecified,0.0,0,1873,2512,2034,2635,161,123
18215,levle2_119.jpg,fore,Unspecified,0.0,0,2041,2489,2141,2612,100,123
18216,levle2_119.jpg,fore,Unspecified,0.0,0,1704,2727,1880,2865,176,138
18217,levle2_119.jpg,fore,Unspecified,0.0,0,1106,1416,1183,1516,77,100
18218,levle1_8.jpg,fore,Unspecified,0.0,0,263,53,279,74,16,21
18219,levle1_8.jpg,fore,Unspecified,0.0,0,291,60,306,84,15,24
18220,levle1_8.jpg,fore,Unspecified,0.0,0,224,273,250,298,26,25
18221,levle1_8.jpg,fore,Unspecified,0.0,0,241,310,260,334,19,24
18222,levle1_8.jpg,fore,Unspecified,0.0,0,207,359,228,388,21,29
18223,levle1_8.jpg,fore,Unspecified,0.0,0,244,374,264,395,20,21
18224,levle1_8.jpg,fore,Unspecified,0.0,0,151,391,171,410,20,19
18225,levle1_8.jpg,fore,Unspecified,0.0,0,157,435,171,453,14,18
18226,levle1_8.jpg,fore,Unspecified,0.0,0,187,318,202,340,15,22
18227,levle1_8.jpg,fore,Unspecified,0.0,0,174,289,190,311,16,22
18228,levle1_8.jpg,fore,Unspecified,0.0,0,150,283,160,300,10,17
18229,levle1_8.jpg,fore,Unspecified,0.0,0,164,316,179,340,15,24
18230,levle1_8.jpg,fore,Unspecified,0.0,0,159,249,185,285,26,36
18231,levle1_541.jpg,fore,Unspecified,0.0,0,1428,1002,1520,1133,92,131
18232,levle1_541.jpg,fore,Unspecified,0.0,0,1980,658,2133,857,153,199
18233,levle1_541.jpg,fore,Unspecified,0.0,0,800,1999,899,2129,99,130
18234,levle1_541.jpg,fore,Unspecified,0.0,0,807,2144,884,2290,77,146
18235,levle1_541.jpg,fore,Unspecified,0.0,0,938,2144,1030,2244,92,100
18236,levle1_541.jpg,fore,Unspecified,0.0,0,961,2244,1076,2359,115,115
18237,levle1_541.jpg,fore,Unspecified,0.0,0,1382,2566,1466,2681,84,115
18238,levle1_541.jpg,fore,Unspecified,0.0,0,1512,2635,1658,2757,146,122
18239,levle1_541.jpg,fore,Unspecified,0.0,0,1589,2290,1658,2412,69,122
18240,levle1_541.jpg,fore,Unspecified,0.0,0,1252,2673,1397,2788,145,115
18241,levle1_541.jpg,fore,Unspecified,0.0,0,1137,2619,1221,2750,84,131
18242,levle1_541.jpg,fore,Unspecified,0.0,0,1298,2934,1420,3056,122,122
18243,levle1_541.jpg,fore,Unspecified,0.0,0,1359,2175,1466,2328,107,153
18244,levle1_17.jpg,fore,Unspecified,0.0,0,220,276,235,301,15,25
18245,levle1_17.jpg,fore,Unspecified,0.0,0,140,254,154,268,14,14
18246,levle1_17.jpg,fore,Unspecified,0.0,0,140,132,167,154,27,22
18247,levle1_17.jpg,fore,Unspecified,0.0,0,171,320,187,342,16,22
18248,levle1_17.jpg,fore,Unspecified,0.0,0,157,334,179,355,22,21
18249,levle1_17.jpg,fore,Unspecified,0.0,0,202,331,220,349,18,18
18250,levle1_17.jpg,fore,Unspecified,0.0,0,237,328,259,350,22,22
18251,levle1_17.jpg,fore,Unspecified,0.0,0,226,362,246,390,20,28
18252,levle1_17.jpg,fore,Unspecified,0.0,0,235,395,258,416,23,21
18253,levle1_17.jpg,fore,Unspecified,0.0,0,237,414,256,432,19,18
18254,levle1_17.jpg,fore,Unspecified,0.0,0,263,411,278,432,15,21
18255,levle1_227.jpg,fore,Unspecified,0.0,0,1643,2236,1857,2336,214,100
18256,levle1_227.jpg,fore,Unspecified,0.0,0,1643,2435,1819,2581,176,146
18257,levle1_227.jpg,fore,Unspecified,0.0,0,1643,2627,1788,2757,145,130
18258,levle1_227.jpg,fore,Unspecified,0.0,0,1919,2550,2057,2658,138,108
18259,levle1_227.jpg,fore,Unspecified,0.0,0,1857,2658,1926,2711,69,53
18260,levle1_227.jpg,fore,Unspecified,0.0,0,1919,2757,2011,2865,92,108
18261,levle1_227.jpg,fore,Unspecified,0.0,0,1988,2382,2148,2512,160,130
18262,levle1_233.jpg,fore,Unspecified,0.0,0,1512,750,1627,834,115,84
18263,levle1_233.jpg,fore,Unspecified,0.0,0,2248,1409,2378,1524,130,115
18264,levle1_233.jpg,fore,Unspecified,0.0,0,1965,2129,2079,2236,114,107
18265,levle1_233.jpg,fore,Unspecified,0.0,0,2141,1983,2240,2098,99,115
18266,levle1_233.jpg,fore,Unspecified,0.0,0,2102,2382,2217,2489,115,107
18267,levle1_233.jpg,fore,Unspecified,0.0,0,1696,2443,1842,2550,146,107
18268,levle1_555.jpg,fore,Unspecified,0.0,0,723,2313,823,2474,100,161
18269,levle1_555.jpg,fore,Unspecified,0.0,0,869,2137,930,2274,61,137
18270,levle1_555.jpg,fore,Unspecified,0.0,0,991,2259,1060,2313,69,54
18271,levle1_555.jpg,fore,Unspecified,0.0,0,1466,1983,1581,2129,115,146
18272,levle1_555.jpg,fore,Unspecified,0.0,0,1443,2213,1574,2328,131,115
18273,levle1_555.jpg,fore,Unspecified,0.0,0,1681,2343,1819,2458,138,115
18274,levle1_555.jpg,fore,Unspecified,0.0,0,1804,2052,1919,2167,115,115
18275,levle1_555.jpg,fore,Unspecified,0.0,0,1788,972,1911,1133,123,161
18276,levle1_555.jpg,fore,Unspecified,0.0,0,1704,3125,1788,3202,84,77
18277,levle1_555.jpg,fore,Unspecified,0.0,0,1574,3179,1666,3263,92,84
18278,levle1_555.jpg,fore,Unspecified,0.0,0,1451,3133,1551,3271,100,138
18279,levle1_555.jpg,fore,Unspecified,0.0,0,1520,3248,1612,3332,92,84
18280,levle1_555.jpg,fore,Unspecified,0.0,0,1443,2972,1512,3117,69,145
18281,levle1_555.jpg,fore,Unspecified,0.0,0,1060,2297,1198,2504,138,207
18282,levle1_569.jpg,fore,Unspecified,0.0,0,1076,2075,1260,2244,184,169
18283,levle1_569.jpg,fore,Unspecified,0.0,0,1014,1807,1183,2006,169,199
18284,levle1_569.jpg,fore,Unspecified,0.0,0,769,2006,915,2144,146,138
18285,levle1_569.jpg,fore,Unspecified,0.0,0,738,1684,869,1868,131,184
18286,levle1_569.jpg,fore,Unspecified,0.0,0,899,1340,1030,1493,131,153
18287,levle1_569.jpg,fore,Unspecified,0.0,0,723,1455,853,1547,130,92
18288,levle1_569.jpg,fore,Unspecified,0.0,0,647,1263,800,1386,153,123
18289,levle1_569.jpg,fore,Unspecified,0.0,0,570,1363,700,1516,130,153
18290,levle1_569.jpg,fore,Unspecified,0.0,0,478,1355,585,1531,107,176
18291,levle1_569.jpg,fore,Unspecified,0.0,0,639,1569,784,1707,145,138
18292,levle1_569.jpg,fore,Unspecified,0.0,0,532,1071,624,1240,92,169
18293,levle1_582.jpg,fore,Unspecified,0.0,0,2309,972,2378,1110,69,138
18294,levle1_582.jpg,fore,Unspecified,0.0,0,2394,1332,2486,1432,92,100
18295,levle1_582.jpg,fore,Unspecified,0.0,0,2417,1025,2555,1186,138,161
18296,levle1_582.jpg,fore,Unspecified,0.0,0,1750,819,1857,949,107,130
18297,levle1_582.jpg,fore,Unspecified,0.0,0,1604,673,1781,865,177,192
18298,levle1_582.jpg,fore,Unspecified,0.0,0,2501,2029,2601,2152,100,123
18299,levle1_582.jpg,fore,Unspecified,0.0,0,2562,2213,2670,2351,108,138
18300,levle1_582.jpg,fore,Unspecified,0.0,0,1942,3140,2057,3271,115,131
18301,levle1_582.jpg,fore,Unspecified,0.0,0,1581,2926,1727,3102,146,176
18302,levle1_582.jpg,fore,Unspecified,0.0,0,1198,3064,1382,3202,184,138
18303,levle3_120.jpg,fore,,,0,298,96,316,114,18,18
18304,levle3_120.jpg,fore,,,0,224,146,237,165,13,19
18305,levle3_120.jpg,fore,,,0,214,166,237,185,23,19
18306,levle3_120.jpg,fore,,,0,229,183,245,195,16,12
18307,levle3_120.jpg,fore,,,0,191,107,204,127,13,20
18308,levle3_120.jpg,fore,,,0,190,89,207,111,17,22
18309,levle3_120.jpg,fore,,,0,173,90,189,111,16,21
18310,levle3_120.jpg,fore,,,0,122,25,140,41,18,16
18311,levle3_120.jpg,fore,,,0,72,228,85,241,13,13
18312,levle3_120.jpg,fore,,,0,82,251,103,271,21,20
18313,levle3_120.jpg,fore,,,0,102,293,119,306,17,13
18314,levle3_120.jpg,fore,,,0,126,289,143,305,17,16
18315,levle3_120.jpg,fore,,,0,152,292,171,310,19,18
18316,levle3_120.jpg,fore,,,0,191,263,211,287,20,24
18317,levle3_120.jpg,fore,,,0,202,249,220,271,18,22
18318,levle3_120.jpg,fore,,,0,246,255,263,272,17,17
18319,levle3_120.jpg,fore,,,0,180,195,195,214,15,19
18320,levle3_120.jpg,fore,,,0,255,141,279,173,24,32
18321,levle3_120.jpg,fore,,,0,222,113,253,142,31,29
18322,levle3_120.jpg,fore,,,0,265,108,292,124,27,16
18323,levle3_120.jpg,fore,,,0,262,128,295,144,33,16
18324,levle3_120.jpg,fore,,,0,302,83,319,99,17,16
18325,levle3_120.jpg,fore,,,0,323,112,341,132,18,20
18326,levle3_120.jpg,fore,,,0,314,162,340,173,26,11
18327,levle3_120.jpg,fore,,,0,309,173,325,188,16,15
18328,levle3_120.jpg,fore,,,0,278,186,292,204,14,18
18329,levle3_120.jpg,fore,,,0,291,180,305,197,14,17
18330,levle3_120.jpg,fore,,,0,222,200,238,214,16,14
18331,levle3_120.jpg,fore,,,0,230,233,244,255,14,22
18332,levle3_120.jpg,fore,,,0,244,231,267,254,23,23
18333,levle3_120.jpg,fore,,,0,209,281,224,294,15,13
18334,levle3_120.jpg,fore,,,0,168,276,186,290,18,14
18335,levle3_120.jpg,fore,,,0,148,245,167,267,19,22
18336,levle3_120.jpg,fore,,,0,155,217,175,234,20,17
18337,levle3_120.jpg,fore,,,0,199,75,210,88,11,13
18338,levle3_120.jpg,fore,,,0,170,52,185,66,15,14
18339,levle3_120.jpg,fore,,,0,159,56,173,71,14,15
18340,levle3_120.jpg,fore,,,0,7,69,27,83,20,14
18341,levle3_120.jpg,fore,,,0,13,36,34,49,21,13
18342,levle3_120.jpg,fore,,,0,194,154,212,168,18,14
18343,levle3_120.jpg,fore,,,0,116,228,126,239,10,11
18344,levle3_120.jpg,fore,,,0,119,238,130,249,11,11
18345,levle3_120.jpg,fore,,,0,327,174,342,192,15,18
18346,levle3_120.jpg,fore,,,0,281,155,297,170,16,15
18347,levle3_120.jpg,fore,,,0,247,181,263,195,16,14
18348,levle3_120.jpg,fore,,,0,256,190,272,204,16,14
18349,levle3_120.jpg,fore,,,0,250,206,268,224,18,18
18350,levle3_120.jpg,fore,,,0,263,243,276,258,13,15
18351,levle3_120.jpg,fore,,,0,342,131,352,144,10,13
18352,levle3_120.jpg,fore,,,0,342,145,352,156,10,11
18353,levle3_120.jpg,fore,,,0,343,159,352,176,9,17
18354,levle3_120.jpg,fore,,,0,187,172,200,185,13,13
18355,levle3_120.jpg,fore,,,0,195,182,213,199,18,17
18356,levle3_120.jpg,fore,,,0,194,235,209,246,15,11
18357,levle3_120.jpg,fore,,,0,168,239,183,256,15,17
18358,levle3_120.jpg,fore,,,0,175,116,190,134,15,18
18359,levle3_120.jpg,fore,,,0,291,119,312,132,21,13
18360,levle3_120.jpg,fore,,,0,294,203,317,219,23,16
18361,levle3_120.jpg,fore,,,0,328,99,340,118,12,19
18362,levle3_120.jpg,fore,,,0,236,147,252,165,16,18
18363,levle3_120.jpg,fore,,,0,193,135,212,151,19,16
18364,levle3_120.jpg,fore,,,0,205,114,222,134,17,20
18365,levle3_120.jpg,fore,,,0,211,91,231,109,20,18
18366,levle1_596.jpg,fore,Unspecified,0.0,0,2501,2198,2716,2328,215,130
18367,levle1_596.jpg,fore,Unspecified,0.0,0,2409,2374,2539,2504,130,130
18368,levle1_596.jpg,fore,Unspecified,0.0,0,2386,2658,2509,2788,123,130
18369,levle1_596.jpg,fore,Unspecified,0.0,0,2279,2374,2386,2535,107,161
18370,levle1_596.jpg,fore,Unspecified,0.0,0,2708,1937,2838,2029,130,92
18371,levle1_596.jpg,fore,Unspecified,0.0,0,1405,3232,1520,3347,115,115
18372,levle3_108.jpg,fore,,,0,77,64,96,78,19,14
18373,levle3_108.jpg,fore,,,0,86,76,99,85,13,9
18374,levle3_108.jpg,fore,,,0,97,76,110,92,13,16
18375,levle3_108.jpg,fore,,,0,95,88,111,105,16,17
18376,levle3_108.jpg,fore,,,0,73,111,88,121,15,10
18377,levle3_108.jpg,fore,,,0,95,109,114,126,19,17
18378,levle3_108.jpg,fore,,,0,123,122,136,136,13,14
18379,levle3_108.jpg,fore,,,0,99,126,114,135,15,9
18380,levle3_108.jpg,fore,,,0,79,119,93,136,14,17
18381,levle3_108.jpg,fore,,,0,68,130,83,139,15,9
18382,levle3_108.jpg,fore,,,0,89,134,103,147,14,13
18383,levle3_108.jpg,fore,,,0,100,146,115,160,15,14
18384,levle3_108.jpg,fore,,,0,38,117,54,126,16,9
18385,levle3_108.jpg,fore,,,0,24,129,41,145,17,16
18386,levle3_108.jpg,fore,,,0,41,130,55,145,14,15
18387,levle3_108.jpg,fore,,,0,40,143,55,151,15,8
18388,levle3_108.jpg,fore,,,0,28,148,46,162,18,14
18389,levle3_108.jpg,fore,,,0,60,135,73,149,13,14
18390,levle3_108.jpg,fore,,,0,61,149,71,161,10,12
18391,levle3_108.jpg,fore,,,0,51,154,67,169,16,15
18392,levle3_108.jpg,fore,,,0,57,167,74,180,17,13
18393,levle3_108.jpg,fore,,,0,50,174,58,183,8,9
18394,levle3_108.jpg,fore,,,0,23,190,36,206,13,16
18395,levle3_108.jpg,fore,,,0,34,192,47,209,13,17
18396,levle3_108.jpg,fore,,,0,45,193,57,204,12,11
18397,levle3_108.jpg,fore,,,0,61,187,75,202,14,15
18398,levle3_108.jpg,fore,,,0,72,153,82,167,10,14
18399,levle3_108.jpg,fore,,,0,90,148,100,162,10,14
18400,levle3_108.jpg,fore,,,0,60,216,83,231,23,15
18401,levle3_108.jpg,fore,,,0,23,225,46,248,23,23
18402,levle3_108.jpg,fore,,,0,117,166,130,179,13,13
18403,levle3_108.jpg,fore,,,0,120,174,139,189,19,15
18404,levle3_108.jpg,fore,,,0,92,210,113,225,21,15
18405,levle3_108.jpg,fore,,,0,85,183,103,197,18,14
18406,levle3_108.jpg,fore,,,0,33,170,55,187,22,17
18407,levle3_108.jpg,fore,,,0,118,191,139,200,21,9
18408,levle3_108.jpg,fore,,,0,118,203,138,220,20,17
18409,levle3_108.jpg,fore,,,0,14,258,26,269,12,11
18410,levle3_108.jpg,fore,,,0,14,161,27,173,13,12
18411,levle3_108.jpg,fore,,,0,71,199,83,207,12,8
18412,levle3_108.jpg,fore,,,0,50,222,61,234,11,12
18413,levle3_108.jpg,fore,,,0,42,231,59,244,17,13
18414,levle3_108.jpg,fore,,,0,52,240,67,251,15,11
18415,levle3_108.jpg,fore,,,0,36,249,49,260,13,11
18416,levle3_108.jpg,fore,,,0,105,192,116,205,11,13
18417,levle3_108.jpg,fore,,,0,100,185,112,199,12,14
18418,levle3_108.jpg,fore,,,0,72,139,86,152,14,13
18419,levle3_108.jpg,fore,,,0,114,143,125,155,11,12
18420,levle3_108.jpg,fore,,,0,94,167,106,177,12,10
18421,levle3_108.jpg,fore,,,0,82,173,96,184,14,11
18422,levle3_108.jpg,fore,,,0,84,161,96,174,12,13
18423,levle3_108.jpg,fore,,,0,128,149,139,160,11,11
18424,levle3_108.jpg,fore,,,0,128,159,141,169,13,10
18425,levle3_108.jpg,fore,,,0,13,147,26,161,13,14
18426,levle3_108.jpg,fore,,,0,15,175,32,189,17,14
18427,levle3_108.jpg,fore,,,0,30,205,42,218,12,13
18428,levle3_109.jpg,fore,Unspecified,0.0,0,125,97,138,115,13,18
18429,levle3_109.jpg,fore,Unspecified,0.0,0,108,96,123,109,15,13
18430,levle3_109.jpg,fore,Unspecified,0.0,0,102,102,110,109,8,7
18431,levle3_109.jpg,fore,Unspecified,0.0,0,118,87,127,92,9,5
18432,levle3_109.jpg,fore,Unspecified,0.0,0,121,72,129,81,8,9
18433,levle3_109.jpg,fore,Unspecified,0.0,0,129,44,141,57,12,13
18434,levle3_109.jpg,fore,Unspecified,0.0,0,142,45,150,54,8,9
18435,levle3_109.jpg,fore,Unspecified,0.0,0,137,54,150,61,13,7
18436,levle3_109.jpg,fore,Unspecified,0.0,0,160,73,169,83,9,10
18437,levle3_109.jpg,fore,Unspecified,0.0,0,158,32,171,45,13,13
18438,levle3_109.jpg,fore,Unspecified,0.0,0,52,32,65,42,13,10
18439,levle3_109.jpg,fore,Unspecified,0.0,0,51,49,64,62,13,13
18440,levle3_109.jpg,fore,Unspecified,0.0,0,43,60,57,72,14,12
18441,levle3_109.jpg,fore,Unspecified,0.0,0,64,91,73,101,9,10
18442,levle3_109.jpg,fore,Unspecified,0.0,0,73,87,82,94,9,7
18443,levle3_109.jpg,fore,Unspecified,0.0,0,83,91,96,102,13,11
18444,levle3_109.jpg,fore,Unspecified,0.0,0,77,102,93,114,16,12
18445,levle3_109.jpg,fore,Unspecified,0.0,0,43,126,58,138,15,12
18446,levle3_109.jpg,fore,Unspecified,0.0,0,43,165,53,174,10,9
18447,levle3_109.jpg,fore,Unspecified,0.0,0,44,147,60,165,16,18
18448,levle3_109.jpg,fore,Unspecified,0.0,0,40,182,56,190,16,8
18449,levle3_109.jpg,fore,Unspecified,0.0,0,55,172,71,185,16,13
18450,levle3_109.jpg,fore,Unspecified,0.0,0,53,197,68,214,15,17
18451,levle3_109.jpg,fore,Unspecified,0.0,0,57,184,72,194,15,10
18452,levle3_109.jpg,fore,Unspecified,0.0,0,68,192,83,204,15,12
18453,levle3_109.jpg,fore,Unspecified,0.0,0,79,187,93,200,14,13
18454,levle3_109.jpg,fore,Unspecified,0.0,0,95,37,118,58,23,21
18455,levle3_109.jpg,fore,Unspecified,0.0,0,105,58,122,68,17,10
18456,levle3_109.jpg,fore,Unspecified,0.0,0,93,62,114,84,21,22
18457,levle3_109.jpg,fore,Unspecified,0.0,0,25,74,37,90,12,16
18458,levle3_109.jpg,fore,Unspecified,0.0,0,39,75,57,87,18,12
18459,levle3_109.jpg,fore,Unspecified,0.0,0,49,85,64,96,15,11
18460,levle3_109.jpg,fore,Unspecified,0.0,0,45,97,63,104,18,7
18461,levle3_109.jpg,fore,Unspecified,0.0,0,48,107,65,122,17,15
18462,levle3_109.jpg,fore,Unspecified,0.0,0,68,119,80,125,12,6
18463,levle3_109.jpg,fore,Unspecified,0.0,0,79,123,85,134,6,11
18464,levle3_109.jpg,fore,Unspecified,0.0,0,70,136,85,149,15,13
18465,levle3_109.jpg,fore,Unspecified,0.0,0,72,149,88,162,16,13
18466,levle3_109.jpg,fore,Unspecified,0.0,0,59,156,72,168,13,12
18467,levle3_109.jpg,fore,Unspecified,0.0,0,71,166,85,179,14,13
18468,levle3_109.jpg,fore,Unspecified,0.0,0,91,133,111,146,20,13
18469,levle3_109.jpg,fore,Unspecified,0.0,0,99,143,119,158,20,15
18470,levle3_109.jpg,fore,Unspecified,0.0,0,117,133,127,141,10,8
18471,levle3_109.jpg,fore,Unspecified,0.0,0,88,156,104,167,16,11
18472,levle3_109.jpg,fore,Unspecified,0.0,0,91,170,104,180,13,10
18473,levle3_109.jpg,fore,Unspecified,0.0,0,105,171,114,181,9,10
18474,levle3_109.jpg,fore,Unspecified,0.0,0,107,182,118,193,11,11
18475,levle3_109.jpg,fore,Unspecified,0.0,0,112,161,126,172,14,11
18476,levle3_109.jpg,fore,Unspecified,0.0,0,119,170,134,180,15,10
18477,levle3_109.jpg,fore,Unspecified,0.0,0,141,148,154,156,13,8
18478,levle3_109.jpg,fore,Unspecified,0.0,0,135,167,153,176,18,9
18479,levle3_109.jpg,fore,Unspecified,0.0,0,142,182,163,195,21,13
18480,levle3_121.jpg,fore,,,0,430,335,449,360,19,25
18481,levle3_121.jpg,fore,,,0,455,337,470,356,15,19
18482,levle3_121.jpg,fore,,,0,426,291,452,315,26,24
18483,levle3_121.jpg,fore,,,0,397,277,417,303,20,26
18484,levle3_121.jpg,fore,,,0,416,255,443,281,27,26
18485,levle3_121.jpg,fore,,,0,429,225,456,249,27,24
18486,levle3_121.jpg,fore,,,0,423,195,443,216,20,21
18487,levle3_121.jpg,fore,,,0,322,232,337,244,15,12
18488,levle3_121.jpg,fore,,,0,306,245,342,277,36,32
18489,levle3_121.jpg,fore,,,0,341,180,364,211,23,31
18490,levle3_121.jpg,fore,,,0,352,172,385,198,33,26
18491,levle3_121.jpg,fore,,,0,360,203,387,234,27,31
18492,levle3_121.jpg,fore,,,0,330,110,357,144,27,34
18493,levle3_121.jpg,fore,,,0,293,127,314,159,21,32
18494,levle3_121.jpg,fore,,,0,276,88,294,109,18,21
18495,levle3_121.jpg,fore,,,0,304,124,309,131,5,7
18496,levle3_121.jpg,fore,,,0,254,352,287,377,33,25
18497,levle3_121.jpg,fore,,,0,281,367,314,393,33,26
18498,levle3_121.jpg,fore,,,0,299,388,326,417,27,29
18499,levle3_121.jpg,fore,,,0,321,379,341,407,20,28
18500,levle3_121.jpg,fore,,,0,325,419,349,438,24,19
18501,levle3_121.jpg,fore,,,0,283,306,299,335,16,29
18502,levle3_121.jpg,fore,,,0,519,363,548,384,29,21
18503,levle3_121.jpg,fore,,,0,488,381,508,400,20,19
18504,levle3_121.jpg,fore,,,0,506,338,531,365,25,27
18505,levle3_121.jpg,fore,,,0,382,258,396,271,14,13
18506,levle3_121.jpg,fore,,,0,323,291,347,311,24,20
18507,levle3_121.jpg,fore,,,0,340,326,379,364,39,38
18508,levle3_121.jpg,fore,,,0,348,359,393,409,45,50
18509,levle3_121.jpg,fore,,,0,514,277,550,309,36,32
18510,levle3_121.jpg,fore,,,0,519,394,552,420,33,26
18511,levle3_121.jpg,fore,,,0,472,405,509,438,37,33
18512,levle3_121.jpg,fore,,,0,502,418,531,442,29,24
18513,levle3_121.jpg,fore,,,0,416,395,440,429,24,34
18514,levle3_121.jpg,fore,,,0,560,346,584,369,24,23
18515,levle3_121.jpg,fore,,,0,384,340,411,366,27,26
18516,levle3_121.jpg,fore,,,0,259,265,292,286,33,21
18517,levle3_121.jpg,fore,,,0,361,415,385,445,24,30
18518,levle3_121.jpg,fore,,,0,415,444,440,461,25,17
18519,levle3_121.jpg,fore,,,0,596,314,614,332,18,18
18520,levle3_121.jpg,fore,,,0,570,309,591,331,21,22
18521,levle3_121.jpg,fore,,,0,619,308,642,338,23,30
18522,levle3_121.jpg,fore,,,0,599,336,628,358,29,22
18523,levle3_121.jpg,fore,,,0,561,284,588,311,27,27
18524,levle3_121.jpg,fore,,,0,498,323,528,348,30,25
18525,levle3_121.jpg,fore,,,0,478,355,501,377,23,22
18526,levle3_121.jpg,fore,,,0,461,389,481,411,20,22
18527,levle3_121.jpg,fore,,,0,530,434,549,453,19,19
18528,levle3_121.jpg,fore,,,0,492,442,526,467,34,25
18529,levle3_121.jpg,fore,,,0,359,302,393,331,34,29
18530,levle3_121.jpg,fore,,,0,320,140,340,162,20,22
18531,levle3_121.jpg,fore,,,0,317,336,346,360,29,24
18532,levle3_121.jpg,fore,,,0,301,280,346,312,45,32
18533,levle1_597.jpg,fore,Unspecified,0.0,0,1037,956,1183,1056,146,100
18534,levle1_597.jpg,fore,Unspecified,0.0,0,1214,757,1397,872,183,115
18535,levle1_597.jpg,fore,Unspecified,0.0,0,1926,2121,2057,2267,131,146
18536,levle1_597.jpg,fore,Unspecified,0.0,0,1758,2497,1903,2673,145,176
18537,levle1_597.jpg,fore,Unspecified,0.0,0,1781,2796,1934,2926,153,130
18538,levle1_597.jpg,fore,Unspecified,0.0,0,1712,3002,1880,3148,168,146
18539,levle1_597.jpg,fore,Unspecified,0.0,0,1650,3140,1758,3263,108,123
18540,levle1_583.jpg,fore,Unspecified,0.0,0,1551,1225,1673,1309,122,84
18541,levle1_583.jpg,fore,Unspecified,0.0,0,1980,1202,2110,1317,130,115
18542,levle1_583.jpg,fore,Unspecified,0.0,0,2141,1094,2279,1240,138,146
18543,levle1_583.jpg,fore,Unspecified,0.0,0,1597,941,1742,1048,145,107
18544,levle1_583.jpg,fore,Unspecified,0.0,0,1620,681,1719,826,99,145
18545,levle1_583.jpg,fore,Unspecified,0.0,0,2378,2160,2516,2290,138,130
18546,levle1_583.jpg,fore,Unspecified,0.0,0,2447,2328,2555,2458,108,130
18547,levle1_583.jpg,fore,Unspecified,0.0,0,2585,2420,2723,2573,138,153
18548,levle1_583.jpg,fore,Unspecified,0.0,0,1758,3186,1873,3317,115,131
18549,levle1_583.jpg,fore,Unspecified,0.0,0,1643,3148,1773,3263,130,115
18550,levle1_583.jpg,fore,Unspecified,0.0,0,1857,665,2064,849,207,184
18551,levle1_568.jpg,fore,Unspecified,0.0,0,2217,1347,2355,1416,138,69
18552,levle1_568.jpg,fore,Unspecified,0.0,0,2194,1202,2302,1301,108,99
18553,levle1_568.jpg,fore,Unspecified,0.0,0,1980,1202,2164,1393,184,191
18554,levle1_568.jpg,fore,Unspecified,0.0,0,2034,1891,2179,2014,145,123
18555,levle1_568.jpg,fore,Unspecified,0.0,0,2286,1753,2432,1891,146,138
18556,levle1_568.jpg,fore,Unspecified,0.0,0,2309,2014,2440,2114,131,100
18557,levle1_568.jpg,fore,Unspecified,0.0,0,2271,2236,2455,2374,184,138
18558,levle1_568.jpg,fore,Unspecified,0.0,0,2547,2512,2693,2612,146,100
18559,levle1_568.jpg,fore,Unspecified,0.0,0,2102,2558,2279,2750,177,192
18560,levle1_232.jpg,fore,Unspecified,0.0,0,2210,2251,2340,2405,130,154
18561,levle1_232.jpg,fore,Unspecified,0.0,0,2455,2290,2585,2420,130,130
18562,levle1_232.jpg,fore,Unspecified,0.0,0,1965,3171,2118,3263,153,92
18563,levle1_232.jpg,fore,Unspecified,0.0,0,1597,3048,1727,3140,130,92
18564,levle1_232.jpg,fore,Unspecified,0.0,0,1597,3140,1704,3271,107,131
18565,levle1_232.jpg,fore,Unspecified,0.0,0,1344,2987,1497,3094,153,107
18566,levle1_232.jpg,fore,Unspecified,0.0,0,1007,3033,1099,3194,92,161
18567,levle1_554.jpg,fore,Unspecified,0.0,0,1758,2236,1888,2328,130,92
18568,levle1_554.jpg,fore,Unspecified,0.0,0,1719,2121,1804,2244,85,123
18569,levle1_554.jpg,fore,Unspecified,0.0,0,1558,2075,1643,2213,85,138
18570,levle1_554.jpg,fore,Unspecified,0.0,0,1620,2259,1681,2343,61,84
18571,levle1_554.jpg,fore,Unspecified,0.0,0,1244,2075,1375,2198,131,123
18572,levle1_554.jpg,fore,Unspecified,0.0,0,1175,2336,1275,2435,100,99
18573,levle1_554.jpg,fore,Unspecified,0.0,0,1405,3064,1474,3133,69,69
18574,levle1_554.jpg,fore,Unspecified,0.0,0,1352,3156,1451,3240,99,84
18575,levle1_554.jpg,fore,Unspecified,0.0,0,1129,3056,1298,3186,169,130
18576,levle1_554.jpg,fore,Unspecified,0.0,0,1290,1409,1382,1508,92,99
18577,levle1_554.jpg,fore,Unspecified,0.0,0,1145,1294,1260,1447,115,153
18578,levle1_554.jpg,fore,Unspecified,0.0,0,1252,1179,1336,1278,84,99
18579,levle1_554.jpg,fore,Unspecified,0.0,0,976,987,1175,1171,199,184
18580,levle1_554.jpg,fore,Unspecified,0.0,0,1482,910,1650,1079,168,169
18581,levle1_554.jpg,fore,Unspecified,0.0,0,1420,3194,1620,3347,200,153
18582,levle1_16.jpg,fore,Unspecified,0.0,0,899,512,1068,681,169,169
18583,levle1_16.jpg,fore,Unspecified,0.0,0,1367,1845,1451,2014,84,169
18584,levle1_16.jpg,fore,Unspecified,0.0,0,1359,2160,1535,2328,176,168
18585,levle1_16.jpg,fore,Unspecified,0.0,0,2102,1845,2240,1983,138,138
18586,levle1_16.jpg,fore,Unspecified,0.0,0,1459,2435,1643,2573,184,138
18587,levle1_16.jpg,fore,Unspecified,0.0,0,1689,2520,1819,2650,130,130
18588,levle1_16.jpg,fore,Unspecified,0.0,0,1834,2826,1988,3010,154,184
18589,levle1_16.jpg,fore,Unspecified,0.0,0,1965,2780,2095,2972,130,192
18590,levle1_16.jpg,fore,Unspecified,0.0,0,1903,2650,2034,2803,131,153
18591,levle1_540.jpg,fore,Unspecified,0.0,0,1566,1079,1696,1186,130,107
18592,levle1_540.jpg,fore,Unspecified,0.0,0,2171,757,2225,872,54,115
18593,levle1_540.jpg,fore,Unspecified,0.0,0,2417,1217,2532,1347,115,130
18594,levle1_540.jpg,fore,Unspecified,0.0,0,800,1807,915,1953,115,146
18595,levle1_540.jpg,fore,Unspecified,0.0,0,1007,2474,1122,2550,115,76
18596,levle1_540.jpg,fore,Unspecified,0.0,0,1283,2704,1390,2819,107,115
18597,levle1_540.jpg,fore,Unspecified,0.0,0,1451,2719,1512,2803,61,84
18598,levle1_540.jpg,fore,Unspecified,0.0,0,1451,2359,1528,2451,77,92
18599,levle1_540.jpg,fore,Unspecified,0.0,0,1520,3010,1566,3071,46,61
18600,levle1_540.jpg,fore,Unspecified,0.0,0,1145,2236,1252,2389,107,153
18601,levle1_540.jpg,fore,Unspecified,0.0,0,976,2091,1129,2259,153,168
18602,levle1_540.jpg,fore,Unspecified,0.0,0,1811,2382,1911,2504,100,122
18603,levle1_540.jpg,fore,Unspecified,0.0,0,1750,2688,1834,2811,84,123
18604,levle1_540.jpg,fore,Unspecified,0.0,0,1566,2627,1673,2765,107,138
18605,levle1_540.jpg,fore,Unspecified,0.0,0,1022,2244,1137,2366,115,122
18606,levle1_226.jpg,fore,Unspecified,0.0,0,2455,1769,2631,1937,176,168
18607,levle1_226.jpg,fore,Unspecified,0.0,0,2470,2635,2601,2788,131,153
18608,levle1_226.jpg,fore,Unspecified,0.0,0,2478,2405,2647,2535,169,130
18609,levle1_226.jpg,fore,Unspecified,0.0,0,2294,2489,2463,2612,169,123
18610,levle1_226.jpg,fore,Unspecified,0.0,0,2064,2888,2217,3002,153,114
18611,levle1_226.jpg,fore,Unspecified,0.0,0,2087,3025,2217,3148,130,123
18612,levle1_226.jpg,fore,Unspecified,0.0,0,2263,2972,2409,3064,146,92
18613,levle1_226.jpg,fore,Unspecified,0.0,0,2455,2098,2539,2183,84,85
18614,levle1_9.jpg,fore,Unspecified,0.0,0,380,153,405,180,25,27
18615,levle1_9.jpg,fore,Unspecified,0.0,0,417,158,451,188,34,30
18616,levle1_9.jpg,fore,Unspecified,0.0,0,312,237,339,265,27,28
18617,levle1_9.jpg,fore,Unspecified,0.0,0,264,289,292,320,28,31
18618,levle1_9.jpg,fore,Unspecified,0.0,0,252,329,291,373,39,44
18619,levle1_9.jpg,fore,Unspecified,0.0,0,317,330,357,356,40,26
18620,levle1_9.jpg,fore,Unspecified,0.0,0,410,252,436,275,26,23
18621,levle1_9.jpg,fore,Unspecified,0.0,0,174,193,210,224,36,31
18622,levle1_9.jpg,fore,Unspecified,0.0,0,420,315,460,357,40,42
18623,levle2_90.jpg,fore,Unspecified,0.0,0,67,61,79,77,12,16
18624,levle2_90.jpg,fore,Unspecified,0.0,0,63,36,73,49,10,13
18625,levle2_90.jpg,fore,Unspecified,0.0,0,73,17,90,29,17,12
18626,levle2_90.jpg,fore,Unspecified,0.0,0,78,31,85,41,7,10
18627,levle2_90.jpg,fore,Unspecified,0.0,0,48,40,65,52,17,12
18628,levle2_90.jpg,fore,Unspecified,0.0,0,39,42,51,59,12,17
18629,levle2_90.jpg,fore,Unspecified,0.0,0,74,110,85,120,11,10
18630,levle2_90.jpg,fore,Unspecified,0.0,0,74,116,80,130,6,14
18631,levle2_90.jpg,fore,Unspecified,0.0,0,60,111,75,123,15,12
18632,levle2_90.jpg,fore,Unspecified,0.0,0,63,122,74,136,11,14
18633,levle2_90.jpg,fore,Unspecified,0.0,0,35,120,49,133,14,13
18634,levle2_90.jpg,fore,Unspecified,0.0,0,26,117,39,131,13,14
18635,levle2_90.jpg,fore,Unspecified,0.0,0,42,132,56,144,14,12
18636,levle2_90.jpg,fore,Unspecified,0.0,0,54,126,67,136,13,10
18637,levle2_90.jpg,fore,Unspecified,0.0,0,32,96,43,105,11,9
18638,levle2_90.jpg,fore,Unspecified,0.0,0,25,144,34,156,9,12
18639,levle2_90.jpg,fore,Unspecified,0.0,0,34,159,49,172,15,13
18640,levle2_90.jpg,fore,Unspecified,0.0,0,75,132,86,141,11,9
18641,levle2_90.jpg,fore,Unspecified,0.0,0,96,138,104,151,8,13
18642,levle2_90.jpg,fore,Unspecified,0.0,0,105,137,117,149,12,12
18643,levle2_90.jpg,fore,Unspecified,0.0,0,108,145,122,161,14,16
18644,levle2_90.jpg,fore,Unspecified,0.0,0,51,163,66,173,15,10
18645,levle2_90.jpg,fore,Unspecified,0.0,0,72,174,84,183,12,9
18646,levle2_90.jpg,fore,Unspecified,0.0,0,72,166,82,174,10,8
18647,levle2_90.jpg,fore,Unspecified,0.0,0,71,193,81,204,10,11
18648,levle2_90.jpg,fore,Unspecified,0.0,0,145,221,153,234,8,13
18649,levle2_90.jpg,fore,Unspecified,0.0,0,151,199,162,213,11,14
18650,levle2_90.jpg,fore,Unspecified,0.0,0,141,195,154,208,13,13
18651,levle2_90.jpg,fore,Unspecified,0.0,0,130,221,142,233,12,12
18652,levle2_90.jpg,fore,Unspecified,0.0,0,94,182,107,197,13,15
18653,levle2_118.jpg,fore,Unspecified,0.0,0,984,1002,1106,1209,122,207
18654,levle2_118.jpg,fore,Unspecified,0.0,0,1160,1340,1221,1409,61,69
18655,levle2_118.jpg,fore,Unspecified,0.0,0,2394,2336,2547,2474,153,138
18656,levle2_118.jpg,fore,Unspecified,0.0,0,2325,2497,2440,2573,115,76
18657,levle2_118.jpg,fore,Unspecified,0.0,0,2317,2144,2470,2305,153,161
18658,levle2_118.jpg,fore,Unspecified,0.0,0,1926,2267,2049,2405,123,138
18659,levle2_118.jpg,fore,Unspecified,0.0,0,1727,2527,1857,2635,130,108
18660,levle2_118.jpg,fore,Unspecified,0.0,0,1903,2612,2034,2757,131,145
18661,levle2_118.jpg,fore,Unspecified,0.0,0,1643,1102,1735,1202,92,100
18662,levle2_118.jpg,fore,Unspecified,0.0,0,1658,2297,1765,2435,107,138
18663,levle2_118.jpg,fore,Unspecified,0.0,0,1811,2474,1942,2550,131,76
18664,levle2_118.jpg,fore,Unspecified,0.0,0,1689,2765,1827,2918,138,153
18665,levle2_118.jpg,fore,Unspecified,0.0,0,1535,3156,1635,3309,100,153
18666,levle2_118.jpg,fore,Unspecified,0.0,0,1704,3194,1819,3355,115,161
18667,levle2_84.jpg,fore,Unspecified,0.0,0,1091,1945,1229,2068,138,123
18668,levle2_84.jpg,fore,Unspecified,0.0,0,1191,3209,1352,3332,161,123
18669,levle2_84.jpg,fore,Unspecified,0.0,0,1581,3064,1758,3263,177,199
18670,levle2_84.jpg,fore,Unspecified,0.0,0,1359,826,1489,972,130,146
18671,levle2_84.jpg,fore,Unspecified,0.0,0,1214,819,1367,1010,153,191
18672,levle2_84.jpg,fore,Unspecified,0.0,0,1252,581,1375,719,123,138
18673,levle2_84.jpg,fore,Unspecified,0.0,0,1474,642,1612,773,138,131
18674,levle2_84.jpg,fore,Unspecified,0.0,0,1375,435,1512,543,137,108
18675,levle2_84.jpg,fore,Unspecified,0.0,0,639,1056,800,1140,161,84
18676,levle2_84.jpg,fore,Unspecified,0.0,0,555,1071,654,1163,99,92
18677,levle2_84.jpg,fore,Unspecified,0.0,0,624,1133,777,1240,153,107
18678,levle2_84.jpg,fore,Unspecified,0.0,0,585,1286,777,1416,192,130
18679,levle2_84.jpg,fore,Unspecified,0.0,0,539,1409,692,1470,153,61
18680,levle2_84.jpg,fore,Unspecified,0.0,0,401,1485,578,1638,177,153
18681,levle2_84.jpg,fore,Unspecified,0.0,0,271,1416,363,1516,92,100
18682,levle2_84.jpg,fore,Unspecified,0.0,0,378,1692,547,1776,169,84
18683,levle2_84.jpg,fore,Unspecified,0.0,0,233,1815,348,1907,115,92
18684,levle2_84.jpg,fore,Unspecified,0.0,0,309,1899,371,1999,62,100
18685,levle2_84.jpg,fore,Unspecified,0.0,0,401,1799,555,1914,154,115
18686,levle2_84.jpg,fore,Unspecified,0.0,0,348,1899,501,1999,153,100
18687,levle2_84.jpg,fore,Unspecified,0.0,0,371,2029,532,2190,161,161
18688,levle2_130.jpg,fore,Unspecified,0.0,0,1336,2045,1474,2152,138,107
18689,levle2_130.jpg,fore,Unspecified,0.0,0,1313,2198,1413,2313,100,115
18690,levle2_130.jpg,fore,Unspecified,0.0,0,1474,2183,1604,2297,130,114
18691,levle2_130.jpg,fore,Unspecified,0.0,0,1321,2320,1482,2466,161,146
18692,levle2_130.jpg,fore,Unspecified,0.0,0,1367,2481,1459,2581,92,100
18693,levle2_130.jpg,fore,Unspecified,0.0,0,1466,2604,1543,2696,77,92
18694,levle2_130.jpg,fore,Unspecified,0.0,0,1482,2481,1574,2581,92,100
18695,levle2_130.jpg,fore,Unspecified,0.0,0,1512,2405,1643,2504,131,99
18696,levle2_130.jpg,fore,Unspecified,0.0,0,1658,2382,1742,2451,84,69
18697,levle2_130.jpg,fore,Unspecified,0.0,0,1612,2742,1704,2811,92,69
18698,levle2_130.jpg,fore,Unspecified,0.0,0,1666,2811,1735,2865,69,54
18699,levle2_130.jpg,fore,Unspecified,0.0,0,1727,2880,1804,3002,77,122
18700,levle2_130.jpg,fore,Unspecified,0.0,0,1819,2796,1949,2903,130,107
18701,levle2_130.jpg,fore,Unspecified,0.0,0,1742,3064,1888,3179,146,115
18702,levle2_130.jpg,fore,Unspecified,0.0,0,1911,2305,2003,2420,92,115
18703,levle2_130.jpg,fore,Unspecified,0.0,0,2057,2320,2110,2397,53,77
18704,levle2_130.jpg,fore,Unspecified,0.0,0,2248,2458,2371,2558,123,100
18705,levle2_130.jpg,fore,Unspecified,0.0,0,2164,1822,2317,1930,153,108
18706,levle2_130.jpg,fore,Unspecified,0.0,0,2049,2068,2225,2236,176,168
18707,levle2_130.jpg,fore,Unspecified,0.0,0,2179,1332,2355,1470,176,138
18708,levle2_130.jpg,fore,Unspecified,0.0,0,1114,604,1206,765,92,161
18709,levle2_130.jpg,fore,Unspecified,0.0,0,1482,727,1589,872,107,145
18710,levle2_124.jpg,fore,,,0,585,2114,700,2198,115,84
18711,levle2_124.jpg,fore,,,0,524,2206,662,2251,138,45
18712,levle2_124.jpg,fore,,,0,608,2244,731,2405,123,161
18713,levle2_124.jpg,fore,,,0,853,2221,953,2366,100,145
18714,levle2_124.jpg,fore,,,0,976,2206,1145,2336,169,130
18715,levle2_124.jpg,fore,,,0,1267,2114,1443,2267,176,153
18716,levle2_124.jpg,fore,,,0,1267,2267,1397,2374,130,107
18717,levle2_124.jpg,fore,,,0,1283,2366,1413,2489,130,123
18718,levle2_124.jpg,fore,,,0,1175,2504,1298,2619,123,115
18719,levle2_124.jpg,fore,,,0,1076,2366,1221,2466,145,100
18720,levle2_124.jpg,fore,,,0,876,2366,1068,2504,192,138
18721,levle2_124.jpg,fore,,,0,922,2504,1045,2596,123,92
18722,levle2_124.jpg,fore,,,0,1037,2596,1168,2704,131,108
18723,levle2_124.jpg,fore,,,0,1091,3133,1244,3278,153,145
18724,levle2_124.jpg,fore,,,0,1321,3071,1459,3186,138,115
18725,levle2_124.jpg,fore,,,0,1321,2865,1451,3025,130,160
18726,levle2_124.jpg,fore,,,0,1589,3117,1773,3294,184,177
18727,levle2_124.jpg,fore,,,0,1581,2405,1735,2558,154,153
18728,levle2_124.jpg,fore,,,0,950,3081,1081,3188,131,107
18729,levle2_124.jpg,fore,,,0,1564,2870,1664,2970,100,100
18730,levle2_124.jpg,fore,,,0,336,1412,440,1498,104,86
18731,levle2_53.jpg,fore,,,0,1744,1236,1943,1369,199,133
18732,levle2_53.jpg,fore,,,0,1627,1560,1844,1751,217,191
18733,levle2_53.jpg,fore,,,0,1494,1402,1669,1576,175,174
18734,levle2_53.jpg,fore,,,0,1461,1851,1694,2075,233,224
18735,levle2_53.jpg,fore,,,0,1819,2083,1943,2241,124,158
18736,levle2_53.jpg,fore,,,0,1910,1792,2018,1942,108,150
18737,levle2_53.jpg,fore,,,0,2218,1709,2367,1867,149,158
18738,levle2_53.jpg,fore,,,0,2625,2075,2774,2200,149,125
18739,levle2_53.jpg,fore,,,0,2400,1992,2616,2183,216,191
18740,levle2_53.jpg,fore,,,0,2251,2208,2384,2366,133,158
18741,levle2_53.jpg,fore,,,0,2459,2125,2575,2250,116,125
18742,levle2_53.jpg,fore,,,0,2558,2200,2725,2349,167,149
18743,levle2_53.jpg,fore,,,0,2375,2408,2508,2582,133,174
18744,levle2_53.jpg,fore,,,0,2201,2507,2334,2615,133,108
18745,levle2_53.jpg,fore,,,0,2484,2516,2608,2657,124,141
18746,levle2_53.jpg,fore,,,0,1927,2250,2093,2432,166,182
18747,levle2_53.jpg,fore,,,0,2924,2964,3148,3172,224,208
18748,levle2_53.jpg,fore,,,0,2625,2707,2741,2840,116,133
18749,levle2_53.jpg,fore,,,0,2567,2973,2733,3164,166,191
18750,levle2_53.jpg,fore,,,0,2422,474,2574,614,152,140
18751,levle2_53.jpg,fore,,,0,2650,1882,2770,2010,120,128
18752,levle2_47.jpg,fore,Unspecified,0.0,0,3448,1876,3556,2050,108,174
18753,levle2_47.jpg,fore,Unspecified,0.0,0,3015,1942,3198,2117,183,175
18754,levle2_47.jpg,fore,Unspecified,0.0,0,2218,1211,2500,1468,282,257
18755,levle2_47.jpg,fore,Unspecified,0.0,0,1735,911,1960,1086,225,175
18756,levle2_47.jpg,fore,Unspecified,0.0,0,1902,1020,2068,1177,166,157
18757,levle2_47.jpg,fore,Unspecified,0.0,0,1436,1003,1661,1202,225,199
18758,levle2_47.jpg,fore,Unspecified,0.0,0,1428,853,1677,1111,249,258
18759,levle2_47.jpg,fore,Unspecified,0.0,0,1420,371,1669,621,249,250
18760,levle2_47.jpg,fore,Unspecified,0.0,0,1968,1327,2159,1527,191,200
18761,levle2_47.jpg,fore,Unspecified,0.0,0,1553,2042,1769,2233,216,191
18762,levle2_47.jpg,fore,Unspecified,0.0,0,1312,2175,1677,2316,365,141
18763,levle2_47.jpg,fore,Unspecified,0.0,0,1785,2250,2101,2457,316,207
18764,levle2_47.jpg,fore,Unspecified,0.0,0,1827,1834,2010,1992,183,158
18765,levle2_47.jpg,fore,Unspecified,0.0,0,1844,1950,2035,2191,191,241
18766,levle2_47.jpg,fore,Unspecified,0.0,0,2010,1768,2193,1934,183,166
18767,levle2_47.jpg,fore,Unspecified,0.0,0,2068,1917,2234,2100,166,183
18768,levle2_47.jpg,fore,Unspecified,0.0,0,2134,803,2301,1053,167,250
18769,levle2_47.jpg,fore,Unspecified,0.0,0,1952,654,2143,812,191,158
18770,levle2_47.jpg,fore,Unspecified,0.0,0,2517,413,2849,720,332,307
18771,levle2_47.jpg,fore,Unspecified,0.0,0,1636,1502,1985,1626,349,124
18772,levle2_47.jpg,fore,Unspecified,0.0,0,1494,1635,1744,1901,250,266
18773,levle2_47.jpg,fore,Unspecified,0.0,0,1229,1759,1420,2034,191,275
18774,levle2_47.jpg,fore,Unspecified,0.0,0,1012,1618,1303,1892,291,274
18775,levle2_47.jpg,fore,Unspecified,0.0,0,1436,2358,1627,2507,191,149
18776,levle2_47.jpg,fore,Unspecified,0.0,0,1578,2399,1769,2624,191,225
18777,levle2_47.jpg,fore,Unspecified,0.0,0,1785,2682,1985,2948,200,266
18778,levle2_47.jpg,fore,Unspecified,0.0,0,2226,2806,2525,3031,299,225
18779,levle2_47.jpg,fore,Unspecified,0.0,0,2326,1967,2542,2167,216,200
18780,levle2_47.jpg,fore,Unspecified,0.0,0,2542,1776,2841,1984,299,208
18781,levle2_47.jpg,fore,Unspecified,0.0,0,2542,1527,2824,1751,282,224
18782,levle2_47.jpg,fore,Unspecified,0.0,0,2791,2183,3065,2441,274,258
18783,levle2_47.jpg,fore,Unspecified,0.0,0,3015,2416,3331,2740,316,324
18784,levle2_47.jpg,fore,Unspecified,0.0,0,3531,2200,3971,2516,440,316
18785,levle0_223.jpg,fore,Unspecified,0.0,0,2187,2328,2394,2535,207,207
18786,levle0_223.jpg,fore,Unspecified,0.0,0,1367,2949,1551,3171,184,222
18787,levle0_95.jpg,fore,Unspecified,0.0,0,1712,2451,1919,2673,207,222
18788,levle0_81.jpg,fore,Unspecified,0.0,0,2126,2715,2292,2856,166,141
18789,levle0_81.jpg,fore,Unspecified,0.0,0,1860,2200,2068,2374,208,174
18790,levle1_187.jpg,fore,Unspecified,0.0,0,2171,2497,2325,2650,154,153
18791,levle1_187.jpg,fore,Unspecified,0.0,0,2064,2589,2194,2719,130,130
18792,levle1_187.jpg,fore,Unspecified,0.0,0,1934,2474,2049,2589,115,115
18793,levle1_187.jpg,fore,Unspecified,0.0,0,2685,1769,2807,1876,122,107
18794,levle1_187.jpg,fore,Unspecified,0.0,0,2846,1317,2976,1524,130,207
18795,levle1_187.jpg,fore,Unspecified,0.0,0,2670,2213,2769,2343,99,130
18796,levle1_187.jpg,fore,Unspecified,0.0,0,1535,382,1627,474,92,92
18797,levle1_187.jpg,fore,Unspecified,0.0,0,1643,274,1804,451,161,177
18798,levle1_187.jpg,fore,Unspecified,0.0,0,1275,941,1375,1041,100,100
18799,levle0_394.jpg,fore,Unspecified,0.0,0,1604,1968,1796,2190,192,222
18800,levle1_193.jpg,fore,Unspecified,0.0,0,907,2374,1022,2535,115,161
18801,levle1_193.jpg,fore,Unspecified,0.0,0,754,443,945,627,191,184
18802,levle1_193.jpg,fore,Unspecified,0.0,0,1221,535,1367,673,146,138
18803,levle1_193.jpg,fore,Unspecified,0.0,0,1727,251,1965,451,238,200
18804,levle1_193.jpg,fore,Unspecified,0.0,0,1896,558,2049,688,153,130
18805,levle1_193.jpg,fore,Unspecified,0.0,0,1650,2244,1788,2389,138,145
18806,levle1_193.jpg,fore,Unspecified,0.0,0,248,1485,378,1638,130,153
18807,levle0_380.jpg,fore,Unspecified,0.0,0,1352,2221,1466,2351,114,130
18808,levle0_56.jpg,fore,Unspecified,0.0,0,1544,1543,1677,1751,133,208
18809,levle0_56.jpg,fore,Unspecified,0.0,0,1561,2599,1852,2898,291,299
18810,levle1_178.jpg,fore,Unspecified,0.0,0,1551,2987,1666,3102,115,115
18811,levle1_178.jpg,fore,Unspecified,0.0,0,1298,2251,1413,2359,115,108
18812,levle1_178.jpg,fore,Unspecified,0.0,0,1972,834,2064,918,92,84
18813,levle1_178.jpg,fore,Unspecified,0.0,0,1850,849,1934,972,84,123
18814,levle1_178.jpg,fore,Unspecified,0.0,0,1957,3217,2003,3317,46,100
18815,levle1_178.jpg,fore,Unspecified,0.0,0,1712,3363,1819,3432,107,69
18816,levle1_178.jpg,fore,Unspecified,0.0,0,2217,1232,2317,1301,100,69
18817,levle0_419.jpg,fore,Unspecified,0.0,0,738,1654,876,1838,138,184
18818,levle0_419.jpg,fore,Unspecified,0.0,0,953,2842,1068,2949,115,107
18819,levle0_419.jpg,fore,Unspecified,0.0,0,1137,2880,1313,3010,176,130
18820,levle0_419.jpg,fore,Unspecified,0.0,0,2057,3248,2141,3370,84,122
18821,levle0_42.jpg,fore,Unspecified,0.0,0,1512,3125,1643,3232,131,107
18822,levle0_42.jpg,fore,Unspecified,0.0,0,1267,3002,1405,3102,138,100
18823,levle1_622.jpg,fore,Unspecified,0.0,0,1834,2190,2003,2366,169,176
18824,levle1_622.jpg,fore,Unspecified,0.0,0,1160,1876,1367,2083,207,207
18825,levle1_622.jpg,fore,Unspecified,0.0,0,1696,3079,1842,3255,146,176
18826,levle1_622.jpg,fore,Unspecified,0.0,0,1160,3278,1313,3439,153,161
18827,levle1_622.jpg,fore,Unspecified,0.0,0,991,3202,1145,3324,154,122
18828,levle1_622.jpg,fore,Unspecified,0.0,0,1060,3125,1290,3255,230,130
18829,levle1_622.jpg,fore,Unspecified,0.0,0,1014,2934,1145,3018,131,84
18830,levle1_622.jpg,fore,Unspecified,0.0,0,807,2911,991,3041,184,130
18831,levle1_622.jpg,fore,Unspecified,0.0,0,1206,964,1352,1102,146,138
18832,levle1_622.jpg,fore,Unspecified,0.0,0,1053,1309,1252,1501,199,192
18833,levle1_144.jpg,fore,,,0,984,2780,1106,2903,122,123
18834,levle1_144.jpg,fore,,,0,715,1799,861,1937,146,138
18835,levle1_144.jpg,fore,,,0,624,1976,754,2114,130,138
18836,levle1_144.jpg,fore,,,0,677,2696,777,2857,100,161
18837,levle1_144.jpg,fore,,,0,1346,846,1481,939,135,93
18838,levle1_144.jpg,fore,,,0,1546,1994,1691,2070,145,76
18839,levle0_357.jpg,fore,Unspecified,0.0,0,1627,3163,1719,3271,92,108
18840,levle0_357.jpg,fore,Unspecified,0.0,0,1014,2665,1076,2842,62,177
18841,levle1_150.jpg,fore,Unspecified,0.0,0,1643,435,1781,558,138,123
18842,levle1_150.jpg,fore,Unspecified,0.0,0,1160,2619,1283,2780,123,161
18843,levle1_150.jpg,fore,Unspecified,0.0,0,715,2520,853,2650,138,130
18844,levle1_150.jpg,fore,Unspecified,0.0,0,562,2389,662,2489,100,100
18845,levle1_150.jpg,fore,Unspecified,0.0,0,509,2550,647,2688,138,138
18846,levle1_150.jpg,fore,Unspecified,0.0,0,302,2535,432,2704,130,169
18847,levle1_150.jpg,fore,Unspecified,0.0,0,440,2750,578,2888,138,138
18848,levle1_150.jpg,fore,Unspecified,0.0,0,639,2757,792,2941,153,184
18849,levle1_150.jpg,fore,Unspecified,0.0,0,440,1447,555,1539,115,92
18850,levle0_343.jpg,fore,Unspecified,0.0,0,1535,2627,1650,2780,115,153
18851,levle0_343.jpg,fore,Unspecified,0.0,0,2026,2374,2187,2512,161,138
18852,levle0_343.jpg,fore,Unspecified,0.0,0,738,1140,869,1271,131,131
18853,levle0_425.jpg,fore,Unspecified,0.0,0,2279,1991,2363,2098,84,107
18854,levle0_425.jpg,fore,Unspecified,0.0,0,1827,933,1926,1064,99,131
18855,levle0_425.jpg,fore,Unspecified,0.0,0,2079,765,2256,903,177,138
18856,levle1_636.jpg,fore,Unspecified,0.0,0,945,1769,1106,1868,161,99
18857,levle1_636.jpg,fore,Unspecified,0.0,0,1099,1922,1260,2045,161,123
18858,levle1_636.jpg,fore,Unspecified,0.0,0,1413,2160,1620,2420,207,260
18859,levle1_636.jpg,fore,Unspecified,0.0,0,1122,2535,1428,2773,306,238
18860,levle1_636.jpg,fore,Unspecified,0.0,0,853,2290,1053,2435,200,145
18861,levle1_636.jpg,fore,Unspecified,0.0,0,800,2627,1007,2811,207,184
18862,levle0_196.jpg,fore,Unspecified,0.0,0,769,2175,968,2366,199,191
18863,levle1_385.jpg,fore,Unspecified,0.0,0,1260,1117,1405,1355,145,238
18864,levle1_385.jpg,fore,Unspecified,0.0,0,1214,1983,1382,2106,168,123
18865,levle1_385.jpg,fore,Unspecified,0.0,0,1321,2152,1451,2320,130,168
18866,levle1_385.jpg,fore,Unspecified,0.0,0,1436,2259,1566,2382,130,123
18867,levle1_385.jpg,fore,Unspecified,0.0,0,1397,2558,1535,2704,138,146
18868,levle1_385.jpg,fore,Unspecified,0.0,0,1375,2826,1505,2964,130,138
18869,levle1_385.jpg,fore,Unspecified,0.0,0,1551,2819,1658,2956,107,137
18870,levle1_385.jpg,fore,Unspecified,0.0,0,2317,819,2463,987,146,168
18871,levle0_182.jpg,fore,Unspecified,0.0,0,738,1845,869,1953,131,108
18872,levle0_182.jpg,fore,Unspecified,0.0,0,647,2091,715,2221,68,130
18873,levle0_182.jpg,fore,Unspecified,0.0,0,731,2083,861,2167,130,84
18874,levle1_391.jpg,fore,Unspecified,0.0,0,1735,2037,1888,2183,153,146
18875,levle1_391.jpg,fore,Unspecified,0.0,0,2156,1332,2309,1562,153,230
18876,levle1_391.jpg,fore,Unspecified,0.0,0,2179,1822,2332,1983,153,161
18877,levle1_391.jpg,fore,Unspecified,0.0,0,2271,2037,2394,2175,123,138
18878,levle1_391.jpg,fore,Unspecified,0.0,0,2026,2098,2210,2267,184,169
18879,levle1_391.jpg,fore,Unspecified,0.0,0,1896,2236,2079,2382,183,146
18880,levle1_391.jpg,fore,Unspecified,0.0,0,1742,2336,1865,2466,123,130
18881,levle1_391.jpg,fore,Unspecified,0.0,0,1781,2719,1873,2865,92,146
18882,levle1_391.jpg,fore,Unspecified,0.0,0,2102,2566,2240,2750,138,184
18883,levle1_391.jpg,fore,Unspecified,0.0,0,2509,2305,2677,2451,168,146
18884,levle1_391.jpg,fore,Unspecified,0.0,0,2440,2137,2593,2290,153,153
18885,levle0_169.jpg,fore,Unspecified,0.0,0,409,1608,555,1753,146,145
18886,levle1_408.jpg,fore,Unspecified,0.0,0,493,2236,631,2389,138,153
18887,levle1_408.jpg,fore,Unspecified,0.0,0,662,2267,823,2382,161,115
18888,levle1_408.jpg,fore,Unspecified,0.0,0,738,2037,830,2167,92,130
18889,levle1_408.jpg,fore,Unspecified,0.0,0,830,2075,938,2190,108,115
18890,levle1_408.jpg,fore,Unspecified,0.0,0,945,2114,1068,2282,123,168
18891,levle1_408.jpg,fore,Unspecified,0.0,0,907,895,1068,1087,161,192
18892,levle1_408.jpg,fore,Unspecified,0.0,0,1183,2979,1382,3156,199,177
18893,levle1_408.jpg,fore,Unspecified,0.0,0,2049,2037,2164,2236,115,199
18894,levle0_155.jpg,fore,Unspecified,0.0,0,2309,2014,2417,2175,108,161
18895,levle1_346.jpg,fore,Unspecified,0.0,0,1604,2029,1781,2206,177,177
18896,levle1_346.jpg,fore,Unspecified,0.0,0,1627,2274,1781,2420,154,146
18897,levle1_346.jpg,fore,Unspecified,0.0,0,1543,2412,1712,2566,169,154
18898,levle1_346.jpg,fore,Unspecified,0.0,0,1191,2290,1405,2535,214,245
18899,levle1_346.jpg,fore,Unspecified,0.0,0,922,2137,1114,2274,192,137
18900,levle1_346.jpg,fore,Unspecified,0.0,0,784,1960,1022,2098,238,138
18901,levle1_420.jpg,fore,Unspecified,0.0,0,547,1730,662,1891,115,161
18902,levle1_420.jpg,fore,Unspecified,0.0,0,708,1117,761,1232,53,115
18903,levle1_420.jpg,fore,Unspecified,0.0,0,677,1999,876,2160,199,161
18904,levle1_420.jpg,fore,Unspecified,0.0,0,1007,2497,1168,2658,161,161
18905,levle1_420.jpg,fore,Unspecified,0.0,0,1597,2619,1735,2742,138,123
18906,levle1_420.jpg,fore,Unspecified,0.0,0,1252,3163,1367,3271,115,108
18907,levle1_434.jpg,fore,Unspecified,0.0,0,1252,933,1375,1102,123,169
18908,levle1_434.jpg,fore,Unspecified,0.0,0,386,2535,509,2734,123,199
18909,levle1_434.jpg,fore,Unspecified,0.0,0,486,2911,631,2979,145,68
18910,levle1_434.jpg,fore,Unspecified,0.0,0,670,3033,830,3202,160,169
18911,levle1_434.jpg,fore,Unspecified,0.0,0,853,2865,945,3064,92,199
18912,levle1_434.jpg,fore,Unspecified,0.0,0,1083,2750,1267,2857,184,107
18913,levle1_434.jpg,fore,Unspecified,0.0,0,1214,2911,1336,3025,122,114
18914,levle1_434.jpg,fore,Unspecified,0.0,0,1007,3064,1129,3240,122,176
18915,levle1_434.jpg,fore,Unspecified,0.0,0,1221,3125,1375,3278,154,153
18916,levle1_434.jpg,fore,Unspecified,0.0,0,1857,2995,1972,3140,115,145
18917,levle1_434.jpg,fore,Unspecified,0.0,0,1781,3179,1926,3324,145,145
18918,levle1_434.jpg,fore,Unspecified,0.0,0,1627,3248,1819,3424,192,176
18919,levle3_13.jpg,fore,,,0,583,233,652,261,69,28
18920,levle3_13.jpg,fore,,,0,568,253,599,306,31,53
18921,levle3_13.jpg,fore,,,0,593,373,636,422,43,49
18922,levle3_13.jpg,fore,,,0,560,388,595,424,35,36
18923,levle3_13.jpg,fore,,,0,574,434,601,498,27,64
18924,levle3_13.jpg,fore,,,0,623,420,662,445,39,25
18925,levle3_13.jpg,fore,,,0,570,526,593,545,23,19
18926,levle3_13.jpg,fore,,,0,489,541,515,587,26,46
18927,levle3_13.jpg,fore,,,0,472,592,509,624,37,32
18928,levle3_13.jpg,fore,,,0,536,598,564,653,28,55
18929,levle3_13.jpg,fore,,,0,562,592,615,606,53,14
18930,levle3_13.jpg,fore,,,0,411,441,446,475,35,34
18931,levle3_13.jpg,fore,,,0,313,508,346,553,33,45
18932,levle3_13.jpg,fore,,,0,354,508,393,549,39,41
18933,levle3_13.jpg,fore,,,0,393,502,434,545,41,43
18934,levle3_13.jpg,fore,,,0,322,557,366,594,44,37
18935,levle3_13.jpg,fore,,,0,334,587,385,628,51,41
18936,levle3_13.jpg,fore,,,0,277,583,301,620,24,37
18937,levle3_13.jpg,fore,,,0,436,579,479,632,43,53
18938,levle3_13.jpg,fore,,,0,403,624,430,647,27,23
18939,levle3_13.jpg,fore,,,0,383,665,405,692,22,27
18940,levle3_13.jpg,fore,,,0,438,663,477,687,39,24
18941,levle3_13.jpg,fore,,,0,397,716,421,738,24,22
18942,levle3_13.jpg,fore,,,0,432,722,491,765,59,43
18943,levle3_13.jpg,fore,,,0,338,665,373,698,35,33
18944,levle3_13.jpg,fore,,,0,232,653,285,692,53,39
18945,levle3_13.jpg,fore,,,0,191,665,226,679,35,14
18946,levle3_13.jpg,fore,,,0,156,634,187,655,31,21
18947,levle3_13.jpg,fore,,,0,113,587,156,612,43,25
18948,levle3_13.jpg,fore,,,0,152,555,193,575,41,20
18949,levle3_13.jpg,fore,,,0,140,514,171,536,31,22
18950,levle3_13.jpg,fore,,,0,136,469,181,510,45,41
18951,levle3_13.jpg,fore,,,0,177,465,224,500,47,35
18952,levle3_13.jpg,fore,,,0,234,457,271,490,37,33
18953,levle3_13.jpg,fore,,,0,444,473,489,512,45,39
18954,levle3_13.jpg,fore,,,0,299,386,350,430,51,44
18955,levle3_13.jpg,fore,,,0,220,557,281,585,61,28
18956,levle3_13.jpg,fore,,,0,468,290,497,317,29,27
18957,levle3_13.jpg,fore,,,0,614,461,647,508,33,47
18958,levle3_13.jpg,fore,,,0,611,294,634,332,23,38
18959,levle3_13.jpg,fore,,,0,636,279,665,306,29,27
18960,levle3_13.jpg,fore,,,0,642,307,670,336,28,29
18961,levle3_13.jpg,fore,,,0,486,403,527,442,41,39
18962,levle3_13.jpg,fore,,,0,492,502,530,538,38,36
18963,levle3_13.jpg,fore,,,0,269,547,314,579,45,32
18964,levle3_13.jpg,fore,,,0,100,650,132,674,32,24
18965,levle3_13.jpg,fore,,,0,127,677,158,707,31,30
18966,levle3_13.jpg,fore,,,0,201,699,236,721,35,22
18967,levle3_13.jpg,fore,,,0,188,584,225,617,37,33
18968,levle3_13.jpg,fore,,,0,132,620,165,659,33,39
18969,levle3_13.jpg,fore,,,0,404,579,435,612,31,33
18970,levle3_13.jpg,fore,,,0,249,595,279,631,30,36
18971,levle3_13.jpg,fore,,,0,308,608,338,642,30,34
18972,levle3_13.jpg,fore,,,0,402,672,431,707,29,35
18973,levle0_141.jpg,fore,Unspecified,0.0,0,2394,2198,2547,2320,153,122
18974,levle0_141.jpg,fore,Unspecified,0.0,0,2562,2320,2677,2474,115,154
18975,levle0_141.jpg,fore,Unspecified,0.0,0,2240,1608,2371,1730,131,122
18976,levle1_352.jpg,fore,Unspecified,0.0,0,2731,1914,2899,2091,168,177
18977,levle1_352.jpg,fore,Unspecified,0.0,0,2325,2282,2532,2466,207,184
18978,levle1_352.jpg,fore,Unspecified,0.0,0,2493,2320,2708,2535,215,215
18979,levle1_352.jpg,fore,Unspecified,0.0,0,1850,2389,1980,2543,130,154
18980,levle1_352.jpg,fore,Unspecified,0.0,0,1949,2290,2110,2420,161,130
18981,levle1_352.jpg,fore,Unspecified,0.0,0,1290,995,1443,1179,153,184
18982,levle1_352.jpg,fore,Unspecified,0.0,0,1198,1171,1336,1324,138,153
